Rank,Song,Artist,TP Spins,+/- Chg. Spins,LP Spins,Stations,Adds,TP Audience,+/- Chg. Audience,LP Audience,TP Stream,week_of
1,Last Night,Morgan Wallen,7890,-48,7938,145,0,32868800,-87900,32956700,30828403,2023.06.22
2,Fast Car,Luke Combs,7706,1281,6425,145,0,31100200,4838800,26261400,21482246,2023.06.22
3,Next Thing You Know,Jordan Davis,7927,723,7204,145,0,30817400,3326900,27490500,8445921,2023.06.22
4,Dancin' In The Country,Tyler Hubbard,6372,-57,6429,145,0,28307500,-488400,28795900,6553301,2023.06.22
5,Memory Lane,Old Dominion,6239,180,6059,145,0,23874200,831800,23042400,7134368,2023.06.22
6,"You, Me, And Whiskey",Justin Moore & Priscilla Block,5582,437,5145,145,0,20380700,1577400,18803300,3187414,2023.06.22
7,Tennessee Orange,Megan Moroney,5133,-2246,7379,145,0,19586700,-7310700,26897400,7124193,2023.06.22
8,Need A Favor,Jelly Roll,5515,599,4916,144,0,19579500,2045400,17534100,11042808,2023.06.22
9,Your Heart Or Mine,Jon Pardi,5118,251,4867,145,0,18304200,959000,17345200,3978215,2023.06.22
10,Love You Anyway,Luke Combs,4815,661,4154,145,0,17430600,1874200,15556400,7385560,2023.06.22
11,Bury Me In Georgia,Kane Brown,4191,425,3766,144,0,16286900,1822700,14464200,4697955,2023.06.22
12,Angels,Thomas Rhett,4133,267,3866,145,0,14784600,1685100,13099500,1950752,2023.06.22
13,Girl In Mine,Parmalee,3774,215,3559,144,0,12962100,1360000,11602100,3445334,2023.06.22
14,Religiously,Bailey Zimmerman,3224,598,2626,145,0,11826100,2523600,9302500,9861075,2023.06.22
15,Drinkaby,Cole Swindell,3397,361,3036,145,0,10939900,1534700,9405200,2698126,2023.06.22
16,Standing Room Only,Tim McGraw,3183,220,2963,145,0,9809500,923300,8886200,2598681,2023.06.22
17,Everything She Ain't,Hailey Whitters,3035,9,3026,145,0,9243900,36000,9207900,2812212,2023.06.22
18,Looking For You,Chris Young,2901,212,2689,145,0,8926100,992700,7933400,2786134,2023.06.22
19,But I Got A Beer In My Hand,Luke Bryan,2453,513,1940,142,0,8727600,1914000,6813600,2817617,2023.06.22
20,Can'T Have Mine,Dylan Scott,2531,137,2394,144,0,7025100,578600,6446500,3095051,2023.06.22
21,God Gave Me A Girl,Russell Dickerson,2217,267,1950,139,0,6853200,1230500,5622700,1531904,2023.06.22
22,Something In The Orange,Zach Bryan,2280,46,2234,135,0,6789000,-42700,6831700,15804904,2023.06.22
23,Watermelon Moonshine,Lainey Wilson,1946,450,1496,141,0,6630100,1442800,5187300,3251108,2023.06.22
24,We Don'T Fight Anymore,Carly Pearce,1428,1422,6,106,0,6190400,6178600,11800,3205449,2023.06.22
25,If You Go Down (I'M Going Down Too),Kelsea Ballerini,2416,390,2026,145,0,6101700,1194500,4907200,2480053,2023.06.22
26,Try That In A Small Town,Jason Aldean,1504,62,1442,125,0,5195900,612400,4583500,1755871,2023.06.22
27,All I Need Is You,Chris Janson,2060,160,1900,137,0,4832200,587800,4244400,1265762,2023.06.22
28,We Got History,Mitchell Tenpenny,1626,173,1453,133,0,4787300,702900,4084400,2243559,2023.06.22
29,Stars Like Confetti,Dustin Lynch,1826,93,1733,137,0,4623500,173300,4450200,1674189,2023.06.22
30,Light On In The Kitchen,Ashley McBryde,1698,146,1552,141,0,3972500,442300,3530200,1141129,2023.06.22
31,Nobody's Nobody,Brothers Osborne,1271,-51,1322,134,0,3218900,32700,3186200,1691009,2023.06.22
32,Mind On You,George Birge,1288,57,1231,135,0,3146500,337900,2808600,199277,2023.06.22
33,23,Chayce Beckham,1256,152,1104,104,0,2975800,116900,2858900,2674022,2023.06.22
34,Creek Will Rise,Conner Smith,1509,205,1304,141,0,2917700,219100,2698600,1047691,2023.06.22
35,Fearless,Jackson Dean,1424,86,1338,141,0,2870200,65800,2804400,1033252,2023.06.22
36,Different 'Round Here,Riley Green,967,48,919,98,0,2728900,174900,2554000,1707123,2023.06.22
37,Heaven By Then,Brantley Gilbert & Blake Shelton Feat. Vince Gill,1285,100,1185,137,0,2454400,-7900,2462300,729820,2023.06.22
38,Glory Days,Gabby Barrett,830,-143,973,98,0,2408100,-1859000,4267100,1358907,2023.06.22
39,Fires Don'T Start Themselves,Darius Rucker,882,60,822,94,0,2360200,160000,2200200,985997,2023.06.22
40,If He Wanted To He Would,Kylie Morgan,1201,28,1173,130,0,2344200,-172800,2517000,2326585,2023.06.22
41,See You Next Summer,Brian Kelley,811,60,751,87,0,2067900,-165100,2233000,388674,2023.06.22
42,Truck Bed,Hardy,770,65,705,72,0,1908900,455400,1453500,5856994,2023.06.22
43,On The Boat Again,Jake Owen,626,93,533,87,0,1742000,313500,1428500,634810,2023.06.22
44,Over For You,Morgan Evans,729,38,691,69,0,1649500,-32700,1682200,2153748,2023.06.22
45,Thinkin' Bout Me,Morgan Wallen,484,89,395,24,0,1601700,308500,1293200,14580912,2023.06.22
46,Save Me (With Lainey Wilson),Jelly Roll,379,-20,399,33,0,1455400,219000,1236400,5701194,2023.06.22
47,Drive You Out Of My Mind,Kassi Ashton,711,37,674,74,0,1445000,157700,1287300,1159312,2023.06.22
48,Everything I Love,Morgan Wallen,339,243,96,32,0,1432500,959700,472800,4747908,2023.06.22
49,Out Of That Truck,Carrie Underwood,509,75,434,54,0,1387400,261500,1125900,3032809,2023.06.22
50,Giving Up On That,Dalton Dover,722,-12,734,81,0,1345600,54900,1290700,1613338,2023.06.22
51,Shoot Tequila,Tigirlily Gold,557,37,520,63,0,1113300,138100,975200,307694,2023.06.22
52,Bout Damn Time,Neon Union,613,24,589,65,0,956400,60700,895700,51306,2023.06.22
53,Burn It Down,Parker Mccollum,269,139,130,49,0,939900,384400,555500,3137210,2023.06.22
54,World On Fire,Nate Smith,502,65,437,61,0,917300,179400,737900,2888934,2023.06.22
55,Somebody Else's Whiskey,Frank Ray,537,26,511,61,0,913800,67800,846000,29668,2023.06.22
56,Bad Day To Be A Cold Beer,Chase Rice,477,23,454,55,0,871100,34900,836200,303358,2023.06.22
57,Marry That Girl,Easton Corbin,496,34,462,62,0,847500,32000,815500,163879,2023.06.22
58,If I Die Young (Pt. 2),Kimberly Perry,431,1,430,81,0,804500,-4600,809100,1701257,2023.06.22
59,Love You Again,Chase Matthew,337,-1,338,49,0,649000,5900,643100,2848726,2023.06.22
60,Jealous Of Myself,Tenille Arts,377,33,344,53,0,586900,69000,517900,60600,2023.06.22
61,'98 Braves,Morgan Wallen,93,2,91,3,0,578000,7100,570900,3763748,2023.06.22
62,Without You,Thompson Square,399,33,366,61,0,577900,111600,466300,23181,2023.06.22
63,Along For The Ride,Jordan Harvey,276,-25,301,48,0,315100,-9900,325000,66836,2023.06.22
64,Lawless,Caroline Jones,57,12,45,56,0,304700,204400,100300,56027,2023.06.22
65,Life Goes On,Ed Sheeran,43,-6,49,3,0,301000,-15000,316000,2403362,2023.06.22
66,Save The Roses,Lee Brice,168,6,162,26,0,269500,73400,196100,873870,2023.06.22
67,I Just Killed A Man,Catie Offerman,232,23,209,31,0,265500,-1000,266500,102173,2023.06.22
68,Buy A Bar,Tim Dugger,134,-22,156,21,0,263700,-34700,298400,24367,2023.06.22
69,Heart To Break,Ryan Griffin,218,9,209,28,0,214200,-26400,240600,194764,2023.06.22
70,Trouble,Josh Ross,216,112,104,42,0,210000,122500,87500,1472905,2023.06.22
71,So Will I,Phillip Phillips,37,,,37,0,175200,,,114304,2023.06.22
72,How Is She,Cole Swindell,27,0,27,2,0,171300,-21400,192700,93312,2023.06.22
73,Wine Country,Hannah Ellis,72,63,9,28,0,146600,120200,26400,55291,2023.06.22
74,Drink One For Me,Hardy,14,-1,15,1,0,137800,7300,130500,197971,2023.06.22
75,Brokenhearted,Joe Nichols,71,53,18,13,0,136700,86100,50600,14270,2023.06.22
76,Make You Mine,Marynn Taylor,183,-5,188,31,0,136000,-7700,143700,69581,2023.06.22
77,Lovin You Gets In The Way,Ben Gallaher,93,-5,98,16,0,130300,-1800,132100,9635,2023.06.22
78,5 Leaf Clover,Luke Combs,21,1,20,3,0,118300,24700,93600,3541034,2023.06.22
79,Oklahoma Smokeshow,Zach Bryan,33,-5,38,2,0,115400,-34900,150300,4781240,2023.06.22
80,Psychopath,Morgan Wade,49,,,48,0,111600,,,307640,2023.06.22
81,Sun To Me,Zach Bryan,41,-6,47,4,0,107700,-41700,149400,4180900,2023.06.22
82,Colorado,Florida Georgia Line,18,4,14,2,0,107600,11800,95800,74316,2023.06.22
83,With You I Am,Cody Johnson,8,0,8,2,0,106500,34200,72300,1279376,2023.06.22
84,Anybody But You,Lauren Watkins,49,,,48,0,106300,,,40027,2023.06.22
85,Pretty Little Poison,Warren Zeiders,47,16,31,6,0,102700,44800,57900,3328266,2023.06.22
86,Wasting All These Tears,Austin Snell,13,0,13,2,0,101300,18600,82700,880689,2023.06.22
87,Fix A Drink (Live 2023),Chris Janson,46,,,46,0,89100,,,0,2023.06.22
87,Buy Me A Boat (Live 2023),Chris Janson,46,,,46,0,89100,,,0,2023.06.22
87,Every Day Of The Week,Chris Janson,46,,,46,0,89100,,,0,2023.06.22
87,Outlaw Side Of Me,Chris Janson,46,,,46,0,89100,,,0,2023.06.22
87,Good Vibes (Live 2023),Chris Janson,46,,,46,0,89100,,,0,2023.06.22
92,Grease,Lainey Wilson,23,-4,27,2,0,87600,-15500,103100,256872,2023.06.22
93,Thicc As Thieves,Lauren Alaina,35,21,14,9,0,81800,42600,39200,667161,2023.06.22
94,Damn Love,Kip Moore,139,-17,156,25,0,81400,-26900,108300,750197,2023.06.22
95,Best Of Me,David Nail,23,1,22,1,0,77800,5200,72600,13201,2023.06.22
96,One Of Us,Matt Stell,18,4,14,3,0,72100,42100,30000,771198,2023.06.22
97,Cowgirls,Morgan Wallen,28,21,7,16,0,63900,36600,27300,7110250,2023.06.22
98,Ain't That Some,Morgan Wallen,19,-3,22,3,0,63100,2900,60200,6369271,2023.06.22
99,A Walk In The Bar,Lauren Alaina,16,-8,24,1,0,61900,-61600,123500,692553,2023.06.22
100,Tulsa,Elle King,23,-1,24,2,0,59200,200,59000,74789,2023.06.22
101,Daylight Savings,Kidd G,31,-58,89,18,0,52100,-59100,111200,271448,2023.06.22
102,I'M Not For Everyone,Brothers Osborne,15,7,8,3,0,48200,7900,40300,530324,2023.06.22
103,Out Of Nowhere,Walker Montgomery,11,0,11,1,0,48000,3600,44400,15173,2023.06.22
104,Something Real,Dierks Bentley,20,15,5,6,0,47900,24400,23500,443800,2023.06.22
105,You In A Honky Tonk,Randall King,4,-1,5,2,0,47800,2400,45400,517611,2023.06.22
106,Drinkin' Problems,Dillon Carmichael,25,,,8,0,46300,,,191302,2023.06.22
107,A Special Place,Danielle Bradbery,36,-9,45,7,0,45700,-46900,92600,377487,2023.06.22
108,The Star-Spangled Banner,Chris Stapleton,13,-2,15,11,0,45500,-52200,97700,0,2023.06.22
109,Question The Universe,Teddy Robb,78,22,56,19,0,43600,11400,32200,8060,2023.06.22
110,I Hope Heaven,Karissa Ella,76,16,60,19,0,43200,10300,32900,0,2023.06.22
111,Firebird,Jordan Fletcher,76,1,75,19,0,43200,200,43000,5149,2023.06.22
112,"Love, Beer",Andrew Sevener,76,0,76,19,0,43200,0,43200,1590,2023.06.22
113,We Ain't The Only Ones,Randy Rogers & Wade Bowen,4,2,2,2,0,42900,22700,20200,0,2023.06.22
114,Sun Sets In Colorado,Dierks Bentley,15,-6,21,2,0,40200,-27400,67600,51820,2023.06.22
115,Holy Water,Michael Ray,10,1,9,2,0,37800,-7400,45200,326632,2023.06.22
116,Girl On Fire,Kameron Marlowe,2,0,2,1,0,36400,27400,9000,1000306,2023.06.22
117,Lovin' Where It's Goin',Josh Ward,2,,,1,0,33200,,,46063,2023.06.22
118,I'M Not Pretty,Megan Moroney,14,7,7,13,0,33000,13500,19500,2002448,2023.06.22
119,3 Tequila Floor,Josiah Siska,25,-14,39,6,0,33000,-11200,44200,13454,2023.06.22
120,Whatcha Looking At,Curves,54,13,41,14,0,32800,8400,24400,5244,2023.06.22
121,Too Much Of A Woman,Roberta Lea,58,24,34,19,0,32600,12000,20600,0,2023.06.22
122,Pretender,Sarah Darling,57,-4,61,19,0,32400,-700,33100,570,2023.06.22
123,In Her Shoes,Sophia Scott,57,-18,75,19,0,32400,-10300,42700,6209,2023.06.22
124,Sparkle,Harper Grace,56,-16,72,19,0,32200,-10200,42400,25093,2023.06.22
125,Dance With You,Brett Young,11,,,7,0,32200,,,1939183,2023.06.22
126,Giving You Up,Kameron Marlowe,7,1,6,2,0,31900,2500,29400,1079015,2023.06.22
127,Still,Luke Combs,12,4,8,1,0,31400,-600,32000,649596,2023.06.22
128,Neon You,Don Louis,3,-1,4,1,0,27200,-31900,59100,76341,2023.06.22
129,Heartfirst,Kelsea Ballerini,9,0,9,1,0,27100,-3500,30600,817525,2023.06.22
130,Star Spangled Banner,Abby Anderson,3,-2,5,3,0,26500,500,26000,0,2023.06.22
131,Man Made A Bar,Morgan Wallen,5,1,4,3,0,25700,13500,12200,4793694,2023.06.22
132,Feel For You,Boy Named Banjo,13,4,9,1,0,24900,8300,16600,45917,2023.06.22
133,How I Get High,Josh Kaiser,42,-9,51,14,0,24900,-6400,31300,0,2023.06.22
134,Wrong Side Of A Sunrise,Adam Doleac,10,,,1,0,24700,,,161129,2023.06.22
135,Settle Me Down,Josh Abbott Band,3,2,1,2,0,23300,17200,6100,547369,2023.06.22
136,Forever Bound,12/Oc,12,-1,13,1,0,22900,-6800,29700,7338,2023.06.22
137,For What It's Worth,Breland,12,-1,13,2,0,22700,4200,18500,2448669,2023.06.22
138,Granny's Got A Garden (For G'maw Jan),Kameron Marlowe,2,-1,3,1,0,22700,-4300,27000,0,2023.06.22
139,Feel Like This,Ingrid Andress,28,-45,73,4,0,22200,-40800,63000,1677061,2023.06.22
140,Those Boots (Deddy's Song),Lainey Wilson,4,,,4,0,22100,,,175377,2023.06.22
141,Loud and Heavy,Cody Jinks,8,-5,13,3,0,21900,8900,13000,2051943,2023.06.22
142,Seven Year Ache,Aaron Watson & Jenna Paulette,8,-2,10,2,0,19800,-17300,37100,0,2023.06.22
143,Young Man's Blues,Parker Mccollum,3,-1,4,1,0,19400,-5500,24900,501408,2023.06.22
144,Heart Of A Small Town,Tim Dugger,3,2,1,1,0,19100,10700,8400,21164,2023.06.22
145,More Than Me,Justin Moore,4,,,4,0,18900,,,78775,2023.06.22
146,Tuggin' On My Heartstrings,Randall King,2,-3,5,1,0,18800,-24000,42800,23541,2023.06.22
147,I Bet You Think About Me (Taylor's Version) (From The Vault),Taylor Swift Feat. Chris Stapleton,4,,,2,0,18700,,,1178881,2023.06.22
148,"Salt, Lime & Tequila",Ryan Griffin,2,0,2,1,0,18200,9500,8700,136796,2023.06.22
149,Wind It Down,Hayden Haddock,1,,,1,0,18200,,,304,2023.06.22
149,Misunderstood,Parker Mccollum,1,,,1,0,18200,,,279380,2023.06.22
151,Stop Coming Over,Chris Lane,7,1,6,6,0,17400,3100,14300,53715,2023.06.22
152,Heartless,Diplo & Julia Michaels Feat. Morgan Wallen,3,1,2,3,0,17300,7600,9700,6674750,2023.06.22
153,Songs We Used To Sing,Ernest,6,-6,12,1,0,16600,-8000,24600,87901,2023.06.22
154,Longneck Way To Go,Midland Feat. Jon Pardi,5,-5,10,1,0,16100,-34200,50300,193824,2023.06.22
155,Something's Gonna Kill Me,Corey Kent,3,,,2,0,15600,,,3802601,2023.06.22
156,Any Given Friday Night,Luke Combs,2,0,2,1,0,15200,0,15200,343093,2023.06.22
157,Me And Jack,Jon Pardi,2,,,1,0,15200,,,78620,2023.06.22
158,Am I The Only One,Aaron Lewis,3,0,3,3,0,14500,3700,10800,800316,2023.06.22
159,When Will I Be Loved,"Ashley McBryde, Caylee Hammack & Pillbox Patti",6,1,5,6,0,14300,3100,11200,43646,2023.06.22
160,Hungover You,Emily Brooke,6,0,6,6,0,14300,0,14300,831,2023.06.22
161,Halfway To Hell,Jelly Roll,6,,,6,0,14300,,,2664651,2023.06.22
161,Peaked In High School,Priscilla Block,6,,,6,0,14300,,,19174,2023.06.22
161,Every Single Summer,Marynn Taylor,6,,,6,0,14300,,,3328,2023.06.22
164,National Anthem From Battle At Bristol,Jennifer Nettles,4,0,4,4,0,13700,-9800,23500,0,2023.06.22
165,One Name,Jeff & Sheri Easter,2,0,2,2,0,13300,900,12400,20146,2023.06.22
166,Scars In Heaven,Nelons,2,1,1,2,0,12800,7500,5300,5514,2023.06.22
167,My Bar,Priscilla Block,3,-2,5,3,0,12800,-5200,18000,214219,2023.06.22
168,Can I Get A Witness,Sound,2,,,2,0,12800,,,2611,2023.06.22
169,Think About There,Greater Vision,2,1,1,2,0,12400,7500,4900,2633,2023.06.22
169,The Building,Emily Ann Roberts,2,1,1,2,0,12400,7500,4900,49257,2023.06.22
171,I Call It Home,Tribute Quartet,2,,,2,0,12400,,,1529,2023.06.22
172,The Night You Walked Away,Costello,2,1,1,1,0,12200,6100,6100,37,2023.06.22
173,"The Father, My Son, And The Holy Ghost",Craig Morgan,2,,,1,0,11600,,,61149,2023.06.22
174,I Wrote The Book,Morgan Wallen,2,,,2,0,11500,,,5521653,2023.06.22
175,White House Road,Tyler Childers & The Highwall,3,-1,4,1,0,11300,500,10800,3098505,2023.06.22
176,When It Comes To Loving You,Jon Langston,2,0,2,2,0,11000,-5800,16800,131233,2023.06.22
177,Waxahachie,Miranda Lambert,8,-2,10,1,0,10800,-1400,12200,83429,2023.06.22
178,Wild as You,Cody Johnson,3,0,3,3,0,10500,-5100,15600,1186141,2023.06.22
179,That Heavenly Home,Tribute Quartet,2,1,1,2,0,10200,4900,5300,1478,2023.06.22
180,Inside And Out,Tyler Hubbard,3,2,1,2,0,9900,6800,3100,112270,2023.06.22
181,You'Re Gonna Love Me,Tim Dugger,2,0,2,1,0,9700,7100,2600,10998,2023.06.22
182,Better Off,Trace Adkins,2,-1,3,1,0,9700,-3200,12900,16836,2023.06.22
183,Star Spangled Banner,Demi Lovato,1,0,1,1,0,9400,7900,1500,100,2023.06.22
184,Get To Gettin’ Gone,Bailey Zimmerman,3,0,3,1,0,9300,0,9300,1617690,2023.06.22
185,Cover Me Up,Morgan Wallen,2,-1,3,2,0,9300,1400,7900,4807257,2023.06.22
186,I'm Feelin' Good (Steve Miller Band),King Calaway,16,-5,21,1,0,9300,-11200,20500,2787,2023.06.22
187,The Man Who Loves You The Most,Zac Brown Band,1,,,1,0,9200,,,90630,2023.06.22
188,Nothin' On You,Cody Johnson,2,0,2,1,0,8800,0,8800,1287091,2023.06.22
189,BELLS,Rachelle Garniez,1,0,1,1,0,8700,0,8700,0,2023.06.22
190,Love Is Real,Morgan Evans,4,-1,5,1,0,8600,-4700,13300,64257,2023.06.22
191,Soundtrack To A Small Town Sundown,Tyler Farr,1,0,1,1,0,8400,7100,1300,14712,2023.06.22
192,Joy Unspeakable,Kim Hopper,1,0,1,1,0,8400,3500,4900,160,2023.06.22
193,Silverado For Sale,Morgan Wallen,1,,,1,0,8400,,,1564510,2023.06.22
193,Breakthrough,Browns,1,,,1,0,8400,,,9449,2023.06.22
193,I'Ll Fly Away,Randall King,1,,,1,0,8400,,,34121,2023.06.22
196,By The Mark In His Hands,Doyle Lawson & Quicksilver,1,,,1,0,8100,,,0,2023.06.22
197,Paradise To Me,Niko Moon,4,2,2,1,0,7600,3500,4100,671283,2023.06.22
198,Nervous,Maren Morris,1,,,1,0,7600,,,64852,2023.06.22
198,Workin' On It,Michael Ray,1,,,1,0,7600,,,169740,2023.06.22
200,God Only Knows,for King & Country,1,-2,3,1,0,7500,-10600,18100,1115319,2023.06.22
201,My Jesus,Anne Wilson,1,,,1,0,7500,,,1337149,2023.06.22
201,Chain Breaker,Triumphant Quartet,1,,,1,0,7500,,,0,2023.06.22
201,PEACE LIKE A RIVER,Master's Voice,1,,,1,0,7500,,,203,2023.06.22
201,Looks Like Jesus,Brian Free & Assurance,1,,,1,0,7500,,,2117,2023.06.22
201,Gettin' Ready To Breathe,Wes Hampton,1,,,1,0,7500,,,21390,2023.06.22
201,Give It To Jesus,3 Heath Brothers,1,,,1,0,7500,,,468,2023.06.22
1,Fast Car,Luke Combs,8251,545,7706,145,0,33355600,2255400,31100200,22551816,2023.06.29
2,Next Thing You Know,Jordan Davis,8405,478,7927,145,0,33111600,2294200,30817400,8923214,2023.06.29
3,Last Night,Morgan Wallen,7895,5,7890,145,0,32840700,-28100,32868800,30514107,2023.06.29
4,Dancin' In The Country,Tyler Hubbard,6226,-146,6372,145,0,28129100,-178400,28307500,6762504,2023.06.29
5,Memory Lane,Old Dominion,6550,311,6239,145,0,25332500,1458300,23874200,8637147,2023.06.29
6,"You, Me, And Whiskey",Justin Moore & Priscilla Block,6067,485,5582,145,0,22420000,2039300,20380700,3380023,2023.06.29
7,Need A Favor,Jelly Roll,6118,603,5515,144,0,22398000,2818500,19579500,11567413,2023.06.29
8,Your Heart Or Mine,Jon Pardi,5457,339,5118,145,0,19453600,1149400,18304200,4121301,2023.06.29
9,Love You Anyway,Luke Combs,5011,196,4815,145,0,18297700,867100,17430600,7296025,2023.06.29
10,Bury Me In Georgia,Kane Brown,4695,504,4191,145,0,18290800,2003900,16286900,6755697,2023.06.29
11,Angels,Thomas Rhett,4196,63,4133,145,0,15401400,616800,14784600,1981415,2023.06.29
12,Girl In Mine,Parmalee,3903,129,3774,144,0,13794000,831900,12962100,2934555,2023.06.29
13,Religiously,Bailey Zimmerman,3344,120,3224,145,0,12514300,688200,11826100,10748484,2023.06.29
14,Drinkaby,Cole Swindell,3431,34,3397,145,0,11350200,410300,10939900,2579915,2023.06.29
15,Standing Room Only,Tim McGraw,3270,87,3183,145,0,10350900,541400,9809500,3293934,2023.06.29
16,Looking For You,Chris Young,3193,292,2901,145,0,10195800,1269700,8926100,2407886,2023.06.29
17,But I Got A Beer In My Hand,Luke Bryan,2728,275,2453,143,0,9672200,944600,8727600,2660553,2023.06.29
18,Everything She Ain't,Hailey Whitters,3125,90,3035,145,0,9513300,269400,9243900,2762258,2023.06.29
19,God Gave Me A Girl,Russell Dickerson,2402,185,2217,140,0,8077500,1224300,6853200,1475555,2023.06.29
20,Can'T Have Mine,Dylan Scott,2699,168,2531,145,0,7983700,958600,7025100,3195557,2023.06.29
21,Watermelon Moonshine,Lainey Wilson,2251,305,1946,140,0,7336700,706600,6630100,4626585,2023.06.29
22,If You Go Down (I'M Going Down Too),Kelsea Ballerini,2630,214,2416,145,0,7156100,1054400,6101700,2521265,2023.06.29
23,Something In The Orange,Zach Bryan,2209,-71,2280,135,0,6818100,29100,6789000,16165734,2023.06.29
24,Try That In A Small Town,Jason Aldean,1597,93,1504,128,0,5268300,72400,5195900,1623295,2023.06.29
25,Stars Like Confetti,Dustin Lynch,1951,125,1826,138,0,5246700,623200,4623500,1683015,2023.06.29
26,We Got History,Mitchell Tenpenny,1669,43,1626,133,0,5157400,370100,4787300,2199237,2023.06.29
27,All I Need Is You,Chris Janson,2101,41,2060,138,0,5042700,210500,4832200,1118292,2023.06.29
28,Light On In The Kitchen,Ashley McBryde,1871,173,1698,142,0,4612700,640200,3972500,1215021,2023.06.29
29,Nobody's Nobody,Brothers Osborne,1402,131,1271,134,0,3526700,307800,3218900,1749840,2023.06.29
30,23,Chayce Beckham,1292,36,1256,110,0,3408200,432400,2975800,2745583,2023.06.29
31,Creek Will Rise,Conner Smith,1499,-10,1509,143,0,3290300,372600,2917700,1143130,2023.06.29
32,Everything I Love,Morgan Wallen,781,442,339,76,0,3213600,1781100,1432500,4798937,2023.06.29
33,Fearless,Jackson Dean,1527,103,1424,142,0,3110000,239800,2870200,1089008,2023.06.29
34,Mind On You,George Birge,1316,28,1288,135,0,3058100,-88400,3146500,197377,2023.06.29
35,Glory Days,Gabby Barrett,957,127,830,111,0,2962100,554000,2408100,2109375,2023.06.29
36,Different 'Round Here,Riley Green,972,5,967,94,0,2755100,26200,2728900,1764258,2023.06.29
37,Fires Don'T Start Themselves,Darius Rucker,925,43,882,98,0,2370500,10300,2360200,1071061,2023.06.29
38,See You Next Summer,Brian Kelley,879,68,811,94,0,2270700,202800,2067900,350347,2023.06.29
39,Heaven By Then,Brantley Gilbert & Blake Shelton Feat. Vince Gill,1113,-172,1285,136,0,2235000,-219400,2454400,708399,2023.06.29
40,Truck Bed,Hardy,816,46,770,77,0,2185800,276900,1908900,5639452,2023.06.29
41,On The Boat Again,Jake Owen,674,48,626,87,0,1866500,124500,1742000,823649,2023.06.29
42,Over For You,Morgan Evans,693,-36,729,69,0,1684200,34700,1649500,1791403,2023.06.29
43,Thinkin' Bout Me,Morgan Wallen,485,1,484,27,0,1614200,12500,1601700,15041387,2023.06.29
44,Out Of That Truck,Carrie Underwood,602,93,509,60,0,1588900,201500,1387400,3299299,2023.06.29
45,Drive You Out Of My Mind,Kassi Ashton,723,12,711,76,0,1501400,56400,1445000,1099155,2023.06.29
46,Save Me (With Lainey Wilson),Jelly Roll,372,-7,379,29,0,1390200,-65200,1455400,5435349,2023.06.29
47,Giving Up On That,Dalton Dover,733,11,722,80,0,1374300,28700,1345600,1069779,2023.06.29
48,World On Fire,Nate Smith,592,90,502,64,0,1360700,443400,917300,4218991,2023.06.29
49,Burn It Down,Parker Mccollum,444,175,269,53,0,1353900,414000,939900,3062796,2023.06.29
50,We Don'T Fight Anymore,Carly Pearce,561,-867,1428,82,0,1303800,-4886600,6190400,2737945,2023.06.29
51,Shoot Tequila,Tigirlily Gold,546,-11,557,64,0,1160200,46900,1113300,956031,2023.06.29
52,Bout Damn Time,Neon Union,634,21,613,74,0,1129000,172600,956400,50874,2023.06.29
53,Somebody Else's Whiskey,Frank Ray,544,7,537,63,0,945800,32000,913800,33954,2023.06.29
54,Marry That Girl,Easton Corbin,512,16,496,60,0,927100,79600,847500,166558,2023.06.29
55,Bad Day To Be A Cold Beer,Chase Rice,483,6,477,58,0,855400,-15700,871100,301207,2023.06.29
56,If I Die Young (Pt. 2),Kimberly Perry,425,-6,431,91,0,729100,-75400,804500,1440165,2023.06.29
57,Jealous Of Myself,Tenille Arts,401,24,377,51,0,700300,113400,586900,55931,2023.06.29
58,Love You Again,Chase Matthew,333,-4,337,38,0,676900,27900,649000,2910796,2023.06.29
59,Without You,Thompson Square,402,3,399,53,0,603800,25900,577900,24336,2023.06.29
60,'98 Braves,Morgan Wallen,90,-3,93,2,0,572500,-5500,578000,3955523,2023.06.29
61,Save The Roses,Lee Brice,213,45,168,34,0,511400,241900,269500,744483,2023.06.29
62,Make Me Wanna Smoke,Runaway June,57,,,56,0,302900,,,39418,2023.06.29
63,Buy A Bar,Tim Dugger,133,-1,134,20,0,279500,15800,263700,24253,2023.06.29
64,Along For The Ride,Jordan Harvey,247,-29,276,43,0,275800,-39300,315100,59333,2023.06.29
65,Trouble,Josh Ross,238,22,216,45,0,269400,59400,210000,1520503,2023.06.29
66,Heart To Break,Ryan Griffin,209,-9,218,42,0,267600,53400,214200,175965,2023.06.29
67,I Just Killed A Man,Catie Offerman,230,-2,232,40,0,255700,-9800,265500,104631,2023.06.29
68,Pretty Little Poison,Warren Zeiders,78,31,47,7,0,240600,137900,102700,3559930,2023.06.29
69,Wine Country,Hannah Ellis,172,100,72,43,0,237700,91100,146600,69266,2023.06.29
70,Brokenhearted,Joe Nichols,150,79,71,25,0,204300,67600,136700,11015,2023.06.29
71,Something Real,Dierks Bentley,104,84,20,32,0,198200,150300,47900,585999,2023.06.29
72,Lovin You Gets In The Way,Ben Gallaher,97,4,93,16,0,192900,62600,130300,11542,2023.06.29
73,Drink One For Me,Hardy,19,5,14,1,0,189500,51700,137800,193384,2023.06.29
74,Make You Mine,Marynn Taylor,218,35,183,40,0,175800,39800,136000,80771,2023.06.29
75,How Is She,Cole Swindell,25,-2,27,1,0,163700,-7600,171300,85286,2023.06.29
76,Dance With You,Brett Young,102,91,11,26,0,133600,101400,32200,1897797,2023.06.29
77,Life Goes On,Ed Sheeran,19,-24,43,2,0,132500,-168500,301000,2613423,2023.06.29
78,Oklahoma Smokeshow,Zach Bryan,30,-3,33,3,0,117000,1600,115400,4788121,2023.06.29
79,Best Of Me,David Nail,35,12,23,1,0,114800,37000,77800,12480,2023.06.29
80,"If You See Him, If You See Her (2023)",Reba McEntire/ Brooks & Dunn,48,,,47,0,107200,,,0,2023.06.29
81,Chameleon,Alana Springsteen,48,,,48,0,107100,,,12491,2023.06.29
82,Drinkin' Problems,Dillon Carmichael,67,42,25,19,0,105600,59300,46300,124973,2023.06.29
83,Colorado,Florida Georgia Line,16,-2,18,2,0,104700,-2900,107600,72281,2023.06.29
84,5 Leaf Clover,Luke Combs,16,-5,21,1,0,96100,-22200,118300,3098778,2023.06.29
85,One Of Us,Matt Stell,21,3,18,4,0,95400,23300,72100,869659,2023.06.29
86,Penthouse,Kelsea Ballerini,48,,,48,0,92000,,,1247679,2023.06.29
87,Wasting All These Tears,Austin Snell,13,0,13,1,0,85100,-16200,101300,845726,2023.06.29
88,Sun To Me,Zach Bryan,39,-2,41,4,0,84900,-22800,107700,4372859,2023.06.29
89,Damn Love,Kip Moore,116,-23,139,23,0,81200,-200,81400,695556,2023.06.29
90,Reason For A Rita,Smithfield,15,,,14,0,76600,,,6311,2023.06.29
91,A Walk In The Bar,Lauren Alaina,19,3,16,2,0,76000,14100,61900,595335,2023.06.29
92,Young Man's Blues,Parker Mccollum,5,2,3,2,0,71600,52200,19400,498790,2023.06.29
93,Grease,Lainey Wilson,27,4,23,3,0,69200,-18400,87600,250775,2023.06.29
94,A Special Place,Danielle Bradbery,39,3,36,8,0,68300,22600,45700,341700,2023.06.29
95,Lovin' Where It's Goin',Josh Ward,4,2,2,1,0,68000,34800,33200,41830,2023.06.29
96,Cowgirls,Morgan Wallen,30,2,28,15,0,67600,3700,63900,7221841,2023.06.29
97,Wrong Side Of A Sunrise,Adam Doleac,26,16,10,1,0,66000,41300,24700,283575,2023.06.29
98,Cold Feet,Tenille Arts,10,,,10,0,64600,,,5621,2023.06.29
98,Praise The Lord,Breland,10,,,10,0,64600,,,231484,2023.06.29
100,Tulsa,Elle King,23,0,23,2,0,59900,700,59200,73906,2023.06.29
101,Ain't That Some,Morgan Wallen,17,-2,19,1,0,59800,-3300,63100,6605815,2023.06.29
102,Thicc As Thieves,Lauren Alaina,28,-7,35,2,0,58200,-23600,81800,891313,2023.06.29
103,With You I Am,Cody Johnson,4,-4,8,1,0,55500,-51000,106500,1296648,2023.06.29
104,Something's Gonna Kill Me,Corey Kent,16,13,3,3,0,55100,39500,15600,3763254,2023.06.29
105,Heartfirst,Kelsea Ballerini,15,6,9,2,0,54000,26900,27100,764162,2023.06.29
106,The Star-Spangled Banner,Chris Stapleton,11,-2,13,11,0,49500,4000,45500,0,2023.06.29
107,Neon You,Don Louis,5,2,3,2,0,43500,16300,27200,78014,2023.06.29
108,Question The Universe,Teddy Robb,77,-1,78,19,0,43400,-200,43600,7837,2023.06.29
109,"Love, Beer",Andrew Sevener,75,-1,76,19,0,43000,-200,43200,1135,2023.06.29
110,The Star-Spangled Banner,Carly Pearce,4,3,1,4,0,42600,36400,6200,0,2023.06.29
111,Granny's Got A Garden (For G'maw Jan),Kameron Marlowe,4,2,2,1,0,41500,18800,22700,0,2023.06.29
112,Holy Water,Michael Ray,8,-2,10,1,0,41300,3500,37800,325353,2023.06.29
113,Out Of Nowhere,Walker Montgomery,10,-1,11,1,0,40800,-7200,48000,16144,2023.06.29
114,Sun Sets In Colorado,Dierks Bentley,15,0,15,2,0,40200,0,40200,45133,2023.06.29
115,Still,Luke Combs,11,-1,12,1,0,34100,2700,31400,613814,2023.06.29
116,First Rodeo,Daves Highway,58,,,19,0,32600,,,943,2023.06.29
117,Pretender,Sarah Darling,57,0,57,19,0,32400,0,32400,406,2023.06.29
118,Honey!,Rayne Johnson,57,,,19,0,32400,,,39018,2023.06.29
119,Too Much Of A Woman,Roberta Lea,55,-3,58,19,0,32000,-600,32600,0,2023.06.29
120,I Hope Heaven,Karissa Ella,55,-21,76,19,0,32000,-11200,43200,0,2023.06.29
121,Giving You Up,Kameron Marlowe,8,1,7,2,0,31500,-400,31900,1045311,2023.06.29
122,3 Tequila Floor,Josiah Siska,24,-1,25,4,0,29100,-3900,33000,12174,2023.06.29
123,Polaroid,Keith Urban,12,,,6,0,28600,,,19330,2023.06.29
124,Daylight Savings,Kidd G,16,-15,31,3,0,28400,-23700,52100,224714,2023.06.29
125,Better Off,Trace Adkins,5,3,2,1,0,26900,17200,9700,17116,2023.06.29
126,Forever Bound,12/Oc,12,0,12,1,0,26600,3700,22900,5454,2023.06.29
127,Codigo,George Strait,2,,,1,0,25400,,,36371,2023.06.29
128,Whatcha Looking At,Curves,43,-11,54,14,0,25100,-7700,32800,5223,2023.06.29
129,Tuggin' On My Heartstrings,Randall King,4,2,2,1,0,24700,5900,18800,24764,2023.06.29
130,How I Get High,Josh Kaiser,41,-1,42,14,0,24700,-200,24900,0,2023.06.29
131,So Many Summers,Brad Paisley,3,,,3,0,22700,,,1294803,2023.06.29
132,So Will I,Phillip Phillips,10,-27,37,9,0,21600,-153600,175200,122338,2023.06.29
133,Star Spangled Banner,Mickey Guyton,4,3,1,4,0,20200,17800,2400,0,2023.06.29
134,Songs We Used To Sing,Ernest,9,3,6,1,0,20100,3500,16600,84800,2023.06.29
135,June In July,Robby Johnson,4,,,4,0,20100,,,10528,2023.06.29
136,Does He Love You,Reba Mcentire W/ Dolly Parton,1,,,1,0,19600,,,0,2023.06.29
137,I'm Feelin' Good (Steve Miller Band),King Calaway,20,4,16,7,0,19500,10200,9300,2938,2023.06.29
138,Spirits And Demons,Michael Ray,8,,,8,0,19300,,,0,2023.06.29
139,I Should Have Married You,Old Dominion,4,,,4,0,18900,,,1679320,2023.06.29
140,You In A Honky Tonk,Randall King,3,-1,4,1,0,18800,-29000,47800,531695,2023.06.29
141,For What It's Worth,Breland,13,1,12,2,0,18500,-4200,22700,2057240,2023.06.29
142,Picture Frames,Randy Rogers Band,1,,,1,0,18200,,,10936,2023.06.29
142,Should'Ve Known Better,Erin Viancourt,1,,,1,0,18200,,,14521,2023.06.29
142,Leave Her Wild,Sundance Head,1,,,1,0,18200,,,5147,2023.06.29
142,Built Different,Casey Donahew,1,,,1,0,18200,,,62228,2023.06.29
142,Boy From Anderson County,Kolby Cooper,1,,,1,0,18200,,,41320,2023.06.29
142,Ain't It Baby (Live at Billy Bob's Texas),Josh Ward,1,,,1,0,18200,,,980,2023.06.29
148,House Fire,Tyler Childers,5,3,2,1,0,17300,10700,6600,1209401,2023.06.29
149,Nothin' On You,Cody Johnson,2,0,2,1,0,16800,8000,8800,1235054,2023.06.29
150,You'Re Gonna Love Me,Tim Dugger,2,0,2,1,0,15900,6200,9700,9459,2023.06.29
151,It's A Great Day To Be Alive (Live),Sam Hunt,3,,,2,0,15600,,,0,2023.06.29
152,Star Spangled Banner,Abby Anderson,3,0,3,3,0,15500,-11000,26500,1,2023.06.29
153,Better With You,Niko Moon,5,,,1,0,15500,,,487273,2023.06.29
154,Longneck Way To Go,Midland Feat. Jon Pardi,4,-1,5,1,0,15300,-800,16100,187459,2023.06.29
155,Any Given Friday Night,Luke Combs,2,0,2,1,0,15200,0,15200,350499,2023.06.29
156,Lucky,Megan Moroney,6,4,2,2,0,14800,12800,2000,324072,2023.06.29
157,When It Comes To Loving You,Jon Langston,3,1,2,1,0,14800,3800,11000,129858,2023.06.29
158,Feel Like This,Ingrid Andress,22,-6,28,5,0,14800,-7400,22200,1700747,2023.06.29
159,That's Why We Fight,Ella Langley & Koe Wetzel,9,,,1,0,14400,,,1140002,2023.06.29
160,Hungover You,Emily Brooke,6,0,6,6,0,14300,0,14300,1011,2023.06.29
161,Wild as You,Cody Johnson,2,-1,3,2,0,14300,3800,10500,1180605,2023.06.29
162,Get Her Back,Michael Ray,6,,,6,0,14300,,,222108,2023.06.29
162,Just Drive,Erin Kinsey,6,,,6,0,14300,,,156397,2023.06.29
162,Goodbye Looks Good On You,Alana Springsteen Feat. Mitchell Tenpenny,6,,,6,0,14300,,,1377693,2023.06.29
165,Star Spangled Banner,Marlana Vanhoose,2,,,2,0,14300,,,0,2023.06.29
166,Love Is Real,Morgan Evans,7,3,4,2,0,14100,5500,8600,60806,2023.06.29
167,The Weight Of The Badge,George Strait,3,,,2,0,14000,,,57443,2023.06.29
168,Martha Divine,Ashley McBryde,6,4,2,2,0,13800,10300,3500,101212,2023.06.29
169,The Star Spangled Banner,Locash,1,,,1,0,13700,,,0,2023.06.29
170,Don't Think Jesus,Morgan Wallen,2,1,1,2,0,13100,12400,700,1884912,2023.06.29
171,Sometimes She Stays,Kip Moore,7,,,2,0,13000,,,179612,2023.06.29
172,I Can Lie (The Truth Is),Kameron Marlowe,2,1,1,2,0,12800,11400,1400,659799,2023.06.29
173,Testify,Legacy Five,2,,,2,0,12800,,,17047,2023.06.29
174,Too Soon To Say Goodbye,Wayland,24,,,18,0,12600,,,497,2023.06.29
175,One Name,Jeff & Sheri Easter,2,0,2,2,0,12400,-900,13300,17355,2023.06.29
176,The Night You Walked Away,Costello,2,0,2,1,0,12200,0,12200,39,2023.06.29
177,Heart Of A Small Town,Tim Dugger,3,0,3,1,0,12000,-7100,19100,20017,2023.06.29
178,Peaked In High School,Priscilla Block,6,0,6,6,0,11800,-2500,14300,19189,2023.06.29
178,When Will I Be Loved,"Ashley McBryde, Caylee Hammack & Pillbox Patti",6,0,6,6,0,11800,-2500,14300,41296,2023.06.29
180,Keith Whitley,Morgan Wallen,1,0,1,1,0,11800,6300,5500,1630772,2023.06.29
181,Keeping Me Up All Night,Chayce Beckham,6,,,6,0,11800,,,146037,2023.06.29
182,Try Losing One,Tyler Braden,1,,,1,0,11800,,,371637,2023.06.29
183,Heartless,Diplo & Julia Michaels Feat. Morgan Wallen,3,0,3,3,0,11700,-5600,17300,6863099,2023.06.29
184,God Only Knows,for King & Country,2,1,1,1,0,11600,4100,7500,1117424,2023.06.29
185,"Lord, I Hope This Day Is Good",Caylee Hammack Feat. Alan Jackson,2,,,2,0,11100,,,7819,2023.06.29
186,"Salt, Lime & Tequila",Ryan Griffin,3,1,2,2,0,11000,-7200,18200,134211,2023.06.29
187,"The Father, My Son, And The Holy Ghost",Craig Morgan,3,1,2,1,0,11000,-600,11600,57960,2023.06.29
188,Sparkle,Harper Grace,20,-36,56,19,0,11000,-21200,32200,23029,2023.06.29
189,Firebird,Jordan Fletcher,19,-57,76,19,0,10800,-32400,43200,5190,2023.06.29
190,Goin' Crazy,Jameson Rodgers,9,2,7,1,0,10600,5600,5000,19965,2023.06.29
191,I'Ve Seen Me Do It,Joe Peters,2,1,1,1,0,10600,5600,5000,585,2023.06.29
192,In Her Shoes,Sophia Scott,18,-39,57,18,0,10600,-21800,32400,9269,2023.06.29
193,Cover Me Up,Morgan Wallen,2,0,2,1,0,10100,800,9300,4928446,2023.06.29
194,Star Spangled Banner,Demi Lovato,1,0,1,1,0,9400,0,9400,77,2023.06.29
195,Glad To Be Here,Hailey Whitters Feat. Lori Mckenna & Hillary Lindsey,5,2,3,1,0,9300,5400,3900,0,2023.06.29
196,Get To Gettin’ Gone,Bailey Zimmerman,3,0,3,1,0,9300,0,9300,1615165,2023.06.29
197,Am I The Only One,Aaron Lewis,3,0,3,2,0,9200,-5300,14500,825152,2023.06.29
198,Girl On Fire,Kameron Marlowe,2,0,2,1,0,9000,-27400,36400,1005913,2023.06.29
199,Star Spangled Banner,Maren Morris,1,,,1,0,9000,,,0,2023.06.29
200,BELLS,Rachelle Garniez,1,0,1,1,0,8700,0,8700,0,2023.06.29
201,She's Somebody's Daughter,Drew Baldridge,1,,,1,0,8700,,,138068,2023.06.29
1,Fast Car,Luke Combs,8269,18,8251,145,0,33627900,272300,33355600,23361106,2023.07.06
2,Last Night,Morgan Wallen,7679,-216,7895,145,0,31942400,-898300,32840700,31016154,2023.07.06
3,Next Thing You Know,Jordan Davis,7745,-660,8405,145,0,30848900,-2262700,33111600,8453928,2023.07.06
4,Memory Lane,Old Dominion,7631,1081,6550,145,0,28991900,3659400,25332500,7998939,2023.07.06
5,Dancin' In The Country,Tyler Hubbard,5919,-307,6226,145,0,26600300,-1528800,28129100,7245869,2023.07.06
6,Need A Favor,Jelly Roll,6945,827,6118,144,0,26243700,3845700,22398000,11603590,2023.07.06
7,"You, Me, And Whiskey",Justin Moore & Priscilla Block,6240,173,6067,145,0,23377800,957800,22420000,3540739,2023.07.06
8,Your Heart Or Mine,Jon Pardi,5401,-56,5457,145,0,19305100,-148500,19453600,4547823,2023.07.06
9,Bury Me In Georgia,Kane Brown,4912,217,4695,145,0,19000100,709300,18290800,6704461,2023.07.06
10,Love You Anyway,Luke Combs,5161,150,5011,145,0,18625800,328100,18297700,7258307,2023.07.06
11,Angels,Thomas Rhett,4446,250,4196,145,0,16734000,1332600,15401400,1914475,2023.07.06
12,Girl In Mine,Parmalee,4051,148,3903,144,0,14256200,462200,13794000,3189383,2023.07.06
13,Religiously,Bailey Zimmerman,3670,326,3344,145,0,14171500,1657200,12514300,10736813,2023.07.06
14,Drinkaby,Cole Swindell,3633,202,3431,145,0,12145000,794800,11350200,2861924,2023.07.06
15,Looking For You,Chris Young,3580,387,3193,145,0,12114800,1919000,10195800,2766630,2023.07.06
16,Standing Room Only,Tim McGraw,3426,156,3270,145,0,11033800,682900,10350900,3020063,2023.07.06
17,But I Got A Beer In My Hand,Luke Bryan,2948,220,2728,145,0,10346900,674700,9672200,2765470,2023.07.06
18,Everything She Ain't,Hailey Whitters,3224,99,3125,145,0,10238200,724900,9513300,3003329,2023.07.06
19,God Gave Me A Girl,Russell Dickerson,2660,258,2402,140,0,8738200,660700,8077500,2076210,2023.07.06
20,Can'T Have Mine,Dylan Scott,2788,89,2699,145,0,8360600,376900,7983700,3281427,2023.07.06
21,Watermelon Moonshine,Lainey Wilson,2359,108,2251,145,0,7665500,328800,7336700,4840926,2023.07.06
22,If You Go Down (I'M Going Down Too),Kelsea Ballerini,2658,28,2630,145,0,7288000,131900,7156100,2710643,2023.07.06
23,Everything I Love,Morgan Wallen,1676,895,781,120,0,6890300,3676700,3213600,5339967,2023.07.06
24,Something In The Orange,Zach Bryan,2136,-73,2209,133,0,6483500,-334600,6818100,16040459,2023.07.06
25,Stars Like Confetti,Dustin Lynch,2174,223,1951,139,0,6202700,956000,5246700,1963458,2023.07.06
26,Try That In A Small Town,Jason Aldean,1796,199,1597,130,0,5769100,500800,5268300,1735391,2023.07.06
27,All I Need Is You,Chris Janson,2214,113,2101,139,0,5526000,483300,5042700,1113285,2023.07.06
28,We Got History,Mitchell Tenpenny,1712,43,1669,136,0,5147100,-10300,5157400,1693526,2023.07.06
29,Light On In The Kitchen,Ashley McBryde,1919,48,1871,143,0,4884300,271600,4612700,1134884,2023.07.06
30,Creek Will Rise,Conner Smith,1609,110,1499,142,0,3581600,291300,3290300,1247185,2023.07.06
31,23,Chayce Beckham,1372,80,1292,136,0,3548000,139800,3408200,2889458,2023.07.06
32,Nobody's Nobody,Brothers Osborne,1469,67,1402,137,0,3489800,-36900,3526700,1733199,2023.07.06
33,Glory Days,Gabby Barrett,1140,183,957,130,0,3298500,336400,2962100,2071291,2023.07.06
34,Different 'Round Here,Riley Green,1108,136,972,121,0,3210000,454900,2755100,1844154,2023.07.06
35,Mind On You,George Birge,1326,10,1316,135,0,3151200,93100,3058100,210673,2023.07.06
36,Fearless,Jackson Dean,1463,-64,1527,142,0,3077200,-32800,3110000,1063523,2023.07.06
37,Fires Don'T Start Themselves,Darius Rucker,923,-2,925,97,0,2685800,315300,2370500,1045361,2023.07.06
38,Truck Bed,Hardy,885,69,816,80,0,2370600,184800,2185800,5881380,2023.07.06
39,See You Next Summer,Brian Kelley,934,55,879,100,0,2365200,94500,2270700,567849,2023.07.06
40,Out Of That Truck,Carrie Underwood,711,109,602,70,0,2184800,595900,1588900,3306502,2023.07.06
41,Heaven By Then,Brantley Gilbert & Blake Shelton Feat. Vince Gill,1091,-22,1113,134,0,2179700,-55300,2235000,652169,2023.07.06
42,We Don'T Fight Anymore,Carly Pearce,745,184,561,96,0,1968800,665000,1303800,2658686,2023.07.06
43,World On Fire,Nate Smith,733,141,592,72,0,1884600,523900,1360700,4350706,2023.07.06
44,Over For You,Morgan Evans,732,39,693,69,0,1835800,151600,1684200,1732932,2023.07.06
45,Thinkin' Bout Me,Morgan Wallen,559,74,485,28,0,1813800,199600,1614200,15123855,2023.07.06
46,Drive You Out Of My Mind,Kassi Ashton,735,12,723,78,0,1663900,162500,1501400,1064923,2023.07.06
47,Giving Up On That,Dalton Dover,773,40,733,83,0,1565700,191400,1374300,1023185,2023.07.06
48,On The Boat Again,Jake Owen,624,-50,674,75,0,1529900,-336600,1866500,756339,2023.07.06
49,Burn It Down,Parker Mccollum,521,77,444,59,0,1524500,170600,1353900,3467179,2023.07.06
50,Save Me (With Lainey Wilson),Jelly Roll,379,7,372,25,0,1351900,-38300,1390200,5283617,2023.07.06
51,Shoot Tequila,Tigirlily Gold,560,14,546,65,0,1119400,-40800,1160200,1070960,2023.07.06
52,Bad Day To Be A Cold Beer,Chase Rice,541,58,483,60,0,1076600,221200,855400,352651,2023.07.06
53,Bout Damn Time,Neon Union,617,-17,634,76,0,1057100,-71900,1129000,52708,2023.07.06
54,Somebody Else's Whiskey,Frank Ray,564,20,544,66,0,981800,36000,945800,26933,2023.07.06
55,Marry That Girl,Easton Corbin,493,-19,512,62,0,939800,12700,927100,179652,2023.07.06
56,If I Die Young (Pt. 2),Kimberly Perry,427,2,425,86,0,807900,78800,729100,1007924,2023.07.06
57,Love You Again,Chase Matthew,348,15,333,39,0,675800,-1100,676900,2622813,2023.07.06
58,'98 Braves,Morgan Wallen,97,7,90,2,0,601100,28600,572500,4030661,2023.07.06
59,Jealous Of Myself,Tenille Arts,366,-35,401,52,0,555700,-144600,700300,52025,2023.07.06
60,Save The Roses,Lee Brice,227,14,213,35,0,552000,40600,511400,683945,2023.07.06
61,Without You,Thompson Square,400,-2,402,57,0,548600,-55200,603800,26783,2023.07.06
62,Something Real,Dierks Bentley,232,128,104,39,0,489500,291300,198200,560420,2023.07.06
63,Buy A Bar,Tim Dugger,206,73,133,33,0,430300,150800,279500,33124,2023.07.06
64,Drinkin' Problems,Dillon Carmichael,231,164,67,40,0,419700,314100,105600,89661,2023.07.06
65,Trouble,Josh Ross,249,11,238,45,0,334100,64700,269400,2834143,2023.07.06
66,Pretty Little Poison,Warren Zeiders,110,32,78,8,0,318600,78000,240600,3669254,2023.07.06
67,Sound Of A Saturday Night,LANCO,59,57,2,56,0,308500,302300,6200,54629,2023.07.06
68,I Just Killed A Man,Catie Offerman,227,-3,230,34,0,273400,17700,255700,146242,2023.07.06
69,Brokenhearted,Joe Nichols,213,63,150,29,0,271700,67400,204300,18463,2023.07.06
70,Wine Country,Hannah Ellis,208,36,172,43,0,267200,29500,237700,96885,2023.07.06
71,Heart To Break,Ryan Griffin,212,3,209,29,0,264800,-2800,267600,159931,2023.07.06
72,Along For The Ride,Jordan Harvey,183,-64,247,39,0,209700,-66100,275800,61720,2023.07.06
73,Flowers,Miley Cyrus,37,,,19,0,191100,,,16349683,2023.07.06
74,Lovin You Gets In The Way,Ben Gallaher,101,4,97,16,0,189100,-3800,192900,20303,2023.07.06
75,Dance With You,Brett Young,192,90,102,34,0,187900,54300,133600,2422085,2023.07.06
76,The Star-Spangled Banner,Chris Stapleton,42,31,11,18,0,177100,127600,49500,1005321,2023.07.06
77,Already Crazy,Carter Faith,37,,,37,0,175200,,,20658,2023.07.06
78,Wasting All These Tears,Austin Snell,26,13,13,1,0,161700,76600,85100,802252,2023.07.06
79,Make You Mine,Marynn Taylor,219,1,218,37,0,160000,-15800,175800,61289,2023.07.06
80,Oklahoma Smokeshow,Zach Bryan,49,19,30,3,0,158400,41400,117000,4781511,2023.07.06
81,How Is She,Cole Swindell,23,-2,25,1,0,146500,-17200,163700,88785,2023.07.06
82,Best Of Me,David Nail,39,4,35,1,0,128000,13200,114800,22631,2023.07.06
83,5 Leaf Clover,Luke Combs,18,2,16,2,0,114800,18700,96100,2954922,2023.07.06
84,Something's Gonna Kill Me,Corey Kent,42,26,16,9,0,113700,58600,55100,4006009,2023.07.06
85,Colorado,Florida Georgia Line,19,3,16,2,0,109700,5000,104700,77657,2023.07.06
86,Strangers,Maddie & Tae,49,,,48,0,109500,,,275239,2023.07.06
86,Everybody Wants To Rule The World,Anna Vaus,49,,,48,0,109500,,,1584,2023.07.06
88,A Walk In The Bar,Lauren Alaina,17,-2,19,3,0,94500,18500,76000,207204,2023.07.06
89,Damn Love,Kip Moore,109,-7,116,20,0,94200,13000,81200,326793,2023.07.06
90,One Of Us,Matt Stell,22,1,21,4,0,88500,-6900,95400,850169,2023.07.06
91,Grease,Lainey Wilson,22,-5,27,3,0,82200,13000,69200,242946,2023.07.06
92,Heartless,Diplo & Julia Michaels Feat. Morgan Wallen,11,8,3,4,0,73400,61700,11700,6888023,2023.07.06
93,21 Forever,Chris Janson,9,8,1,7,0,70100,69800,300,53106,2023.07.06
94,I'M Not Pretty,Megan Moroney,16,13,3,4,0,68700,60200,8500,2051879,2023.07.06
95,Sun To Me,Zach Bryan,32,-7,39,4,0,66900,-18000,84900,4184829,2023.07.06
96,With You I Am,Cody Johnson,5,1,4,2,0,63700,8200,55500,1348988,2023.07.06
97,Tulsa,Elle King,26,3,23,2,0,63500,3600,59900,72546,2023.07.06
98,Same Here,Brad Paisley,9,,,9,0,61200,,,7218,2023.07.06
99,If That Ain'T God,Chris Young,9,,,9,0,60600,,,25976,2023.07.06
100,Paradise To Me,Niko Moon,7,5,2,3,0,56600,55300,1300,770756,2023.07.06
101,Thicc As Thieves,Lauren Alaina,30,2,28,2,0,56500,-1700,58200,1270907,2023.07.06
102,Neon You,Don Louis,4,-1,5,1,0,54300,10800,43500,87162,2023.07.06
103,A Special Place,Danielle Bradbery,34,-5,39,7,0,54100,-14200,68300,321418,2023.07.06
104,Good Times Roll,Jimmie Allen & Nelly,5,,,1,0,52900,,,496254,2023.07.06
105,Wrong Side Of A Sunrise,Adam Doleac,23,-3,26,1,0,52800,-13200,66000,138512,2023.07.06
106,Heartfirst,Kelsea Ballerini,14,-1,15,1,0,50600,-3400,54000,813515,2023.07.06
107,Drink One For Me,Hardy,4,-15,19,1,0,47100,-142400,189500,192350,2023.07.06
108,"Love, Beer",Andrew Sevener,77,2,75,19,0,43400,400,43000,720,2023.07.06
109,I Hope Heaven,Karissa Ella,76,21,55,19,0,43200,11200,32000,0,2023.07.06
110,Too Much Of A Woman,Roberta Lea,74,19,55,19,0,42800,10800,32000,0,2023.07.06
111,Out Of Nowhere,Walker Montgomery,12,2,10,1,0,42500,1700,40800,15760,2023.07.06
112,Ain't That Some,Morgan Wallen,14,-3,17,2,0,41600,-18200,59800,6486745,2023.07.06
113,Star Spangled Banner,Abby Anderson,8,5,3,6,0,41200,25700,15500,0,2023.07.06
114,USA,Filmore Feat. Pitbull,4,,,2,0,40500,,,50912,2023.07.06
115,Longneck Way To Go,Midland Feat. Jon Pardi,8,4,4,1,0,38100,22800,15300,212672,2023.07.06
116,You In A Honky Tonk,Randall King,5,2,3,2,0,37600,18800,18800,513786,2023.07.06
117,Lovin' Where It's Goin',Josh Ward,4,0,4,1,0,37600,-30400,68000,42056,2023.07.06
118,Sun Sets In Colorado,Dierks Bentley,14,-1,15,1,0,37100,-3100,40200,44298,2023.07.06
119,Young Man's Blues,Parker Mccollum,3,-2,5,1,0,37000,-34600,71600,501667,2023.07.06
120,Should'Ve Known Better,Erin Viancourt,2,1,1,1,0,36400,18200,18200,8872,2023.07.06
121,Holy Water,Michael Ray,7,-1,8,2,0,34200,-7100,41300,305238,2023.07.06
122,Tuggin' On My Heartstrings,Randall King,3,-1,4,1,0,33800,9100,24700,28128,2023.07.06
123,How I Get High,Josh Kaiser,58,17,41,14,0,33600,8900,24700,0,2023.07.06
124,Whatcha Looking At,Curves,57,14,43,14,0,33400,8300,25100,33813,2023.07.06
125,First Rodeo,Daves Highway,59,1,58,19,0,32800,200,32600,342,2023.07.06
126,Pretender,Sarah Darling,58,1,57,19,0,32600,200,32400,394,2023.07.06
127,red,HARDY Feat. Morgan Wallen,5,,,2,0,32400,,,0,2023.07.06
128,Question The Universe,Teddy Robb,55,-22,77,19,0,32000,-11400,43400,6811,2023.07.06
129,Honey!,Rayne Johnson,54,-3,57,18,0,31800,-600,32400,37803,2023.07.06
130,Giving You Up,Kameron Marlowe,5,-3,8,1,0,29700,-1800,31500,1018116,2023.07.06
131,Still,Luke Combs,7,-4,11,1,0,29300,-4800,34100,556904,2023.07.06
132,My Bar,Priscilla Block,7,4,3,5,0,29200,26500,2700,209182,2023.07.06
133,Stop Coming Over,Chris Lane,12,,,6,0,28600,,,48368,2023.07.06
134,Man Made A Bar,Morgan Wallen,8,3,5,2,0,28200,20800,7400,4503688,2023.07.06
135,Forever Bound,12/Oc,12,0,12,1,0,28000,1400,26600,5948,2023.07.06
136,The Star Spangled Banner,Brad Paisley,3,1,2,3,0,27900,21600,6300,0,2023.07.06
137,Happy Birthday America,Toby Keith,6,,,2,0,27600,,,177177,2023.07.06
138,Daylight Savings,Kidd G,19,3,16,2,0,26800,-1600,28400,251531,2023.07.06
139,Stranger In My House,Ronnie Milsap,2,-18,20,2,0,26300,-92300,118600,160599,2023.07.06
140,Cowgirls,Morgan Wallen,11,-19,30,3,0,25400,-42200,67600,7210388,2023.07.06
141,"1, 2 Many",Luke Combs & Brooks & Dunn,4,2,2,4,0,25000,23200,1800,1775242,2023.07.06
142,Too Soon To Say Goodbye,Wayland,42,18,24,14,0,24900,12300,12600,526,2023.07.06
143,Wild as You,Cody Johnson,5,3,2,2,0,24900,10600,14300,1083989,2023.07.06
144,Loser,Mike Ryan,3,,,2,0,24700,,,9031,2023.07.06
145,I Wrote The Book,Morgan Wallen,2,1,1,2,0,24200,21100,3100,5685994,2023.07.06
146,National Anthem From Battle At Bristol,Jennifer Nettles,4,,,4,0,24000,,,0,2023.07.06
147,Georgia Girl,Megan Moroney,5,4,1,1,0,23900,20800,3100,118019,2023.07.06
148,Young Again,Morgan Evans,4,,,3,0,23900,,,13876,2023.07.06
149,I'M Not For Everyone,Brothers Osborne,3,1,2,2,0,23300,17600,5700,565701,2023.07.06
150,Love Is Real,Morgan Evans,10,3,7,2,0,22000,7900,14100,58100,2023.07.06
151,Porch Swing,Taylor Hicks,10,,,9,0,21600,,,7435,2023.07.06
152,Kiss That Girl Goodbye,Aaron Watson,5,4,1,2,0,20100,14000,6100,18734,2023.07.06
153,It's A Great Day To Be Alive (Live),Sam Hunt,5,2,3,4,0,19500,3900,15600,0,2023.07.06
154,Songs We Used To Sing,Ernest,8,-1,9,1,0,19400,-700,20100,83879,2023.07.06
155,We Ain't The Only Ones,Randy Rogers & Wade Bowen,1,-2,3,1,0,18200,15000,3200,0,2023.07.06
156,Four Minutes,Chad Cooke Band,1,,,1,0,18200,,,3617,2023.07.06
157,3 Tequila Floor,Josiah Siska,17,-7,24,4,0,17900,-11200,29100,12238,2023.07.06
158,Better Off,Trace Adkins,3,-2,5,1,0,17200,-9700,26900,17023,2023.07.06
159,"Houston, We Got A Problem",Luke Combs,4,3,1,1,0,17100,13000,4100,1461648,2023.07.06
160,Heart Of A Small Town,Tim Dugger,2,-1,3,1,0,16800,4800,12000,36698,2023.07.06
161,Ain'T Missin' You,Dylan Schneider,8,,,3,0,15600,,,345617,2023.07.06
162,Any Given Friday Night,Luke Combs,2,0,2,1,0,15200,0,15200,338268,2023.07.06
163,Cover Me Up,Morgan Wallen,4,2,2,2,0,14500,4400,10100,5067778,2023.07.06
164,Polaroid,Keith Urban,6,-6,12,6,0,14300,-14300,28600,19030,2023.07.06
165,Don’t Give A Truck,Michael Ray,6,,,6,0,14300,,,28981,2023.07.06
165,Growin' Up And Gettin' Old,Luke Combs,6,,,6,0,14300,,,3125951,2023.07.06
165,Dive Bars & Broken Hearts,Michael Ray,6,,,6,0,14300,,,81623,2023.07.06
165,Whiskey's Fine,Adam Doleac,6,,,6,0,14300,,,38210,2023.07.06
165,Mine For The Summer,Jameson Rodgers,6,,,6,0,14300,,,386506,2023.07.06
165,Moon Over Mexico,Luke Combs,6,,,6,0,14300,,,451157,2023.07.06
171,Playboys,Midland,2,,,2,0,14200,,,86452,2023.07.06
172,Feel For You,Boy Named Banjo,9,0,9,1,0,14100,5700,8400,45143,2023.07.06
173,Loud and Heavy,Cody Jinks,4,-1,5,3,0,13900,9200,4700,2037793,2023.07.06
174,bad guy,Billie Eilish,1,,,1,0,13800,,,4252559,2023.07.06
175,The Star Spangled Banner,Locash,1,0,1,1,0,13700,0,13700,0,2023.07.06
176,America,Clint Black,4,,,1,0,13200,,,2325,2023.07.06
177,Heart They Didn'T Break,Maddie & Tae,2,,,2,0,13100,,,919888,2023.07.06
178,Sometimes She Stays,Kip Moore,12,5,7,1,0,13000,0,13000,168697,2023.07.06
179,Dancing Away With My Heart,Dillon Carmichael,1,0,1,1,0,12900,6800,6100,44145,2023.07.06
180,Tucson Too Late,Jordan Davis,2,,,2,0,12800,,,837060,2023.07.06
180,Child Of The King,Joseph Habedank,2,,,2,0,12800,,,1191,2023.07.06
182,Sunrise,Morgan Wallen,2,1,1,1,0,12600,9500,3100,4625214,2023.07.06
183,Codigo,George Strait,1,-1,2,1,0,12500,-12900,25400,36112,2023.07.06
184,Goin' Crazy,Jameson Rodgers,9,0,9,1,0,12200,1600,10600,19895,2023.07.06
185,Old Glory,Jerrod Niemann,2,,,2,0,12200,,,50903,2023.07.06
186,Three Favorite Colors,Locash,3,2,1,3,0,12100,6600,5500,74025,2023.07.06
187,Dangerous,Morgan Wallen,1,0,1,1,0,11800,8200,3600,1989874,2023.07.06
188,Money On Me,Morgan Wallen,1,-1,2,1,0,11800,7400,4400,1254561,2023.07.06
189,Single Than She Was,Morgan Wallen,1,,,1,0,11800,,,1814911,2023.07.06
189,Neon Star (Country Boy Lullaby),Morgan Wallen,1,,,1,0,11800,,,2627768,2023.07.06
191,Humble And Kind (Nunca Te Olvides De Amar),Tim McGraw,3,2,1,1,0,11600,5600,6000,819,2023.07.06
192,Made In America,Tracy Lawrence,3,,,1,0,11500,,,5232,2023.07.06
193,The Great Divide,Luke Combs & Billy Strings,4,1,3,1,0,11400,4100,7300,236790,2023.07.06
194,That's Why We Fight,Ella Langley & Koe Wetzel,9,0,9,1,0,11300,-3100,14400,1168233,2023.07.06
195,Buckles And Broken Hearts,Joe Peters,2,,,1,0,11000,,,2066,2023.07.06
196,Star Spangled Banner,Demi Lovato,2,1,1,2,0,10900,1500,9400,198,2023.07.06
197,Days That End In Why,Morgan Wallen,2,1,1,2,0,10600,8400,2200,1939552,2023.07.06
198,Bus Route,Tyler Childers,3,1,2,1,0,10100,8100,2000,214225,2023.07.06
199,White House Road,Tyler Childers & The Highwall,3,0,3,1,0,10100,2800,7300,3180343,2023.07.06
200,Talk About Georgia,Jason Aldean,1,0,1,1,0,10000,7400,2600,40262,2023.07.06
1,Fast Car,Luke Combs,8623,354,8269,145,0,34718600,1090700,33627900,22991672,2023.07.13
2,Last Night,Morgan Wallen,7615,-64,7679,145,0,31916300,-26100,31942400,29854014,2023.07.13
3,Next Thing You Know,Jordan Davis,7040,-705,7745,144,0,28565000,-2283900,30848900,8387458,2023.07.13
4,Need A Favor,Jelly Roll,7156,211,6945,144,0,27561600,1317900,26243700,11485033,2023.07.13
5,Dancin' In The Country,Tyler Hubbard,5900,-19,5919,145,0,26504800,-95500,26600300,7162388,2023.07.13
6,Memory Lane,Old Dominion,6788,-843,7631,145,0,24941800,-4050100,28991900,7736658,2023.07.13
7,"You, Me, And Whiskey",Justin Moore & Priscilla Block,6337,97,6240,145,0,24021800,644000,23377800,3408856,2023.07.13
8,Your Heart Or Mine,Jon Pardi,5643,242,5401,145,0,20288600,983500,19305100,4438379,2023.07.13
9,Love You Anyway,Luke Combs,5335,174,5161,145,0,19741700,1115900,18625800,7214260,2023.07.13
10,Bury Me In Georgia,Kane Brown,5086,174,4912,145,0,19478900,478800,19000100,6967450,2023.07.13
11,Angels,Thomas Rhett,4578,132,4446,145,0,17399000,665000,16734000,2775393,2023.07.13
12,Religiously,Bailey Zimmerman,3861,191,3670,145,0,15212100,1040600,14171500,11584317,2023.07.13
13,Girl In Mine,Parmalee,4115,64,4051,144,0,14570600,314400,14256200,3473688,2023.07.13
14,Drinkaby,Cole Swindell,3797,164,3633,145,0,12696900,551900,12145000,2603509,2023.07.13
15,Looking For You,Chris Young,3646,66,3580,145,0,12611800,497000,12114800,2775324,2023.07.13
16,Standing Room Only,Tim McGraw,3488,62,3426,145,0,11576300,542500,11033800,2938560,2023.07.13
17,But I Got A Beer In My Hand,Luke Bryan,3132,184,2948,145,0,10988700,641800,10346900,3455977,2023.07.13
18,Everything She Ain't,Hailey Whitters,3248,24,3224,145,0,10256300,18100,10238200,2726865,2023.07.13
19,God Gave Me A Girl,Russell Dickerson,2710,50,2660,140,0,9294300,556100,8738200,1674323,2023.07.13
20,Everything I Love,Morgan Wallen,2112,436,1676,134,0,8906800,2016500,6890300,5014797,2023.07.13
21,Watermelon Moonshine,Lainey Wilson,2699,340,2359,145,0,8906700,1241200,7665500,5149090,2023.07.13
22,Can'T Have Mine,Dylan Scott,2802,14,2788,145,0,8500100,139500,8360600,3119564,2023.07.13
23,If You Go Down (I'M Going Down Too),Kelsea Ballerini,2796,138,2658,145,0,7979700,691700,7288000,2438331,2023.07.13
24,Stars Like Confetti,Dustin Lynch,2212,38,2174,139,0,6483000,280300,6202700,1844435,2023.07.13
25,Try That In A Small Town,Jason Aldean,1751,-45,1796,137,0,5651900,-117200,5769100,1790948,2023.07.13
26,We Got History,Mitchell Tenpenny,1730,18,1712,137,0,5554500,407400,5147100,1788789,2023.07.13
27,All I Need Is You,Chris Janson,2181,-33,2214,138,0,5546600,20600,5526000,1193588,2023.07.13
28,Light On In The Kitchen,Ashley McBryde,1943,24,1919,144,0,5239000,354700,4884300,1171654,2023.07.13
29,Nobody's Nobody,Brothers Osborne,1585,116,1469,138,0,3893700,403900,3489800,1699936,2023.07.13
30,23,Chayce Beckham,1434,62,1372,138,0,3667500,119500,3548000,2765119,2023.07.13
31,Mind On You,George Birge,1484,158,1326,136,0,3616900,465700,3151200,222837,2023.07.13
32,Creek Will Rise,Conner Smith,1595,-14,1609,142,0,3566400,-15200,3581600,1237528,2023.07.13
33,Glory Days,Gabby Barrett,1194,54,1140,129,0,3374800,76300,3298500,2553173,2023.07.13
34,Different 'Round Here,Riley Green,1206,98,1108,116,0,3324000,114000,3210000,1680466,2023.07.13
35,Fearless,Jackson Dean,1580,117,1463,142,0,3284100,206900,3077200,1039165,2023.07.13
36,See You Next Summer,Brian Kelley,989,55,934,98,0,2635000,269800,2365200,383353,2023.07.13
37,Fires Don'T Start Themselves,Darius Rucker,898,-25,923,97,0,2612300,-73500,2685800,1071888,2023.07.13
38,Truck Bed,Hardy,905,20,885,78,0,2372700,2100,2370600,5678992,2023.07.13
39,Out Of That Truck,Carrie Underwood,733,22,711,67,0,2331400,146600,2184800,3339441,2023.07.13
40,Heaven By Then,Brantley Gilbert & Blake Shelton Feat. Vince Gill,1136,45,1091,136,0,2279500,99800,2179700,684236,2023.07.13
41,We Don'T Fight Anymore,Carly Pearce,804,59,745,94,0,2176300,207500,1968800,2578293,2023.07.13
42,Thinkin' Bout Me,Morgan Wallen,578,19,559,29,0,2103300,289500,1813800,14378286,2023.07.13
43,World On Fire,Nate Smith,758,25,733,69,0,1886200,1600,1884600,4380137,2023.07.13
44,Drive You Out Of My Mind,Kassi Ashton,760,25,735,77,0,1807000,143100,1663900,873370,2023.07.13
45,Burn It Down,Parker Mccollum,584,63,521,63,0,1687900,163400,1524500,3221896,2023.07.13
46,Over For You,Morgan Evans,713,-19,732,69,0,1676700,-159100,1835800,1132549,2023.07.13
47,On The Boat Again,Jake Owen,631,7,624,68,0,1592800,62900,1529900,589168,2023.07.13
48,Giving Up On That,Dalton Dover,785,12,773,82,0,1559500,-6200,1565700,1293747,2023.07.13
49,Save Me (With Lainey Wilson),Jelly Roll,409,30,379,35,0,1524700,172800,1351900,5121565,2023.07.13
50,Shoot Tequila,Tigirlily Gold,574,14,560,66,0,1143100,23700,1119400,907527,2023.07.13
51,Somebody Else's Whiskey,Frank Ray,612,48,564,74,0,1108100,126300,981800,337751,2023.07.13
52,Marry That Girl,Easton Corbin,547,54,493,65,0,1035300,95500,939800,181300,2023.07.13
53,Bad Day To Be A Cold Beer,Chase Rice,525,-16,541,59,0,1031300,-45300,1076600,240139,2023.07.13
54,Bout Damn Time,Neon Union,624,7,617,74,0,988200,-68900,1057100,49890,2023.07.13
55,Pretty Little Poison,Warren Zeiders,310,200,110,36,0,927000,608400,318600,4609687,2023.07.13
56,If I Die Young (Pt. 2),Kimberly Perry,418,-9,427,84,0,741700,-66200,807900,1546407,2023.07.13
57,Love You Again,Chase Matthew,333,-15,348,38,0,636400,-39400,675800,2835821,2023.07.13
58,Drinkin' Problems,Dillon Carmichael,296,65,231,45,0,625600,205900,419700,94777,2023.07.13
59,'98 Braves,Morgan Wallen,97,0,97,4,0,611500,10400,601100,3769933,2023.07.13
60,Save The Roses,Lee Brice,249,22,227,34,0,602300,50300,552000,692985,2023.07.13
61,Buy A Bar,Tim Dugger,249,43,206,36,0,575400,145100,430300,29254,2023.07.13
62,Something Real,Dierks Bentley,285,53,232,51,0,569400,79900,489500,475613,2023.07.13
63,Without You,Thompson Square,406,6,400,54,0,564400,15800,548600,26751,2023.07.13
64,Jealous Of Myself,Tenille Arts,366,0,366,52,0,559000,3300,555700,55987,2023.07.13
65,Brokenhearted,Joe Nichols,273,60,213,44,0,458600,186900,271700,19873,2023.07.13
66,Wine Country,Hannah Ellis,258,50,208,48,0,357300,90100,267200,126906,2023.07.13
67,Something's Gonna Kill Me,Corey Kent,175,133,42,38,0,354800,241100,113700,3633637,2023.07.13
68,Everybody Wants To Rule The World,Anna Vaus,57,8,49,56,0,304700,195200,109500,2107,2023.07.13
69,Dance With You,Brett Young,264,72,192,43,0,271000,83100,187900,2167956,2023.07.13
70,Trouble,Josh Ross,229,-20,249,38,0,253100,-81000,334100,2205339,2023.07.13
71,Heart To Break,Ryan Griffin,209,-3,212,27,0,235500,-29300,264800,172188,2023.07.13
72,I Just Killed A Man,Catie Offerman,213,-14,227,33,0,224400,-49000,273400,136224,2023.07.13
73,It's A Great Day To Be Alive (Live),Sam Hunt,49,44,5,27,0,193400,173900,19500,0,2023.07.13
74,The Star-Spangled Banner,Chris Stapleton,54,12,42,51,0,190400,13300,177100,457561,2023.07.13
75,Oklahoma Smokeshow,Zach Bryan,53,4,49,3,0,190300,31900,158400,4763082,2023.07.13
76,Make You Mine,Marynn Taylor,232,13,219,38,0,171900,11900,160000,65007,2023.07.13
77,I'M Not Pretty,Megan Moroney,40,24,16,6,0,165700,97000,68700,1811924,2023.07.13
78,Wasting All These Tears,Austin Snell,22,-4,26,1,0,150800,-10900,161700,856591,2023.07.13
79,Lovin You Gets In The Way,Ben Gallaher,96,-5,101,15,0,150000,-39100,189100,22961,2023.07.13
80,How Is She,Cole Swindell,21,-2,23,1,0,147200,700,146500,81749,2023.07.13
81,Along For The Ride,Jordan Harvey,109,-74,183,22,0,146600,-63100,209700,56184,2023.07.13
82,Best Of Me,David Nail,36,-3,39,1,0,129900,1900,128000,15507,2023.07.13
83,Always On My Mind,"Amanda Shires, Bobbie Nelson",49,,,48,0,109500,,,3519,2023.07.13
84,One Of Us,Matt Stell,23,1,22,4,0,108500,20000,88500,808941,2023.07.13
85,I Picture You In A Jazz Bar,Nikita Karmen,48,,,48,0,107100,,,149,2023.07.13
86,Colorado,Florida Georgia Line,16,-3,19,2,0,104200,-5500,109700,68634,2023.07.13
87,So Many Summers,Brad Paisley,22,,,20,0,103700,,,791333,2023.07.13
88,5 Leaf Clover,Luke Combs,17,-1,18,1,0,93900,-20900,114800,3014174,2023.07.13
89,When My Baby's In Boots,Randall King,17,16,1,16,0,80600,78600,2000,0,2023.07.13
90,Tulsa,Elle King,23,-3,26,2,0,73200,9700,63500,71852,2023.07.13
91,Thicc As Thieves,Lauren Alaina,31,1,30,1,0,61700,5200,56500,951583,2023.07.13
92,Drink One For Me,Hardy,8,4,4,1,0,52800,5700,47100,180950,2023.07.13
93,Out Of Nowhere,Walker Montgomery,14,2,12,1,0,52400,9900,42500,14945,2023.07.13
94,Heartfirst,Kelsea Ballerini,12,-2,14,1,0,51700,1100,50600,715587,2023.07.13
95,Ain't That Some,Morgan Wallen,19,5,14,3,0,51300,9700,41600,6047248,2023.07.13
96,Damn Love,Kip Moore,54,-55,109,15,0,50700,-43500,94200,297257,2023.07.13
97,The Star-Spangled Banner,Carly Pearce,5,,,4,0,50600,,,0,2023.07.13
98,Daylight Savings,Kidd G,29,10,19,5,0,48400,21600,26800,192222,2023.07.13
99,With You I Am,Cody Johnson,6,1,5,3,0,48000,-15700,63700,1307771,2023.07.13
100,Grease,Lainey Wilson,19,-3,22,3,0,47000,-35200,82200,244126,2023.07.13
101,Young Man's Blues,Parker Mccollum,5,2,3,2,0,45200,8200,37000,491341,2023.07.13
102,Ain'T Missin' You,Dylan Schneider,13,5,8,5,0,43700,28100,15600,393940,2023.07.13
103,Loser,Mike Ryan,4,1,3,2,0,42900,18200,24700,12826,2023.07.13
104,Question The Universe,Teddy Robb,70,15,55,19,0,40900,8900,32000,6202,2023.07.13
105,Pretender,Sarah Darling,72,14,58,19,0,40900,8300,32600,468,2023.07.13
106,Sun Sets In Colorado,Dierks Bentley,15,1,14,2,0,40200,3100,37100,50936,2023.07.13
107,Longneck Way To Go,Midland Feat. Jon Pardi,9,1,8,2,0,38700,600,38100,186963,2023.07.13
108,Stranger In My House,Ronnie Milsap,5,3,2,2,0,38000,11700,26300,145302,2023.07.13
109,Holy Water,Michael Ray,7,0,7,2,0,37900,3700,34200,299150,2023.07.13
110,First Rodeo,Daves Highway,66,7,59,19,0,37700,4900,32800,449,2023.07.13
111,Sun To Me,Zach Bryan,24,-8,32,3,0,37700,-29200,66900,4340242,2023.07.13
112,Still,Luke Combs,12,5,7,1,0,37400,8100,29300,579133,2023.07.13
113,Wrong Side Of A Sunrise,Adam Doleac,16,-7,23,1,0,37000,-15800,52800,174666,2023.07.13
114,Granny's Got A Garden (For G'maw Jan),Kameron Marlowe,3,1,2,1,0,35400,30300,5100,0,2023.07.13
115,Whatcha Looking At,Curves,56,-1,57,14,0,33300,-100,33400,6084,2023.07.13
116,I'M Not For Everyone,Brothers Osborne,6,3,3,4,0,33200,9900,23300,518344,2023.07.13
117,Lovin' Where It's Goin',Josh Ward,3,-1,4,1,0,32500,-5100,37600,40401,2023.07.13
118,Too Much Of A Woman,Roberta Lea,54,-20,74,19,0,30900,-11900,42800,0,2023.07.13
119,Honey!,Rayne Johnson,57,3,54,19,0,30800,-1000,31800,35773,2023.07.13
120,"Love, Beer",Andrew Sevener,53,-24,77,19,0,30600,-12800,43400,533,2023.07.13
121,A Special Place,Danielle Bradbery,31,-3,34,7,0,30200,-23900,54100,305746,2023.07.13
122,I Hope Heaven,Karissa Ella,54,-22,76,19,0,30100,-13100,43200,0,2023.07.13
123,Too Soon To Say Goodbye,Wayland,48,6,42,14,0,29900,5000,24900,472,2023.07.13
124,Settle Me Down,Josh Abbott Band,3,1,2,2,0,28800,22100,6700,496596,2023.07.13
125,Star Spangled Banner,Abby Anderson,5,-3,8,4,0,28200,-13000,41200,0,2023.07.13
126,Wild as You,Cody Johnson,3,-2,5,2,0,28100,3200,24900,1104400,2023.07.13
127,Just Drive,Erin Kinsey,11,,,6,0,26900,,,139903,2023.07.13
128,Giving You Up,Kameron Marlowe,6,1,5,1,0,26800,-2900,29700,1019129,2023.07.13
129,Forever Bound,12/Oc,12,0,12,1,0,26700,-1300,28000,6979,2023.07.13
130,Man Made A Bar,Morgan Wallen,11,3,8,2,0,26500,-1700,28200,4314086,2023.07.13
131,A Walk In The Bar,Lauren Alaina,9,-8,17,1,0,26100,-68400,94500,158634,2023.07.13
132,Cowgirls,Morgan Wallen,9,-2,11,4,0,25400,0,25400,6911808,2023.07.13
133,Neon You,Don Louis,4,0,4,2,0,25300,-29000,54300,89779,2023.07.13
134,Better Off,Trace Adkins,3,0,3,1,0,25200,8000,17200,16425,2023.07.13
135,How I Get High,Josh Kaiser,42,-16,58,14,0,24900,-8700,33600,0,2023.07.13
136,Down On The Beach,Russell Dickerson,12,9,3,1,0,24700,14800,9900,194370,2023.07.13
137,We Ain't The Only Ones,Randy Rogers & Wade Bowen,3,2,1,2,0,24700,6500,18200,0,2023.07.13
138,You In A Honky Tonk,Randall King,4,-1,5,2,0,23700,-13900,37600,491328,2023.07.13
139,Tuggin' On My Heartstrings,Randall King,3,0,3,1,0,23300,-10500,33800,26215,2023.07.13
140,"The Father, My Son, And The Holy Ghost",Craig Morgan,3,2,1,2,0,22100,14600,7500,58490,2023.07.13
141,Streetlights,Frank Ray,4,,,4,0,22100,,,16723,2023.07.13
142,Your Place,Ashley Cooke,7,,,7,0,21900,,,512770,2023.07.13
143,Already Crazy,Carter Faith,10,-27,37,9,0,21600,-153600,175200,19360,2023.07.13
144,Ride The Wave,Russell Dickerson,11,9,2,1,0,20800,14200,6600,693200,2023.07.13
145,Half a Song,Cody Johnson,1,,,1,0,18200,,,372943,2023.07.13
146,City Don'T,Billy Currington,2,1,1,2,0,17600,10000,7600,366389,2023.07.13
147,Songs We Used To Sing,Ernest,7,-1,8,1,0,17500,-1900,19400,82273,2023.07.13
148,Every Single Summer,Marynn Taylor,7,5,2,6,0,17400,12600,4800,2913,2023.07.13
149,The Great Divide,Luke Combs & Billy Strings,6,2,4,1,0,16200,4800,11400,228701,2023.07.13
150,Love Is Real,Morgan Evans,6,-4,10,2,0,15900,-6100,22000,55470,2023.07.13
151,3 Tequila Floor,Josiah Siska,18,1,17,4,0,15600,-2300,17900,12248,2023.07.13
152,Heartless,Diplo & Julia Michaels Feat. Morgan Wallen,3,-8,11,2,0,14900,-58500,73400,6810705,2023.07.13
153,When Will I Be Loved,"Ashley McBryde, Caylee Hammack & Pillbox Patti",6,5,1,6,0,14300,12200,2100,39253,2023.07.13
154,Fillin' My Cup,Hailey Whitters Feat. Little Big Town,6,5,1,6,0,14300,9000,5300,122656,2023.07.13
155,21 Forever,Chris Janson,6,-3,9,6,0,14300,-55800,70100,41895,2023.07.13
156,You'Re Gonna Love Me,Tim Dugger,4,3,1,1,0,14200,12900,1300,10093,2023.07.13
157,Nothin' On You,Cody Johnson,3,,,1,0,13900,,,1216356,2023.07.13
158,Tell The Grave,Perrys,2,1,1,2,0,13700,8400,5300,14099,2023.07.13
159,Testify,Legacy Five,2,1,1,2,0,12800,7500,5300,20790,2023.07.13
160,Never Changing God,Kingdom Heirs,2,,,2,0,12800,,,1226,2023.07.13
161,National Anthem,Pryor & Lee,3,2,1,3,0,12700,5800,6900,0,2023.07.13
162,Stop Coming Over,Chris Lane,5,-7,12,5,0,12600,-16000,28600,45695,2023.07.13
163,The Weight Of The Badge,George Strait,1,,,1,0,12500,,,59895,2023.07.13
164,"Dear Country Music,",Mike Ryan,2,1,1,1,0,12200,6100,6100,23772,2023.07.13
165,wAnt me back,Lindsay Ell,5,,,5,0,12200,,,33432,2023.07.13
166,I Wrote The Book,Morgan Wallen,1,-1,2,1,0,11800,-12400,24200,5436884,2023.07.13
167,Get Rich Or Drunk Trying,Justin Moore,6,,,6,0,11800,,,568068,2023.07.13
168,Am I The Only One,Aaron Lewis,3,-2,5,2,0,11700,6700,5000,814098,2023.07.13
169,Star Spangled Banner,Mickey Guyton,3,1,2,3,0,11500,8600,2900,0,2023.07.13
170,When It Comes To Loving You,Jon Langston,2,0,2,2,0,11000,1300,9700,125668,2023.07.13
171,National Anthem From Battle At Bristol,Jennifer Nettles,2,-2,4,2,0,10900,-13100,24000,0,2023.07.13
172,Goin' Crazy,Jameson Rodgers,9,0,9,1,0,10700,-1500,12200,18092,2023.07.13
173,Heart Of A Small Town,Tim Dugger,2,0,2,1,0,10700,-6100,16800,20124,2023.07.13
174,Sometimes She Stays,Kip Moore,7,-5,12,1,0,10400,-2600,13000,252807,2023.07.13
175,The Story of Us,Taylor Swift,2,,,1,0,10300,,,756603,2023.07.13
176,I Don'T Want To Get Adjusted,Kim Hopper,2,,,2,0,10200,,,85,2023.07.13
176,I Bet You Think About Me (Taylor's Version) (From The Vault),Taylor Swift Feat. Chris Stapleton,6,,,2,0,10200,,,1088495,2023.07.13
178,God Only Knows,for King & Country,2,,,1,0,9700,,,1076348,2023.07.13
179,Tattoo On A Sunburn,Luke Combs,1,,,1,0,9500,,,478266,2023.07.13
180,Star Spangled Banner,Demi Lovato,1,-1,2,1,0,9400,-1500,10900,86,2023.07.13
181,Red (Taylor's Version),Taylor Swift,2,,,1,0,9300,,,1433505,2023.07.13
182,BELLS,Rachelle Garniez,1,0,1,1,0,8700,0,8700,0,2023.07.13
183,Lucky,Megan Moroney,4,2,2,1,0,8600,6600,2000,265453,2023.07.13
184,Scars In Heaven,Casting Crowns,1,,,1,0,8400,,,541210,2023.07.13
184,People Like Me,Jeff & Sheri Easter,1,,,1,0,8400,,,0,2023.07.13
184,If I Know Me,Morgan Wallen,1,,,1,0,8400,,,1549441,2023.07.13
184,By Your Grace,Cody Johnson,1,,,1,0,8400,,,551823,2023.07.13
184,Somebody's Problem,Morgan Wallen,1,,,1,0,8400,,,3641645,2023.07.13
189,Star Spangled Banner,P!Nk,1,,,1,0,8200,,,0,2023.07.13
190,That's Why We Fight,Ella Langley & Koe Wetzel,7,-2,9,1,0,8100,-3200,11300,1166058,2023.07.13
191,"Houston, We Got A Problem",Luke Combs,1,-3,4,1,0,8100,-9000,17100,1485546,2023.07.13
192,Bus Route,Tyler Childers,4,1,3,1,0,8000,-2100,10100,212016,2023.07.13
193,Feel For You,Boy Named Banjo,8,-1,9,1,0,8000,-6100,14100,45816,2023.07.13
194,90s Country,Holdaways,6,-3,9,1,0,8000,1000,7000,52,2023.07.13
195,Humble And Kind (Nunca Te Olvides De Amar),Tim McGraw,2,-1,3,1,0,7600,-4000,11600,1479,2023.07.13
196,One Name,Jeff & Sheri Easter,1,0,1,1,0,7500,2600,4900,17818,2023.07.13
197,The Way (New Horizon),Gaither Vocal Band,1,,,1,0,7500,,,4078,2023.07.13
197,Because He Lives,Carrie Underwood,1,,,1,0,7500,,,55775,2023.07.13
197,Beautiful Ever After,Zane & Donna King,1,,,1,0,7500,,,0,2023.07.13
197,Don'T You Think You Ought To Worship Me,Wisecarvers,1,,,1,0,7500,,,1472,2023.07.13
197,Goliath,Joseph Habedank,1,,,1,0,7500,,,3130,2023.07.13
197,His Grave Wrote The Song,Greater Vision,1,,,1,0,7500,,,371,2023.07.13
1,Fast Car,Luke Combs,8700,77,8623,145,0,34770900,52300,34718600,22675712,2023.07.20
2,Last Night,Morgan Wallen,7514,-101,7615,145,0,31625400,-290900,31916300,29903009,2023.07.20
3,Need A Favor,Jelly Roll,7772,616,7156,144,0,30477600,2916000,27561600,11204100,2023.07.20
4,Next Thing You Know,Jordan Davis,6441,-599,7040,144,0,26596800,-1968200,28565000,8646368,2023.07.20
5,Dancin' In The Country,Tyler Hubbard,5663,-237,5900,145,0,25909800,-595000,26504800,6869497,2023.07.20
6,"You, Me, And Whiskey",Justin Moore & Priscilla Block,6603,266,6337,145,0,24888800,867000,24021800,3606699,2023.07.20
7,Your Heart Or Mine,Jon Pardi,5773,130,5643,145,0,21231700,943100,20288600,4644832,2023.07.20
8,Love You Anyway,Luke Combs,5698,363,5335,145,0,21104400,1362700,19741700,7401722,2023.07.20
9,Bury Me In Georgia,Kane Brown,5484,398,5086,145,0,20594800,1115900,19478900,6872491,2023.07.20
10,Angels,Thomas Rhett,4676,98,4578,145,0,17658200,259200,17399000,2392885,2023.07.20
11,Religiously,Bailey Zimmerman,4193,332,3861,145,0,15970300,758200,15212100,11517541,2023.07.20
12,Girl In Mine,Parmalee,4225,110,4115,144,0,14732100,161500,14570600,2983982,2023.07.20
13,Looking For You,Chris Young,3786,140,3646,145,0,13019900,408100,12611800,2580834,2023.07.20
14,Drinkaby,Cole Swindell,3789,-8,3797,145,0,12906500,209600,12696900,2703607,2023.07.20
15,But I Got A Beer In My Hand,Luke Bryan,3372,240,3132,145,0,11844800,856100,10988700,3174503,2023.07.20
16,Standing Room Only,Tim McGraw,3559,71,3488,145,0,11741400,165100,11576300,2941857,2023.07.20
17,Everything I Love,Morgan Wallen,2731,619,2112,144,0,10899900,1993100,8906800,4849193,2023.07.20
18,Watermelon Moonshine,Lainey Wilson,2983,284,2699,145,0,10251500,1344800,8906700,5514061,2023.07.20
19,Everything She Ain't,Hailey Whitters,3223,-25,3248,145,0,10161300,-95000,10256300,2842779,2023.07.20
20,God Gave Me A Girl,Russell Dickerson,2948,238,2710,141,0,10109200,814900,9294300,1637803,2023.07.20
21,Save Me The Trouble,Dan + Shay,2308,2305,3,136,0,10076400,10070400,6000,4580868,2023.07.20
22,Can'T Have Mine,Dylan Scott,2880,78,2802,145,0,8795500,295400,8500100,3176930,2023.07.20
23,If You Go Down (I'M Going Down Too),Kelsea Ballerini,2989,193,2796,145,0,8514800,535100,7979700,2491517,2023.07.20
24,Stars Like Confetti,Dustin Lynch,2517,305,2212,141,0,7869000,1386000,6483000,1893944,2023.07.20
25,Try That In A Small Town,Jason Aldean,1950,199,1751,136,0,6540600,888700,5651900,12533277,2023.07.20
26,All I Need Is You,Chris Janson,2251,70,2181,139,0,5748200,201600,5546600,1096907,2023.07.20
27,We Got History,Mitchell Tenpenny,1795,65,1730,138,0,5668700,114200,5554500,1950963,2023.07.20
28,Light On In The Kitchen,Ashley McBryde,1980,37,1943,144,0,5284900,45900,5239000,1205110,2023.07.20
29,Mind On You,George Birge,1595,111,1484,138,0,3990000,373100,3616900,237945,2023.07.20
30,Nobody's Nobody,Brothers Osborne,1587,2,1585,139,0,3896300,2600,3893700,1658782,2023.07.20
31,Creek Will Rise,Conner Smith,1671,76,1595,142,0,3838600,272200,3566400,1172642,2023.07.20
32,23,Chayce Beckham,1460,26,1434,137,0,3719300,51800,3667500,2889596,2023.07.20
33,Different 'Round Here,Riley Green,1302,96,1206,130,0,3539400,215400,3324000,1789855,2023.07.20
34,Fearless,Jackson Dean,1529,-51,1580,142,0,3260300,-23800,3284100,1083190,2023.07.20
35,Glory Days,Gabby Barrett,1190,-4,1194,132,0,3219600,-155200,3374800,2101051,2023.07.20
36,Fires Don'T Start Themselves,Darius Rucker,983,85,898,131,0,2866800,254500,2612300,1098529,2023.07.20
37,See You Next Summer,Brian Kelley,1028,39,989,115,0,2601100,-33900,2635000,409303,2023.07.20
38,We Don'T Fight Anymore,Carly Pearce,881,77,804,97,0,2528200,351900,2176300,2326604,2023.07.20
39,Truck Bed,Hardy,965,60,905,88,0,2511900,139200,2372700,6083680,2023.07.20
40,Thinkin' Bout Me,Morgan Wallen,610,32,578,34,0,2432200,328900,2103300,15054548,2023.07.20
41,Out Of That Truck,Carrie Underwood,727,-6,733,68,0,2277900,-53500,2331400,2393012,2023.07.20
42,World On Fire,Nate Smith,830,72,758,73,0,2142200,256000,1886200,4216865,2023.07.20
43,Burn It Down,Parker Mccollum,657,73,584,74,0,1937000,249100,1687900,3585828,2023.07.20
44,On The Boat Again,Jake Owen,663,32,631,71,0,1837200,244400,1592800,574852,2023.07.20
45,Drive You Out Of My Mind,Kassi Ashton,742,-18,760,79,0,1689900,-117100,1807000,1215909,2023.07.20
46,Over For You,Morgan Evans,667,-46,713,67,0,1620200,-56500,1676700,1091951,2023.07.20
47,Giving Up On That,Dalton Dover,806,21,785,84,0,1618300,58800,1559500,1517551,2023.07.20
48,Pretty Little Poison,Warren Zeiders,422,112,310,50,0,1490600,563600,927000,4516792,2023.07.20
49,Save Me (With Lainey Wilson),Jelly Roll,386,-23,409,35,0,1420400,-104300,1524700,5280469,2023.07.20
50,Somebody Else's Whiskey,Frank Ray,633,21,612,73,0,1127600,19500,1108100,150625,2023.07.20
51,Marry That Girl,Easton Corbin,553,6,547,68,0,1069700,34400,1035300,180577,2023.07.20
52,Shoot Tequila,Tigirlily Gold,561,-13,574,68,0,1022400,-120700,1143100,860892,2023.07.20
53,Bad Day To Be A Cold Beer,Chase Rice,512,-13,525,62,0,988500,-42800,1031300,230624,2023.07.20
54,Bout Damn Time,Neon Union,575,-49,624,76,0,955700,-32500,988200,53488,2023.07.20
55,Buy A Bar,Tim Dugger,285,36,249,41,0,742700,167300,575400,35250,2023.07.20
56,If I Die Young (Pt. 2),Kimberly Perry,384,-34,418,84,0,727600,-14100,741700,1228399,2023.07.20
57,Drinkin' Problems,Dillon Carmichael,356,60,296,55,0,682600,57000,625600,82233,2023.07.20
58,Love You Again,Chase Matthew,348,15,333,50,0,679800,43400,636400,3143324,2023.07.20
59,'98 Braves,Morgan Wallen,116,19,97,7,0,665900,54400,611500,3904935,2023.07.20
60,Save The Roses,Lee Brice,239,-10,249,33,0,587000,-15300,602300,640651,2023.07.20
61,Something Real,Dierks Bentley,315,30,285,47,0,582800,13400,569400,592562,2023.07.20
62,Jealous Of Myself,Tenille Arts,367,1,366,51,0,564100,5100,559000,61334,2023.07.20
63,Without You,Thompson Square,388,-18,406,56,0,518600,-45800,564400,31225,2023.07.20
64,Something's Gonna Kill Me,Corey Kent,262,87,175,42,0,406700,51900,354800,3835384,2023.07.20
65,Wine Country,Hannah Ellis,265,7,258,50,0,401000,43700,357300,104570,2023.07.20
66,Brokenhearted,Joe Nichols,261,-12,273,37,0,399900,-58700,458600,29500,2023.07.20
67,I'M Not Pretty,Megan Moroney,71,31,40,8,0,377400,211700,165700,1971153,2023.07.20
68,Waffle House,Jonas Brothers,74,,,37,0,350400,,,2980281,2023.07.20
69,I Just Killed A Man,Catie Offerman,239,26,213,43,0,308200,83800,224400,128857,2023.07.20
70,Always On My Mind,"Amanda Shires, Bobbie Nelson",56,7,49,55,0,302600,193100,109500,2807,2023.07.20
71,Dance With You,Brett Young,291,27,264,43,0,300200,29200,271000,2490690,2023.07.20
72,Trouble,Josh Ross,239,10,229,42,0,267800,14700,253100,2268224,2023.07.20
73,Heart To Break,Ryan Griffin,181,-28,209,24,0,202800,-32700,235500,174241,2023.07.20
74,Make You Mine,Marynn Taylor,252,20,232,43,0,201300,29400,171900,63391,2023.07.20
75,How Is She,Cole Swindell,28,7,21,1,0,196000,48800,147200,86679,2023.07.20
76,Oklahoma Smokeshow,Zach Bryan,48,-5,53,3,0,182100,-8200,190300,5080922,2023.07.20
77,Sticks And Stones,Lukas Nelson & Promise Of The Real,38,,,37,0,180500,,,102235,2023.07.20
78,Find Yourself,Lukas Nelson & Promise Of The Real,37,,,37,0,175200,,,256027,2023.07.20
79,Lovin You Gets In The Way,Ben Gallaher,97,1,96,16,0,157500,7500,150000,23498,2023.07.20
80,Daylight Savings,Kidd G,91,62,29,21,0,134700,86300,48400,206130,2023.07.20
81,Best Of Me,David Nail,37,1,36,1,0,131600,1700,129900,16171,2023.07.20
82,Ride The Wave,Russell Dickerson,30,19,11,21,0,124900,104100,20800,722722,2023.07.20
83,Thicc As Thieves,Lauren Alaina,43,12,31,2,0,124700,63000,61700,1745332,2023.07.20
84,Already Crazy,Carter Faith,48,38,10,48,0,103900,82300,21600,21903,2023.07.20
85,This Guy,Abby Anderson,48,,,48,0,103900,,,22232,2023.07.20
85,Whispering,Brooke Eden,48,,,48,0,103900,,,5831,2023.07.20
87,5 Leaf Clover,Luke Combs,16,-1,17,1,0,94300,400,93900,3034836,2023.07.20
88,Colorado,Florida Georgia Line,15,-1,16,2,0,91700,-12500,104200,70328,2023.07.20
89,Wasting All These Tears,Austin Snell,15,-7,22,2,0,83400,-67400,150800,862127,2023.07.20
90,Along For The Ride,Jordan Harvey,64,-45,109,11,0,81500,-65100,146600,38194,2023.07.20
91,June In July,Robby Johnson,16,,,15,0,78600,,,4914,2023.07.20
92,The Star-Spangled Banner,Chris Stapleton,15,-39,54,13,0,69900,-120500,190400,490026,2023.07.20
93,Heartfirst,Kelsea Ballerini,14,2,12,1,0,67500,15800,51700,663219,2023.07.20
94,One Of Us,Matt Stell,17,-6,23,3,0,67200,-41300,108500,977247,2023.07.20
95,Tulsa,Elle King,25,2,23,2,0,66100,-7100,73200,71751,2023.07.20
96,With You I Am,Cody Johnson,6,0,6,2,0,65500,17500,48000,1333429,2023.07.20
97,So Many Summers,Brad Paisley,10,-12,22,10,0,64600,-39100,103700,811222,2023.07.20
98,Same Here,Brad Paisley,10,,,10,0,64000,,,11520,2023.07.20
99,Young Man's Blues,Parker Mccollum,5,0,5,1,0,63400,18200,45200,498067,2023.07.20
100,Neon You,Don Louis,6,2,4,1,0,62600,37300,25300,89893,2023.07.20
101,Man Made A Bar,Morgan Wallen,24,13,11,14,0,60000,33500,26500,4318758,2023.07.20
102,First Rodeo,Daves Highway,94,28,66,19,0,53900,16200,37700,494,2023.07.20
103,Sun To Me,Zach Bryan,27,3,24,3,0,53300,15600,37700,4559932,2023.07.20
104,Honey!,Rayne Johnson,90,33,57,19,0,53000,22200,30800,34567,2023.07.20
105,Out Of Nowhere,Walker Montgomery,13,-1,14,1,0,52200,-200,52400,15116,2023.07.20
106,A Special Place,Danielle Bradbery,26,-5,31,5,0,52200,22000,30200,238000,2023.07.20
107,Cowgirls,Morgan Wallen,16,7,9,7,0,51900,26500,25400,7363550,2023.07.20
108,Down On The Beach,Russell Dickerson,22,10,12,8,0,49700,25000,24700,193805,2023.07.20
109,Still,Luke Combs,15,3,12,1,0,47700,10300,37400,590892,2023.07.20
110,Holy Water,Michael Ray,7,0,7,2,0,47500,9600,37900,315882,2023.07.20
111,"Love, Beer",Andrew Sevener,76,23,53,19,0,42800,12200,30600,687,2023.07.20
112,Grease,Lainey Wilson,18,-1,19,2,0,41700,-5300,47000,252305,2023.07.20
113,Just To Be Loved,Jo Dee Messina,7,6,1,7,0,38400,33200,5200,44572,2023.07.20
114,Ain't That Some,Morgan Wallen,13,-6,19,3,0,38000,-13300,51300,6243700,2023.07.20
115,Sun Sets In Colorado,Dierks Bentley,13,-2,15,1,0,37700,-2500,40200,48973,2023.07.20
116,Star Spangled Banner,Abby Anderson,6,1,5,5,0,34200,6000,28200,0,2023.07.20
117,You In A Honky Tonk,Randall King,4,0,4,2,0,34100,10400,23700,490084,2023.07.20
118,Ain'T Missin' You,Dylan Schneider,42,29,13,8,0,33600,-10100,43700,325654,2023.07.20
119,How I Get High,Josh Kaiser,54,12,42,14,0,32800,7900,24900,0,2023.07.20
120,Record High,Randall King,4,3,1,3,0,32400,26300,6100,34617,2023.07.20
121,Question The Universe,Teddy Robb,57,-13,70,19,0,32300,-8600,40900,6220,2023.07.20
122,Drink One For Me,Hardy,5,-3,8,1,0,32100,-20700,52800,194928,2023.07.20
123,A Walk In The Bar,Lauren Alaina,9,0,9,2,0,31800,5700,26100,151301,2023.07.20
124,Giving You Up,Kameron Marlowe,7,1,6,1,0,29300,2500,26800,1023086,2023.07.20
125,The Star-Spangled Banner,Carly Pearce,4,-1,5,4,0,27700,-22900,50600,0,2023.07.20
126,You Don't Want That Smoke,Bailey Zimmerman,10,,,10,0,26700,,,2048804,2023.07.20
127,Have You Forgotten?,Darryl Worley,5,3,2,4,0,26300,18900,7400,88016,2023.07.20
128,Loser,Mike Ryan,4,0,4,2,0,25300,-17600,42900,12129,2023.07.20
129,Too Soon To Say Goodbye,Wayland,42,-6,48,14,0,24900,-5000,29900,454,2023.07.20
130,3 Tequila Floor,Josiah Siska,20,2,18,4,0,24100,8500,15600,11664,2023.07.20
131,God Blessed Texas,"Randy Rogers Band, Josh Abbott Band & Casey Donahew Feat. Crowell, Watson, Green",4,3,1,3,0,23500,21500,2000,258892,2023.07.20
132,Tuggin' On My Heartstrings,Randall King,3,0,3,1,0,23300,0,23300,26592,2023.07.20
133,Wild as You,Cody Johnson,5,2,3,3,0,22800,-5300,28100,1084872,2023.07.20
134,National Anthem From Battle At Bristol,Jennifer Nettles,4,2,2,4,0,21900,11000,10900,0,2023.07.20
135,My Bar,Priscilla Block,10,8,2,9,0,21500,16600,4900,195928,2023.07.20
136,Songs We Used To Sing,Ernest,6,-1,7,1,0,21400,3900,17500,84326,2023.07.20
137,I Hope Heaven,Karissa Ella,37,-17,54,19,0,21400,-8700,30100,0,2023.07.20
138,We Ain't The Only Ones,Randy Rogers & Wade Bowen,2,-1,3,2,0,20200,-4500,24700,0,2023.07.20
139,Better Off,Trace Adkins,3,0,3,2,0,19800,-5400,25200,16448,2023.07.20
140,Cover Me Up,Morgan Wallen,4,2,2,3,0,19400,13100,6300,5001836,2023.07.20
141,Downtime,Roman Alexander,33,,,19,0,19100,,,10305,2023.07.20
142,Pretender,Sarah Darling,38,-34,72,19,0,18900,-22000,40900,378,2023.07.20
143,I Bet You Think About Me (Taylor's Version) (From The Vault),Taylor Swift Feat. Chris Stapleton,11,5,6,1,0,18700,8500,10200,1112767,2023.07.20
144,Loud and Heavy,Cody Jinks,11,7,4,3,0,18300,14300,4000,1942699,2023.07.20
145,Girl On Fire,Kameron Marlowe,1,-1,2,1,0,18200,17000,1200,1059058,2023.07.20
146,Plainview,Kin Faux,1,,,1,0,18200,,,3322,2023.07.20
146,Ragweed,Koe Wetzel,1,,,1,0,18200,,,413348,2023.07.20
146,If You Ever Get Lonely,Jake Bush,1,,,1,0,18200,,,2580,2023.07.20
149,Nothing Compares To You,Mickey Guyton,5,,,5,0,18100,,,0,2023.07.20
150,I Wrote The Book,Morgan Wallen,3,2,1,3,0,18000,6200,11800,5545168,2023.07.20
151,"Salt, Lime & Tequila",Ryan Griffin,2,,,1,0,17800,,,120207,2023.07.20
152,You'Re Gonna Love Me,Tim Dugger,2,-2,4,1,0,16800,2600,14200,9856,2023.07.20
153,That's Why We Fight,Ella Langley & Koe Wetzel,11,4,7,1,0,15900,7800,8100,1175012,2023.07.20
154,Forever Bound,12/Oc,9,-3,12,1,0,15300,-11400,26700,5153,2023.07.20
155,Decoration,Jillian Riscoe,8,3,5,1,0,15200,7800,7400,7,2023.07.20
156,Any Given Friday Night,Luke Combs,2,,,1,0,15200,,,332322,2023.07.20
157,Mix 'Em With Whiskey,Drake White,3,,,1,0,15000,,,401148,2023.07.20
158,Soundtrack To A Small Town Sundown,Tyler Farr,3,,,1,0,14800,,,13109,2023.07.20
159,Dazed And Confused,Vanatei,2,,,1,0,14400,,,0,2023.07.20
160,Just Drive,Erin Kinsey,6,-5,11,6,0,14300,-12600,26900,144224,2023.07.20
161,Hungover You,Emily Brooke,6,,,6,0,14300,,,899,2023.07.20
161,Back In The Saddle,Ashley Cooke,6,,,6,0,14300,,,93066,2023.07.20
163,Lovin' Where It's Goin',Josh Ward,4,1,3,2,0,13500,-19000,32500,39983,2023.07.20
164,Savior's Shadow,Blake Shelton,2,,,2,0,13300,,,11383,2023.07.20
165,Whiskey Friends,Morgan Wallen,2,,,2,0,13000,,,2555839,2023.07.20
166,Heading South,Zach Bryan,3,2,1,2,0,12900,11600,1300,4815666,2023.07.20
167,I'm In Love,Hailey Whitters,3,,,2,0,12800,,,191,2023.07.20
168,Inside And Out,Tyler Hubbard,4,3,1,1,0,12400,9300,3100,107884,2023.07.20
169,Think About There,Greater Vision,2,1,1,2,0,12400,7500,4900,2500,2023.07.20
169,Nobody Like Jesus,LeFevre Quartet,2,1,1,2,0,12400,7500,4900,2460,2023.07.20
171,From Austin,Zach Bryan,2,1,1,2,0,12400,6300,6100,2220821,2023.07.20
172,Ooo,Dj Nothin Nice,4,,,1,0,12300,,,0,2023.07.20
173,The Night You Walked Away,Costello,2,1,1,1,0,12200,6100,6100,39,2023.07.20
173,I DREW A LINE,Folk Family Revival,2,1,1,1,0,12200,6100,6100,451,2023.07.20
175,Bigger Houses,Dan + Shay,3,,,2,0,12100,,,794724,2023.07.20
176,Heartless,Diplo & Julia Michaels Feat. Morgan Wallen,3,0,3,3,0,12000,-2900,14900,7069964,2023.07.20
177,Damn Love,Kip Moore,14,-40,54,5,0,11900,-38800,50700,290729,2023.07.20
178,Stop Coming Over,Chris Lane,6,1,5,6,0,11800,-800,12600,47125,2023.07.20
179,Every Single Summer,Marynn Taylor,6,-1,7,6,0,11800,-5600,17400,3810,2023.07.20
180,Sunrise,Morgan Wallen,2,,,2,0,11800,,,4552054,2023.07.20
181,Humble And Kind (Nunca Te Olvides De Amar),Tim McGraw,3,1,2,1,0,11600,4000,7600,756,2023.07.20
182,Young Love & Saturday Nights,Chris Young,1,,,1,0,11500,,,1699,2023.07.20
183,The Star Spangled Banner,Brad Paisley,2,,,2,0,11000,,,0,2023.07.20
184,Back At The Bar,Landon Parker,20,,,19,0,11000,,,11173,2023.07.20
184,Under A Southern Sky,Ian Flanigan,20,,,19,0,11000,,,1017,2023.07.20
186,Star Spangled Banner,Demi Lovato,2,1,1,2,0,10900,1500,9400,74,2023.07.20
187,House Fire,Tyler Childers,3,1,2,1,0,10700,4100,6600,1239298,2023.07.20
188,Too Much Of A Woman,Roberta Lea,19,-35,54,18,0,10700,-20200,30900,0,2023.07.20
189,Feel For You,Boy Named Banjo,7,-1,8,1,0,10500,2500,8000,55508,2023.07.20
190,Pastels,Brook & The Bluff,3,,,1,0,10500,,,22364,2023.07.20
191,You Are My Sunshine,Morgane Stapleton,2,,,1,0,10400,,,95100,2023.07.20
192,Keep Movin' Along,Perrys,2,1,1,2,0,10200,5300,4900,6070,2023.07.20
193,I Don'T Want To Get Adjusted,Kim Hopper,2,0,2,2,0,10200,0,10200,63,2023.07.20
194,Goin' Crazy,Jameson Rodgers,8,-1,9,1,0,10100,-600,10700,17274,2023.07.20
195,Behind Bars,Jelly Roll,4,1,3,1,0,10000,3100,6900,523508,2023.07.20
196,Hungover You,Ethan Anderson,2,,,1,0,10000,,,192,2023.07.20
197,Tucson Too Late,Jordan Davis,1,0,1,1,0,9500,7800,1700,994481,2023.07.20
198,Tough Crowd,Jason Aldean,2,1,1,1,0,9400,8700,700,1221336,2023.07.20
199,Star Spangled Banner,Mickey Guyton,2,-1,3,2,0,9300,-2200,11500,0,2023.07.20
200,Quittin' Time,Morgan Wallen,2,1,1,1,0,9200,7900,1300,1168195,2023.07.20
1,Fast Car,Luke Combs,8239,-461,8700,145,0,33766600,-1004300,34770900,22829412,2023.07.27
2,Need A Favor,Jelly Roll,8204,432,7772,144,0,32690300,2212700,30477600,11412015,2023.07.27
3,Last Night,Morgan Wallen,7230,-284,7514,145,0,30142100,-1483300,31625400,29832319,2023.07.27
4,"You, Me, And Whiskey",Justin Moore & Priscilla Block,7003,400,6603,145,0,26594000,1705200,24888800,4237490,2023.07.27
5,Dancin' In The Country,Tyler Hubbard,5343,-320,5663,145,0,24125900,-1783900,25909800,6751766,2023.07.27
6,Bury Me In Georgia,Kane Brown,5867,383,5484,145,0,22186900,1592100,20594800,6641545,2023.07.27
7,Love You Anyway,Luke Combs,6031,333,5698,145,0,22139600,1035200,21104400,7528534,2023.07.27
8,Your Heart Or Mine,Jon Pardi,5786,13,5773,145,0,21339300,107600,21231700,5060666,2023.07.27
9,Angels,Thomas Rhett,4829,153,4676,145,0,18283700,625500,17658200,2544743,2023.07.27
10,Religiously,Bailey Zimmerman,4342,149,4193,145,0,16376100,405800,15970300,12013164,2023.07.27
11,Girl In Mine,Parmalee,4291,66,4225,144,0,15370900,638800,14732100,3075570,2023.07.27
12,But I Got A Beer In My Hand,Luke Bryan,3730,358,3372,145,0,13243500,1398700,11844800,3501250,2023.07.27
13,Looking For You,Chris Young,3807,21,3786,145,0,13199300,179400,13019900,2753715,2023.07.27
14,Drinkaby,Cole Swindell,3818,29,3789,145,0,12942500,36000,12906500,2825317,2023.07.27
15,Standing Room Only,Tim McGraw,3574,15,3559,145,0,12229500,488100,11741400,2858117,2023.07.27
16,Everything I Love,Morgan Wallen,3026,295,2731,144,0,11946900,1047000,10899900,4757943,2023.07.27
17,Watermelon Moonshine,Lainey Wilson,3188,205,2983,145,0,11048600,797100,10251500,5648049,2023.07.27
18,God Gave Me A Girl,Russell Dickerson,3173,225,2948,140,0,10755700,646500,10109200,2152806,2023.07.27
19,Everything She Ain't,Hailey Whitters,3170,-53,3223,145,0,9867500,-293800,10161300,2690700,2023.07.27
20,White Horse,Chris Stapleton,2123,2122,1,134,0,9551400,9546900,4500,9892131,2023.07.27
21,Can'T Have Mine,Dylan Scott,2913,33,2880,145,0,9146800,351300,8795500,3241310,2023.07.27
22,If You Go Down (I'M Going Down Too),Kelsea Ballerini,3002,13,2989,145,0,8647100,132300,8514800,2603211,2023.07.27
23,Stars Like Confetti,Dustin Lynch,2716,199,2517,141,0,8380800,511800,7869000,1985206,2023.07.27
24,Try That In A Small Town,Jason Aldean,2210,260,1950,141,0,7927800,1387200,6540600,37341327,2023.07.27
25,All I Need Is You,Chris Janson,2279,28,2251,144,0,5950900,202700,5748200,1222536,2023.07.27
26,We Got History,Mitchell Tenpenny,1827,32,1795,139,0,5729100,60400,5668700,1880104,2023.07.27
27,Light On In The Kitchen,Ashley McBryde,1969,-11,1980,144,0,5144900,-140000,5284900,1262556,2023.07.27
28,Mind On You,George Birge,1621,26,1595,137,0,4459500,469500,3990000,254685,2023.07.27
29,Nobody's Nobody,Brothers Osborne,1679,92,1587,139,0,4199400,303100,3896300,1781791,2023.07.27
30,Save Me The Trouble,Dan + Shay,1258,-1050,2308,116,0,3741300,-6335100,10076400,3094249,2023.07.27
31,23,Chayce Beckham,1466,6,1460,139,0,3720300,1000,3719300,2959470,2023.07.27
32,Creek Will Rise,Conner Smith,1688,17,1671,142,0,3708100,-130500,3838600,1219885,2023.07.27
33,Glory Days,Gabby Barrett,1293,103,1190,137,0,3327600,108000,3219600,2128274,2023.07.27
34,Different 'Round Here,Riley Green,1212,-90,1302,131,0,3231000,-308400,3539400,1791725,2023.07.27
35,Fearless,Jackson Dean,1532,3,1529,142,0,3219700,-40600,3260300,996407,2023.07.27
36,See You Next Summer,Brian Kelley,1192,164,1028,116,0,3046500,445400,2601100,533620,2023.07.27
37,Out Of That Truck,Carrie Underwood,846,119,727,86,0,2778000,500100,2277900,2681924,2023.07.27
38,Fires Don'T Start Themselves,Darius Rucker,955,-28,983,111,0,2670000,-196800,2866800,1161807,2023.07.27
39,Thinkin' Bout Me,Morgan Wallen,670,60,610,36,0,2594600,162400,2432200,14650367,2023.07.27
40,We Don'T Fight Anymore,Carly Pearce,870,-11,881,104,0,2408500,-119700,2528200,2280116,2023.07.27
41,Truck Bed,Hardy,925,-40,965,91,0,2314400,-197500,2511900,6613255,2023.07.27
42,World On Fire,Nate Smith,882,52,830,74,0,2228300,86100,2142200,4639389,2023.07.27
43,Pretty Little Poison,Warren Zeiders,644,222,422,56,0,2191300,700700,1490600,5276630,2023.07.27
44,Burn It Down,Parker Mccollum,710,53,657,71,0,2041200,104200,1937000,4051842,2023.07.27
45,On The Boat Again,Jake Owen,694,31,663,71,0,2037100,199900,1837200,543580,2023.07.27
46,Drive You Out Of My Mind,Kassi Ashton,779,37,742,82,0,1847200,157300,1689900,1284471,2023.07.27
47,Giving Up On That,Dalton Dover,789,-17,806,87,0,1616100,-2200,1618300,1236831,2023.07.27
48,Save Me (With Lainey Wilson),Jelly Roll,346,-40,386,24,0,1287300,-133100,1420400,5151269,2023.07.27
49,Shoot Tequila,Tigirlily Gold,610,49,561,66,0,1197100,174700,1022400,935735,2023.07.27
50,Somebody Else's Whiskey,Frank Ray,647,14,633,76,0,1183100,55500,1127600,164321,2023.07.27
51,Bad Day To Be A Cold Beer,Chase Rice,552,40,512,62,0,1010100,21600,988500,224659,2023.07.27
52,Marry That Girl,Easton Corbin,536,-17,553,70,0,961000,-108700,1069700,172447,2023.07.27
53,Outskirts,Sam Hunt,349,,,50,0,839500,,,3246081,2023.07.27
54,Buy A Bar,Tim Dugger,276,-9,285,41,0,795600,52900,742700,35976,2023.07.27
55,Drinkin' Problems,Dillon Carmichael,406,50,356,73,0,737700,55100,682600,78122,2023.07.27
56,If I Die Young (Pt. 2),Kimberly Perry,351,-33,384,79,0,677300,-50300,727600,840618,2023.07.27
57,Love You Again,Chase Matthew,362,14,348,44,0,667800,-12000,679800,3421156,2023.07.27
58,Save The Roses,Lee Brice,263,24,239,39,0,648900,61900,587000,754021,2023.07.27
59,Something Real,Dierks Bentley,340,25,315,50,0,648200,65400,582800,475082,2023.07.27
60,Jealous Of Myself,Tenille Arts,353,-14,367,50,0,641000,76900,564100,55311,2023.07.27
61,Something's Gonna Kill Me,Corey Kent,313,51,262,44,0,635300,228600,406700,3256990,2023.07.27
62,Without You,Thompson Square,395,7,388,56,0,575500,56900,518600,27315,2023.07.27
63,'98 Braves,Morgan Wallen,90,-26,116,2,0,547700,-118200,665900,3731804,2023.07.27
64,I'M Not Pretty,Megan Moroney,117,46,71,19,0,534000,156600,377400,1904959,2023.07.27
65,Wine Country,Hannah Ellis,287,22,265,47,0,459800,58800,401000,104516,2023.07.27
66,Just To Be Loved,Jo Dee Messina,107,100,7,58,0,414100,375700,38400,47237,2023.07.27
67,Brokenhearted,Joe Nichols,246,-15,261,39,0,383700,-16200,399900,41447,2023.07.27
68,Daylight Savings,Kidd G,188,97,91,39,0,337500,202800,134700,202664,2023.07.27
69,Dance With You,Brett Young,296,5,291,56,0,332100,31900,300200,2785559,2023.07.27
70,Trouble,Josh Ross,248,9,239,41,0,311700,43900,267800,2372766,2023.07.27
71,I Just Killed A Man,Catie Offerman,219,-20,239,35,0,242700,-65500,308200,121089,2023.07.27
72,Make You Mine,Marynn Taylor,270,18,252,44,0,227500,26200,201300,60597,2023.07.27
73,Oklahoma Smokeshow,Zach Bryan,52,4,48,4,0,199900,17800,182100,5613720,2023.07.27
74,Young Love & Saturday Nights,Chris Young,41,40,1,10,0,174800,163300,11500,896932,2023.07.27
75,How Is She,Cole Swindell,27,-1,28,1,0,173000,-23000,196000,91571,2023.07.27
76,Heart To Break,Ryan Griffin,177,-4,181,24,0,169900,-32900,202800,149401,2023.07.27
77,Namaste,Bobby Bones & The Raging Idiot,35,,,35,0,167600,,,1732,2023.07.27
78,Thicc As Thieves,Lauren Alaina,48,5,43,2,0,160700,36000,124700,1615978,2023.07.27
79,Ain'T Missin' You,Dylan Schneider,93,51,42,26,0,155900,122300,33600,393810,2023.07.27
80,Closer,Chainsmokers Feat. Halsey,35,,,20,0,155200,,,3643289,2023.07.27
81,Lovin You Gets In The Way,Ben Gallaher,80,-17,97,16,0,122500,-35000,157500,21975,2023.07.27
82,One Of Us,Matt Stell,28,11,17,3,0,122200,55000,67200,870321,2023.07.27
83,With You I Am,Cody Johnson,10,4,6,3,0,120700,55200,65500,1322739,2023.07.27
84,Best Of Me,David Nail,36,-1,37,1,0,120200,-11400,131600,19636,2023.07.27
85,Already Crazy,Carter Faith,48,0,48,48,0,103900,0,103900,20816,2023.07.27
86,Mean Girl,Ashley Cooke,48,,,48,0,103900,,,224972,2023.07.27
87,5 Leaf Clover,Luke Combs,16,0,16,1,0,98900,4600,94300,3031919,2023.07.27
88,A Special Place,Danielle Bradbery,35,9,26,7,0,96500,44300,52200,236501,2023.07.27
89,Wasting All These Tears,Austin Snell,16,1,15,1,0,91900,8500,83400,868034,2023.07.27
90,Colorado,Florida Georgia Line,14,-1,15,2,0,89600,-2100,91700,67700,2023.07.27
91,Don't Think Jesus,Morgan Wallen,13,10,3,13,0,72900,68300,4600,1675307,2023.07.27
92,Tucson Too Late,Jordan Davis,13,12,1,2,0,72100,62600,9500,978588,2023.07.27
93,Tuggin' On My Heartstrings,Randall King,4,1,3,1,0,68000,44700,23300,25963,2023.07.27
94,Jesus Got A Tight Grip,Blake Shelton,10,,,10,0,64600,,,14300,2023.07.27
95,Neon You,Don Louis,5,-1,6,2,0,63200,600,62600,95230,2023.07.27
96,The Star-Spangled Banner,Chris Stapleton,17,2,15,16,0,61700,-8200,69900,613059,2023.07.27
97,Giving You Up,Kameron Marlowe,9,2,7,2,0,55000,25700,29300,1005238,2023.07.27
98,Along For The Ride,Jordan Harvey,55,-9,64,10,0,53500,-28000,81500,38599,2023.07.27
99,Tough Crowd,Jason Aldean,21,19,2,2,0,53300,43900,9400,1813139,2023.07.27
100,Heartfirst,Kelsea Ballerini,15,1,14,1,0,51400,-16100,67500,686233,2023.07.27
101,Sun To Me,Zach Bryan,23,-4,27,3,0,51000,-2300,53300,4596510,2023.07.27
102,Out Of Nowhere,Walker Montgomery,14,1,13,1,0,50100,-2100,52200,14006,2023.07.27
103,Tulsa,Elle King,23,-2,25,2,0,47000,-19100,66100,75303,2023.07.27
104,Grease,Lainey Wilson,17,-1,18,3,0,46500,4800,41700,254207,2023.07.27
105,Holy Water,Michael Ray,8,1,7,2,0,44400,-3100,47500,342713,2023.07.27
106,"Love, Beer",Andrew Sevener,77,1,76,19,0,43400,600,42800,902,2023.07.27
107,Back At The Bar,Landon Parker,76,56,20,19,0,43200,32200,11000,10336,2023.07.27
108,Honey!,Rayne Johnson,76,-14,90,19,0,43200,-9800,53000,35121,2023.07.27
109,Have You Forgotten?,Darryl Worley,8,3,5,4,0,43100,16800,26300,94413,2023.07.27
110,3 Tequila Floor,Josiah Siska,18,-2,20,5,0,40300,16200,24100,11144,2023.07.27
111,The Star-Spangled Banner,Carly Pearce,3,-1,4,2,0,39400,11700,27700,0,2023.07.27
112,I Hope Heaven,Karissa Ella,73,36,37,19,0,38900,17500,21400,0,2023.07.27
113,You In A Honky Tonk,Randall King,3,-1,4,2,0,36800,2700,34100,490500,2023.07.27
114,For What It's Worth,Breland,6,-4,10,2,0,36400,27400,9000,1839381,2023.07.27
115,Sun Sets In Colorado,Dierks Bentley,13,0,13,1,0,35000,-2700,37700,49299,2023.07.27
116,A Walk In The Bar,Lauren Alaina,10,1,9,2,0,33700,1900,31800,137482,2023.07.27
117,How I Get High,Josh Kaiser,57,3,54,14,0,33400,600,32800,0,2023.07.27
118,Downtime,Roman Alexander,59,26,33,19,0,32800,13700,19100,20768,2023.07.27
119,Too Soon To Say Goodbye,Wayland,57,15,42,19,0,32400,7500,24900,578,2023.07.27
120,Under A Southern Sky,Ian Flanigan,56,36,20,19,0,32200,21200,11000,870,2023.07.27
121,First Rodeo,Daves Highway,56,-38,94,19,0,32200,-21700,53900,488,2023.07.27
122,Question The Universe,Teddy Robb,55,-2,57,19,0,32000,-300,32300,4954,2023.07.27
123,Young Man's Blues,Parker Mccollum,3,-2,5,1,0,30900,-32500,63400,490452,2023.07.27
124,Ain't That Some,Morgan Wallen,13,0,13,2,0,30100,-7900,38000,6026199,2023.07.27
125,Money On Me,Morgan Wallen,13,,,13,0,30000,,,1128829,2023.07.27
126,Cowgirls,Morgan Wallen,11,-5,16,4,0,29200,-22700,51900,7457075,2023.07.27
127,Just Drive,Erin Kinsey,12,6,6,6,0,28600,14300,14300,144432,2023.07.27
128,Stop Coming Over,Chris Lane,11,5,6,6,0,26500,14700,11800,52703,2023.07.27
129,Star Spangled Banner,Abby Anderson,3,-3,6,3,0,26500,-7700,34200,0,2023.07.27
130,Down On The Beach,Russell Dickerson,13,-9,22,1,0,25900,-23800,49700,176254,2023.07.27
131,Polaroid,Keith Urban,11,,,6,0,25500,,,19839,2023.07.27
132,Drink One For Me,Hardy,4,-1,5,1,0,25300,-6800,32100,197078,2023.07.27
133,Heart Of A Small Town,Tim Dugger,3,2,1,1,0,24300,21100,3200,17960,2023.07.27
134,The Good I'Ll Do,Zach Bryan,10,9,1,1,0,22700,18900,3800,2665429,2023.07.27
135,Lovin' Where It's Goin',Josh Ward,2,-2,4,1,0,22700,9200,13500,41659,2023.07.27
136,"1, 2 Many",Luke Combs & Brooks & Dunn,7,4,3,6,0,21400,14600,6800,1663218,2023.07.27
137,I'M Not For Everyone,Brothers Osborne,5,4,1,3,0,20600,18800,1800,573318,2023.07.27
138,From Austin,Zach Bryan,4,2,2,2,0,20600,8200,12400,2262683,2023.07.27
139,Find Yourself,Lukas Nelson & Promise Of The Real,9,-28,37,8,0,20400,-154800,175200,244607,2023.07.27
140,Nothin' On You,Cody Johnson,2,,,2,0,20200,,,1228277,2023.07.27
141,Codigo,George Strait,2,,,1,0,19000,,,37002,2023.07.27
142,The Luckiest,Josh Abbott Band,1,0,1,1,0,18200,16600,1600,31659,2023.07.27
143,We Ain't The Only Ones,Randy Rogers & Wade Bowen,1,-1,2,1,0,18200,-2000,20200,0,2023.07.27
144,Baby Do,Randall King,1,,,1,0,18200,,,27525,2023.07.27
144,A Cowboy Can (Live at Billy Bob's Texas),Josh Ward,1,,,1,0,18200,,,2275,2023.07.27
144,Why Indiana,Parker Mccollum,1,,,1,0,18200,,,153634,2023.07.27
147,"Salt, Lime & Tequila",Ryan Griffin,7,5,2,7,0,17200,-600,17800,112372,2023.07.27
148,The Great Divide,Luke Combs & Billy Strings,6,3,3,1,0,16800,9500,7300,257003,2023.07.27
149,Stranger In My House,Ronnie Milsap,1,-2,3,1,0,16600,4700,11900,148924,2023.07.27
150,Forever Bound,12/Oc,7,-2,9,1,0,16600,1300,15300,4601,2023.07.27
151,Quittin' Time,Morgan Wallen,4,2,2,1,0,16000,6800,9200,1134941,2023.07.27
152,Star Spangled Banner,Mickey Guyton,3,1,2,3,0,16000,6700,9300,0,2023.07.27
153,Wild as You,Cody Johnson,4,-1,5,2,0,15700,-7100,22800,1070777,2023.07.27
154,Buckles And Broken Hearts,Joe Peters,3,2,1,1,0,15600,14000,1600,1744,2023.07.27
155,That's Why We Fight,Ella Langley & Koe Wetzel,10,-1,11,1,0,15500,-400,15900,1100878,2023.07.27
156,Any Given Friday Night,Luke Combs,2,0,2,1,0,15200,0,15200,367454,2023.07.27
157,If It Wasn't For Trucks,Riley Green,4,0,4,2,0,14900,9700,5200,626416,2023.07.27
158,When Will I Be Loved,"Ashley McBryde, Caylee Hammack & Pillbox Patti",6,,,6,0,14300,,,40418,2023.07.27
158,Outrunnin' Your Memory,Luke Combs & Miranda Lambert,6,,,6,0,14300,,,735194,2023.07.27
160,Star Spangled Banner,Maren Morris,1,0,1,1,0,13700,4700,9000,0,2023.07.27
161,Loud and Heavy,Cody Jinks,7,-4,11,1,0,13200,-5100,18300,1950960,2023.07.27
162,Love Is Real,Morgan Evans,6,2,4,2,0,12800,8800,4000,56240,2023.07.27
163,ghost in my guitar,Alana Springsteen,2,,,2,0,12700,,,463778,2023.07.27
164,She's Somebody's Daughter,Drew Baldridge,11,8,3,2,0,12400,7800,4600,123949,2023.07.27
165,National Anthem From Battle At Bristol,Jennifer Nettles,4,0,4,4,0,12300,-9600,21900,0,2023.07.27
166,Runnin' Through That T,Thomas Edwards,1,,,1,0,11700,,,20926,2023.07.27
167,We Are The Champions/We Will Rock You,Dolly Parton,1,,,1,0,11300,,,0,2023.07.27
167,We Are The Champions/We Will Rock You,Dolly Parton,1,,,1,0,11300,,,665240,2023.07.27
169,All Trucks Go To Heaven,Boomtown Saints,5,,,5,0,11200,,,4308,2023.07.27
170,The Star Spangled Banner,Brad Paisley,3,1,2,3,0,11100,100,11000,0,2023.07.27
171,Longneck Way To Go,Midland Feat. Jon Pardi,2,-5,7,1,0,10900,2000,8900,194020,2023.07.27
172,House Fire,Tyler Childers,3,0,3,1,0,10700,0,10700,1214267,2023.07.27
173,Loser,Mike Ryan,2,-2,4,1,0,10400,-14900,25300,11782,2023.07.27
174,Once And For All,Gold City,2,1,1,2,0,10200,4900,5300,17971,2023.07.27
175,"Liar, Liar",Brian Free & Assurance,2,,,2,0,10200,,,20158,2023.07.27
176,Bigger Houses,Dan + Shay,7,4,3,1,0,10100,-2000,12100,553134,2023.07.27
177,Better Off,Trace Adkins,4,1,3,3,0,10000,-9800,19800,16711,2023.07.27
178,Goin' Crazy,Jameson Rodgers,8,0,8,1,0,10000,-100,10100,17419,2023.07.27
179,Build A Bridge,Ashley Cooke,5,,,1,0,9800,,,66568,2023.07.27
180,"The Father, My Son, And The Holy Ghost",Craig Morgan,2,1,1,1,0,9700,8400,1300,57253,2023.07.27
181,Humble And Kind (Nunca Te Olvides De Amar),Tim McGraw,2,-1,3,2,0,9700,-1900,11600,878,2023.07.27
182,Man Made A Bar,Morgan Wallen,8,-16,24,2,0,9700,-50300,60000,4271423,2023.07.27
183,Girl On Fire,Kameron Marlowe,3,2,1,1,0,9600,-8600,18200,1006691,2023.07.27
184,Heartless,Diplo & Julia Michaels Feat. Morgan Wallen,4,1,3,2,0,9500,-2500,12000,7123034,2023.07.27
185,Hannah Ford Road,Luke Combs,1,0,1,1,0,9500,8500,1000,615370,2023.07.27
186,Star Spangled Banner,Demi Lovato,1,-1,2,1,0,9400,-1500,10900,98,2023.07.27
187,Behind Bars,Jelly Roll,3,-1,4,1,0,9300,-700,10000,549496,2023.07.27
188,Feel Like This,Ingrid Andress,10,-1,11,2,0,8800,7500,1300,1181515,2023.07.27
189,BELLS,Rachelle Garniez,1,0,1,1,0,8700,0,8700,0,2023.07.27
190,Paradise To Me,Niko Moon,3,-1,4,2,0,8700,3100,5600,664959,2023.07.27
191,Dangerous,Morgan Wallen,1,0,1,1,0,8400,6200,2200,1844758,2023.07.27
192,God Only Knows,for King & Country,1,0,1,1,0,8400,5200,3200,1111663,2023.07.27
193,I Wrote The Book,Morgan Wallen,1,-2,3,1,0,8400,-9600,18000,5596467,2023.07.27
194,Country A$$ Shit,Morgan Wallen,1,,,1,0,8400,,,694312,2023.07.27
194,Like I'M On The Shore,Erwins,1,,,1,0,8400,,,1472,2023.07.27
194,For My Money,Brandon Lay,1,,,1,0,8400,,,14353,2023.07.27
194,Safe Haven,Hillary Scott & The Scott Family,1,,,1,0,8400,,,5186,2023.07.27
194,Silverado For Sale,Morgan Wallen,1,,,1,0,8400,,,1650296,2023.07.27
199,Everything Has Your Memory,Wade Bowen,2,1,1,2,0,8100,2000,6100,12061,2023.07.27
199,Nothing But Love Songs,Randy Rogers Band,2,1,1,2,0,8100,2000,6100,16725,2023.07.27
201,Songs We Used To Sing,Ernest,5,-1,6,1,0,8100,-13300,21400,83187,2023.07.27
202,Pastels,Brook & The Bluff,1,-2,3,1,0,8100,-2400,10500,20840,2023.07.27
203,He's a Coming,Darin & Brooke Aldridge,1,,,1,0,8100,,,161,2023.07.27
1,Need A Favor,Jelly Roll,8254,121,8133,143,0,32935600,504000,32431600,10451942,2023.08.03
2,Fast Car,Luke Combs,7917,-252,8169,144,0,32454700,-1069900,33524600,21361899,2023.08.03
3,"You, Me, And Whiskey",Justin Moore & Priscilla Block,7743,807,6936,144,0,29817300,3477700,26339600,5845139,2023.08.03
4,Last Night,Morgan Wallen,6641,-527,7168,144,0,28732100,-1179400,29911500,27521511,2023.08.03
5,Love You Anyway,Luke Combs,6366,401,5965,144,0,23846200,1932900,21913300,7425668,2023.08.03
6,Dancin' In The Country,Tyler Hubbard,5461,153,5308,143,0,23827200,-167100,23994300,6517796,2023.08.03
7,Bury Me In Georgia,Kane Brown,6026,202,5824,144,0,23063800,1008700,22055100,6637096,2023.08.03
8,Your Heart Or Mine,Jon Pardi,6100,355,5745,144,0,22807700,1594600,21213100,4150990,2023.08.03
9,Angels,Thomas Rhett,5006,210,4796,144,0,18483300,311100,18172200,2485496,2023.08.03
10,Religiously,Bailey Zimmerman,4523,206,4317,144,0,16362900,64200,16298700,12016289,2023.08.03
11,Girl In Mine,Parmalee,4369,113,4256,143,0,16089400,842400,15247000,3219043,2023.08.03
12,But I Got A Beer In My Hand,Luke Bryan,3812,105,3707,144,0,13701200,527500,13173700,3565850,2023.08.03
13,Drinkaby,Cole Swindell,3854,50,3804,144,0,13560100,634300,12925800,2436572,2023.08.03
14,Looking For You,Chris Young,3840,67,3773,144,0,13319400,255800,13063600,2608711,2023.08.03
15,Everything I Love,Morgan Wallen,3276,263,3013,144,0,12494400,603300,11891100,4594137,2023.08.03
16,Standing Room Only,Tim McGraw,3534,-17,3551,144,0,11924200,-245800,12170000,2489294,2023.08.03
17,God Gave Me A Girl,Russell Dickerson,3304,165,3139,141,0,11783700,1146300,10637400,1591735,2023.08.03
18,Watermelon Moonshine,Lainey Wilson,3505,346,3159,144,0,11758300,824200,10934100,5795147,2023.08.03
19,Try That In A Small Town,Jason Aldean,2992,783,2209,139,0,10789800,2865900,7923900,19623644,2023.08.03
20,Everything She Ain't,Hailey Whitters,3210,52,3158,143,0,9945200,90600,9854600,2589365,2023.08.03
21,Can'T Have Mine,Dylan Scott,2964,65,2899,144,0,9324600,196500,9128100,2971461,2023.08.03
22,If You Go Down (I'M Going Down Too),Kelsea Ballerini,3036,68,2968,144,0,9043100,508300,8534800,2289050,2023.08.03
23,Stars Like Confetti,Dustin Lynch,2648,-36,2684,141,0,8387900,123600,8264300,1745684,2023.08.03
24,All I Need Is You,Chris Janson,2354,88,2266,142,0,6442600,508200,5934400,1115551,2023.08.03
25,We Got History,Mitchell Tenpenny,1872,51,1821,139,0,5715800,-8400,5724200,1786430,2023.08.03
26,Save Me The Trouble,Dan + Shay,1726,476,1250,142,0,5409200,1719800,3689400,2880458,2023.08.03
27,Light On In The Kitchen,Ashley McBryde,1944,-15,1959,143,0,5194200,61800,5132400,1391820,2023.08.03
28,Mind On You,George Birge,1738,122,1616,137,0,5114400,655900,4458500,241595,2023.08.03
29,Nobody's Nobody,Brothers Osborne,1657,-10,1667,139,0,4287000,100500,4186500,1914031,2023.08.03
30,Creek Will Rise,Conner Smith,1694,12,1682,141,0,3819300,112400,3706900,1199004,2023.08.03
31,Different 'Round Here,Riley Green,1455,245,1210,132,0,3691400,460800,3230600,2332378,2023.08.03
32,23,Chayce Beckham,1466,6,1460,139,0,3564900,-150500,3715400,2953781,2023.08.03
33,Thinkin' Bout Me,Morgan Wallen,924,254,670,70,0,3557200,962600,2594600,13799877,2023.08.03
34,Fearless,Jackson Dean,1633,107,1526,141,0,3483800,265300,3218500,1086625,2023.08.03
35,White Horse,Chris Stapleton,1079,-1027,2106,107,0,3354500,-6113800,9468300,7016013,2023.08.03
36,See You Next Summer,Brian Kelley,1155,-37,1192,122,0,3140200,93700,3046500,430705,2023.08.03
37,Glory Days,Gabby Barrett,1220,-59,1279,133,0,2816000,-447400,3263400,2196425,2023.08.03
38,Out Of That Truck,Carrie Underwood,863,17,846,90,0,2751100,-26900,2778000,2390900,2023.08.03
39,Pretty Little Poison,Warren Zeiders,814,170,644,64,0,2696400,505100,2191300,5062919,2023.08.03
40,Truck Bed,Hardy,1012,87,925,98,0,2569900,255500,2314400,6269252,2023.08.03
41,World On Fire,Nate Smith,955,73,882,76,0,2550000,321700,2228300,4938600,2023.08.03
42,Fires Don'T Start Themselves,Darius Rucker,922,-24,946,108,0,2514300,-101500,2615800,1182092,2023.08.03
43,We Don'T Fight Anymore,Carly Pearce,896,26,870,107,0,2489400,80900,2408500,2574533,2023.08.03
44,Burn It Down,Parker Mccollum,794,84,710,82,0,2372200,331000,2041200,3392044,2023.08.03
45,On The Boat Again,Jake Owen,679,-15,694,69,0,1869600,-167500,2037100,539309,2023.08.03
46,Giving Up On That,Dalton Dover,777,-12,789,87,0,1587800,-28300,1616100,1778910,2023.08.03
47,Drive You Out Of My Mind,Kassi Ashton,722,-57,779,80,0,1519300,-327900,1847200,916519,2023.08.03
48,Save Me (With Lainey Wilson),Jelly Roll,341,-6,347,27,0,1246100,-41600,1287700,5254079,2023.08.03
49,Somebody Else's Whiskey,Frank Ray,661,14,647,72,0,1221800,38700,1183100,161180,2023.08.03
50,Shoot Tequila,Tigirlily Gold,597,-13,610,68,0,1100200,-96900,1197100,1067221,2023.08.03
51,Bad Day To Be A Cold Beer,Chase Rice,586,34,552,61,0,1061600,51500,1010100,216939,2023.08.03
52,Marry That Girl,Easton Corbin,559,23,536,68,0,1059500,98500,961000,185212,2023.08.03
53,Outskirts,Sam Hunt,422,73,349,57,0,1006500,167000,839500,3815717,2023.08.03
54,Something's Gonna Kill Me,Corey Kent,393,80,313,50,0,869300,234000,635300,3201728,2023.08.03
55,Drinkin' Problems,Dillon Carmichael,488,82,406,73,0,842900,105200,737700,76201,2023.08.03
56,Buy A Bar,Tim Dugger,291,19,272,41,0,833500,45500,788000,35075,2023.08.03
57,Love You Again,Chase Matthew,372,10,362,45,0,739300,71500,667800,2994921,2023.08.03
58,Something Real,Dierks Bentley,359,19,340,52,0,672300,24100,648200,531968,2023.08.03
59,Save The Roses,Lee Brice,254,-9,263,34,0,590100,-58800,648900,663570,2023.08.03
60,Without You,Thompson Square,402,7,395,59,0,589100,13600,575500,29148,2023.08.03
61,I'M Not Pretty,Megan Moroney,126,9,117,20,0,580600,46600,534000,2530459,2023.08.03
62,'98 Braves,Morgan Wallen,90,0,90,3,0,563700,16000,547700,3496526,2023.08.03
63,In Your Love,Tyler Childers,112,,,39,0,521400,,,11520185,2023.08.03
64,Wine Country,Hannah Ellis,287,0,287,45,0,422200,-37600,459800,102803,2023.08.03
65,Jealous Of Myself,Tenille Arts,242,-111,353,46,0,411800,-229200,641000,59771,2023.08.03
66,Trouble,Josh Ross,274,26,248,51,0,371500,59800,311700,2322984,2023.08.03
67,Daylight Savings,Kidd G,170,-18,188,28,0,356000,18500,337500,173304,2023.08.03
68,Dance With You,Brett Young,316,20,296,52,0,333500,1400,332100,2529560,2023.08.03
69,Brokenhearted,Joe Nichols,274,39,235,41,0,332000,12600,319400,35483,2023.08.03
70,How Is She,Cole Swindell,41,14,27,1,0,311000,138000,173000,83608,2023.08.03
71,Sticks And Stones,Lukas Nelson & Promise Of The Real,56,,,55,0,300300,,,45456,2023.08.03
72,I Just Killed A Man,Catie Offerman,216,-3,219,34,0,291500,48800,242700,119725,2023.08.03
73,Make You Mine,Marynn Taylor,288,18,270,49,0,263600,36100,227500,53251,2023.08.03
74,Tucson Too Late,Jordan Davis,26,13,13,2,0,232400,160300,72100,1103359,2023.08.03
75,Oklahoma Smokeshow,Zach Bryan,64,12,52,4,0,215900,16000,199900,5728406,2023.08.03
76,Heart To Break,Ryan Griffin,185,8,177,25,0,186100,16200,169900,174433,2023.08.03
77,Wasting All These Tears,Austin Snell,26,10,16,2,0,166800,74900,91900,845566,2023.08.03
78,Young Love & Saturday Nights,Chris Young,35,-6,41,10,0,154800,-20000,174800,560347,2023.08.03
79,Dial Drunk,Noah Kahan,33,,,33,0,154800,,,10298666,2023.08.03
80,Ain'T Missin' You,Dylan Schneider,136,43,93,19,0,154500,-1400,155900,332069,2023.08.03
81,Thicc As Thieves,Lauren Alaina,45,-3,48,3,0,150900,-9800,160700,1439987,2023.08.03
82,Best Of Me,David Nail,37,1,36,1,0,116200,-4000,120200,19814,2023.08.03
83,ghost in my guitar,Alana Springsteen,48,46,2,48,0,103900,91200,12700,527212,2023.08.03
84,Million Little Bandaids,Caroline Jones,48,,,48,0,103900,,,63429,2023.08.03
84,80's Movie,Morgan Wade,48,,,48,0,103900,,,117808,2023.08.03
86,5 Leaf Clover,Luke Combs,18,2,16,3,0,99800,900,98900,2871005,2023.08.03
87,One Of Us,Matt Stell,25,-3,28,3,0,98200,-24000,122200,958054,2023.08.03
88,Colorado,Florida Georgia Line,14,0,14,2,0,89600,0,89600,66529,2023.08.03
89,Lovin You Gets In The Way,Ben Gallaher,61,-19,80,15,0,79900,-42600,122500,32168,2023.08.03
90,The Star-Spangled Banner,Chris Stapleton,13,-4,17,12,0,64700,3000,61700,429403,2023.08.03
91,Miss Americana & The Heartbreak Prince,Taylor Swift,19,,,1,0,64600,,,2763306,2023.08.03
92,We Are Never Ever Getting Back Together (Taylor's Version),Taylor Swift,19,,,1,0,61700,,,2346751,2023.08.03
92,Blank Space,Taylor Swift,19,,,1,0,61700,,,7829732,2023.08.03
94,Praise The Lord,Breland,9,,,9,0,61200,,,202286,2023.08.03
95,22 (Taylor's Version),Taylor Swift,19,,,1,0,60200,,,1912336,2023.08.03
95,Karma,Taylor Swift,19,,,1,0,60200,,,9064195,2023.08.03
97,Along For The Ride,Jordan Harvey,58,3,55,9,0,59000,5500,53500,38809,2023.08.03
98,Cruel Summer,Taylor Swift,19,,,1,0,57500,,,21588026,2023.08.03
98,...Ready For It?,Taylor Swift,19,,,1,0,57500,,,2975178,2023.08.03
98,Style,Taylor Swift,19,,,1,0,57500,,,6087530,2023.08.03
101,Neon You,Don Louis,5,0,5,2,0,57200,-6000,63200,91388,2023.08.03
102,Anti-Hero,Taylor Swift,18,,,1,0,56300,,,9971019,2023.08.03
103,Enchanted,Taylor Swift,17,16,1,1,0,55300,50400,4900,2007648,2023.08.03
104,You Need To Calm Down,Taylor Swift,18,,,1,0,55000,,,4015732,2023.08.03
105,With You I Am,Cody Johnson,6,-4,10,3,0,54100,-66600,120700,1342432,2023.08.03
106,Sun To Me,Zach Bryan,24,1,23,3,0,53800,2800,51000,4631184,2023.08.03
107,Behind Bars,Jelly Roll,8,5,3,1,0,52200,42900,9300,537458,2023.08.03
108,Holy Water,Michael Ray,10,2,8,1,0,51700,7300,44400,350728,2023.08.03
109,"You're On Your Own, Kid",Taylor Swift,16,,,1,0,51700,,,2573267,2023.08.03
110,You In A Honky Tonk,Randall King,4,1,3,2,0,51400,14600,36800,488918,2023.08.03
111,Question The Universe,Teddy Robb,72,20,52,20,0,51300,19900,31400,4340,2023.08.03
112,Bad Blood,Taylor Swift,17,,,1,0,50100,,,4373619,2023.08.03
113,I Knew You Were Trouble (Taylor's Version),Taylor Swift,17,,,1,0,48700,,,3009889,2023.08.03
114,Tulsa,Elle King,21,-2,23,2,0,47800,800,47000,71745,2023.08.03
115,Lavender Haze,Taylor Swift,16,,,1,0,44200,,,5468437,2023.08.03
116,Heartfirst,Kelsea Ballerini,11,-4,15,1,0,44100,-7300,51400,649618,2023.08.03
117,A Special Place,Danielle Bradbery,27,-8,35,5,0,43600,-52900,96500,238561,2023.08.03
118,Out Of Nowhere,Walker Montgomery,10,-4,14,1,0,43100,-7000,50100,13672,2023.08.03
119,Downtime,Roman Alexander,72,16,56,18,0,42500,10300,32200,33213,2023.08.03
120,I Hope Heaven,Karissa Ella,71,2,69,18,0,41900,3800,38100,0,2023.08.03
121,We Ride,Bryan Martin,13,12,1,3,0,41600,38500,3100,3139806,2023.08.03
122,Tough Crowd,Jason Aldean,17,-4,21,2,0,41300,-12000,53300,1391184,2023.08.03
123,First Rodeo,Daves Highway,70,17,53,18,0,41100,9500,31600,572,2023.08.03
124,Leave You Alone,Kane Brown,10,,,5,0,39500,,,388615,2023.08.03
125,Spirits And Demons,Michael Ray,6,,,3,0,39100,,,0,2023.08.03
126,Mr. Perfectly Fine (From The Vault),Taylor Swift,11,,,1,0,37200,,,1694483,2023.08.03
127,Long Live,Taylor Swift,11,,,1,0,36900,,,278362,2023.08.03
128,I'M Not For Everyone,Brothers Osborne,5,0,5,2,0,35100,14500,20600,507960,2023.08.03
129,Bejeweled,Taylor Swift,10,,,1,0,33800,,,3650647,2023.08.03
130,Silverado For Sale,Morgan Wallen,15,14,1,15,0,33700,25300,8400,1475449,2023.08.03
131,Wild as You,Cody Johnson,3,-1,4,2,0,32500,16800,15700,1124882,2023.08.03
132,Too Soon To Say Goodbye,Wayland,55,1,54,18,0,32000,200,31800,632,2023.08.03
133,"Love, Beer",Andrew Sevener,55,-18,73,18,0,32000,-10600,42600,885,2023.08.03
134,How I Get High,Josh Kaiser,51,-2,53,13,0,31900,-700,32600,0,2023.08.03
135,Honey!,Rayne Johnson,53,-19,72,18,0,31600,-10800,42400,34980,2023.08.03
135,Back At The Bar,Landon Parker,53,-19,72,18,0,31600,-10800,42400,9282,2023.08.03
137,All Too Well,Taylor Swift,8,,,1,0,31600,,,368348,2023.08.03
138,Under A Southern Sky,Ian Flanigan,51,-2,53,18,0,30900,-700,31600,867,2023.08.03
139,Red (Taylor's Version),Taylor Swift,9,,,1,0,30800,,,1297098,2023.08.03
140,Getaway Car,Taylor Swift,8,,,1,0,28900,,,3397287,2023.08.03
141,The Archer,Taylor Swift,7,,,1,0,28400,,,2060064,2023.08.03
142,The Last Great American Dynasty,Taylor Swift,9,,,1,0,27900,,,2002236,2023.08.03
143,Cowgirls,Morgan Wallen,8,-3,11,4,0,27000,-2200,29200,7316822,2023.08.03
144,3 Tequila Floor,Josiah Siska,14,-4,18,4,0,26700,-13600,40300,10317,2023.08.03
145,Stop Coming Over,Chris Lane,12,1,11,6,0,26100,-400,26500,41269,2023.08.03
146,End Game,Taylor Swift Feat. Ed Sheeran & Future,8,,,1,0,25500,,,1541810,2023.08.03
146,Grow Old,Florida Georgia Line,1,,,1,0,25500,,,191586,2023.08.03
148,Vigilante Shit,Taylor Swift,8,,,1,0,25400,,,2457233,2023.08.03
149,Drink One For Me,Hardy,4,0,4,1,0,25200,-100,25300,181677,2023.08.03
150,The Star-Spangled Banner,Carly Pearce,4,1,3,4,0,24700,-14700,39400,0,2023.08.03
151,The Great Divide,Luke Combs & Billy Strings,8,2,6,1,0,24000,7200,16800,237669,2023.08.03
152,My Tears Ricochet,Taylor Swift,8,,,1,0,23700,,,2598727,2023.08.03
153,Death By A Thousand Cuts,Taylor Swift,8,,,1,0,23500,,,1656723,2023.08.03
154,Young Man's Blues,Parker Mccollum,3,0,3,2,0,23300,-7600,30900,481668,2023.08.03
155,Heart Of A Small Town,Tim Dugger,8,5,3,6,0,23200,-1100,24300,17381,2023.08.03
156,The Good I'Ll Do,Zach Bryan,8,-2,10,1,0,23200,500,22700,2708561,2023.08.03
157,Snow On The Beach,Taylor Swift Feat. Lana Del Rey,6,,,1,0,23200,,,2996570,2023.08.03
157,The 1,Taylor Swift,9,,,1,0,23200,,,3211434,2023.08.03
159,August,Taylor Swift,9,,,1,0,22700,,,7370289,2023.08.03
160,Gorgeous,Taylor Swift,7,,,1,0,22500,,,1627044,2023.08.03
161,Look What You Made Me Do,Taylor Swift,7,,,1,0,22300,,,3605353,2023.08.03
162,June In July,Robby Johnson,4,,,4,0,22100,,,1389,2023.08.03
163,Maroon,Taylor Swift,7,,,1,0,22000,,,2286339,2023.08.03
164,Star Spangled Banner,Abby Anderson,5,2,3,5,0,21900,-4600,26500,0,2023.08.03
165,Midnight Rain,Taylor Swift,8,,,1,0,20300,,,2815920,2023.08.03
166,Longneck Way To Go,Midland Feat. Jon Pardi,4,2,2,1,0,19800,8900,10900,189203,2023.08.03
167,Wonderland,Taylor Swift,6,,,1,0,19800,,,925478,2023.08.03
168,Love Is Real,Morgan Evans,7,1,6,2,0,19600,6800,12800,54831,2023.08.03
169,A Life Where We Work Out,Flatland Cavalry,2,,,2,0,19500,,,1015584,2023.08.03
170,Boys 'Round Here (Live 2017),Blake Shelton,1,,,1,0,19200,,,0,2023.08.03
171,Man Made A Bar,Morgan Wallen,6,-2,8,1,0,18500,8800,9700,4109982,2023.08.03
172,You All Over Me (From The Vault),Taylor Swift Feat. Maren Morris,6,,,1,0,18400,,,422149,2023.08.03
173,The Man,Taylor Swift,7,,,1,0,18300,,,3206293,2023.08.03
174,I'm Feelin' Good (Steve Miller Band),King Calaway,20,9,11,7,0,18200,14100,4100,2507,2023.08.03
175,Austin,Koe Wetzel,1,,,1,0,18200,,,415158,2023.08.03
175,Another Town,Jon Stork,1,,,1,0,18200,,,4160,2023.08.03
175,She's Gonna Leave A Mark,Darrin Morris Band,1,,,1,0,18200,,,0,2023.08.03
178,Begin Again (Taylor's Version),Taylor Swift,5,,,1,0,17900,,,507824,2023.08.03
179,"Salt, Lime & Tequila",Ryan Griffin,3,-4,7,1,0,17800,600,17200,109029,2023.08.03
180,tis the damn season,Taylor Swift,7,,,1,0,17600,,,1384574,2023.08.03
180,Lover,Taylor Swift Feat. Shawn Mendes,7,,,1,0,17600,,,5092224,2023.08.03
182,The Story of Us,Taylor Swift,6,,,1,0,17100,,,379141,2023.08.03
183,tolerate it,Taylor Swift,6,,,1,0,16900,,,1548899,2023.08.03
184,"The Father, My Son, And The Holy Ghost",Craig Morgan,2,0,2,1,0,16800,7100,9700,62698,2023.08.03
185,Nothin' On You,Cody Johnson,2,0,2,1,0,16800,-3400,20200,1259573,2023.08.03
186,Ain't That Some,Morgan Wallen,11,-2,13,2,0,16700,-13400,30100,5859768,2023.08.03
187,Afterglow,Taylor Swift,6,,,1,0,16600,,,1460004,2023.08.03
188,Haunted (Taylor's Version),Taylor Swift,5,,,1,0,16400,,,1938144,2023.08.03
188,Call It What You Want,Taylor Swift,5,,,1,0,16400,,,1447393,2023.08.03
190,Welcome To New York,Taylor Swift,5,,,1,0,16100,,,1291208,2023.08.03
191,Dear John,Taylor Swift,5,,,1,0,15700,,,373573,2023.08.03
192,Forever Bound,12/Oc,5,-2,7,1,0,15500,-1100,16600,6429,2023.08.03
193,My Bar,Priscilla Block,3,0,3,2,0,15300,11000,4300,200641,2023.08.03
194,Any Given Friday Night,Luke Combs,2,0,2,1,0,15200,0,15200,335460,2023.08.03
195,champagne problems,Taylor Swift,6,,,1,0,14700,,,2454062,2023.08.03
195,Don't Blame Me,Taylor Swift,6,,,1,0,14700,,,4899725,2023.08.03
197,Dress,Taylor Swift,4,,,1,0,14400,,,1630025,2023.08.03
198,Just Drive,Erin Kinsey,6,-6,12,6,0,14300,-14300,28600,161960,2023.08.03
199,Come Back To Bed,Sean Stemaly,6,,,6,0,14300,,,213031,2023.08.03
199,Bench Seat,Chase Rice,6,,,6,0,14300,,,189403,2023.08.03
199,State You Left Me In,Jake Worthington,6,,,6,0,14300,,,27400,2023.08.03
199,Tumbleweed,Keith Urban,6,,,6,0,14300,,,11028,2023.08.03
1,Need A Favor,Jelly Roll,8287,33,8254,143,0,32804900,-130700,32935600,9479378,2023.08.10
2,Fast Car,Luke Combs,7429,-488,7917,144,0,30798300,-1656400,32454700,20611409,2023.08.10
3,Last Night,Morgan Wallen,6451,-190,6641,144,0,28594100,-138000,28732100,26999603,2023.08.10
4,"You, Me, And Whiskey",Justin Moore & Priscilla Block,6485,-1258,7743,144,0,25989700,-3827600,29817300,5810026,2023.08.10
5,Love You Anyway,Luke Combs,6710,344,6366,144,0,25498100,1651900,23846200,6919749,2023.08.10
6,Bury Me In Georgia,Kane Brown,6081,55,6026,144,0,23172500,108700,23063800,6321784,2023.08.10
7,Dancin' In The Country,Tyler Hubbard,5204,-257,5461,144,0,23046000,-781200,23827200,6490923,2023.08.10
8,Your Heart Or Mine,Jon Pardi,6141,41,6100,144,0,22906500,98800,22807700,3845488,2023.08.10
9,Angels,Thomas Rhett,5199,193,5006,144,0,19341700,858400,18483300,2912179,2023.08.10
10,Religiously,Bailey Zimmerman,4884,361,4523,144,0,17595500,1232600,16362900,13375236,2023.08.10
11,Girl In Mine,Parmalee,4590,221,4369,143,0,16328400,239000,16089400,2313730,2023.08.10
12,Drinkaby,Cole Swindell,3912,58,3854,144,0,13568200,8100,13560100,2373838,2023.08.10
13,Looking For You,Chris Young,3884,44,3840,144,0,13521000,201600,13319400,2245426,2023.08.10
14,But I Got A Beer In My Hand,Luke Bryan,3804,-8,3812,144,0,13343500,-357700,13701200,3172958,2023.08.10
15,Everything I Love,Morgan Wallen,3480,204,3276,144,0,13118500,624100,12494400,4405305,2023.08.10
16,Watermelon Moonshine,Lainey Wilson,3649,144,3505,144,0,12637200,878900,11758300,7583775,2023.08.10
17,God Gave Me A Girl,Russell Dickerson,3449,145,3304,141,0,12410900,627200,11783700,1618581,2023.08.10
18,Standing Room Only,Tim McGraw,3566,32,3534,144,0,12232800,308600,11924200,2564293,2023.08.10
19,Try That In A Small Town,Jason Aldean,3253,261,2992,141,0,12150900,1361100,10789800,14740158,2023.08.10
20,Everything She Ain't,Hailey Whitters,3185,-25,3210,144,0,10112000,166800,9945200,2480148,2023.08.10
21,Can'T Have Mine,Dylan Scott,3008,44,2964,144,0,9782300,457700,9324600,2630219,2023.08.10
22,If You Go Down (I'M Going Down Too),Kelsea Ballerini,3165,129,3036,144,0,9241500,198400,9043100,2084894,2023.08.10
23,Stars Like Confetti,Dustin Lynch,2701,53,2648,142,0,9078700,690800,8387900,1767553,2023.08.10
24,Save Me The Trouble,Dan + Shay,1958,232,1726,141,0,6603300,1194100,5409200,2554740,2023.08.10
25,All I Need Is You,Chris Janson,2310,-44,2354,139,0,6266700,-175900,6442600,1112178,2023.08.10
26,We Got History,Mitchell Tenpenny,1914,42,1872,140,0,5858400,142600,5715800,1887809,2023.08.10
27,Mind On You,George Birge,1934,196,1738,139,0,5760400,646000,5114400,247710,2023.08.10
28,Light On In The Kitchen,Ashley McBryde,1979,35,1944,143,0,5177000,-17200,5194200,1422944,2023.08.10
29,Thinkin' Bout Me,Morgan Wallen,1166,242,924,91,0,4426300,869100,3557200,13694689,2023.08.10
30,Nobody's Nobody,Brothers Osborne,1784,127,1657,141,0,4402100,115100,4287000,1615419,2023.08.10
31,Creek Will Rise,Conner Smith,1907,213,1694,142,0,4400400,581100,3819300,1137662,2023.08.10
32,White Horse,Chris Stapleton,1236,157,1079,113,0,3900200,545700,3354500,7051183,2023.08.10
33,23,Chayce Beckham,1499,33,1466,136,0,3797400,232500,3564900,2890390,2023.08.10
34,Different 'Round Here,Riley Green,1332,-123,1455,132,0,3621000,-70400,3691400,2040200,2023.08.10
35,Fearless,Jackson Dean,1508,-125,1633,141,0,3192400,-291400,3483800,1112703,2023.08.10
36,Glory Days,Gabby Barrett,1268,48,1220,134,0,2991500,175500,2816000,1753333,2023.08.10
37,Pretty Little Poison,Warren Zeiders,910,96,814,69,0,2940000,243600,2696400,4997481,2023.08.10
38,See You Next Summer,Brian Kelley,1186,31,1155,119,0,2913400,-226800,3140200,521872,2023.08.10
39,World On Fire,Nate Smith,1030,75,955,83,0,2859500,309500,2550000,4181211,2023.08.10
40,Out Of That Truck,Carrie Underwood,896,33,863,90,0,2711300,-39800,2751100,2233985,2023.08.10
41,Truck Bed,Hardy,1024,12,1012,101,0,2594800,24900,2569900,7304191,2023.08.10
42,Burn It Down,Parker Mccollum,824,30,794,82,0,2587400,215200,2372200,3787380,2023.08.10
43,We Don'T Fight Anymore,Carly Pearce,919,23,896,112,0,2573100,83700,2489400,2601305,2023.08.10
44,Fires Don'T Start Themselves,Darius Rucker,987,65,922,126,0,2536100,21800,2514300,711636,2023.08.10
45,On The Boat Again,Jake Owen,657,-22,679,72,0,1750700,-118900,1869600,346421,2023.08.10
46,Giving Up On That,Dalton Dover,805,28,777,87,0,1572000,-15800,1587800,1506746,2023.08.10
47,Drive You Out Of My Mind,Kassi Ashton,725,3,722,81,0,1523100,3800,1519300,1360327,2023.08.10
48,Save Me (With Lainey Wilson),Jelly Roll,363,22,341,32,0,1439500,193400,1246100,5893285,2023.08.10
49,Somebody Else's Whiskey,Frank Ray,680,19,661,73,0,1178000,-43800,1221800,157746,2023.08.10
50,Shoot Tequila,Tigirlily Gold,623,26,597,70,0,1075600,-24600,1100200,2006183,2023.08.10
51,Marry That Girl,Easton Corbin,570,11,559,71,0,1055000,-4500,1059500,178746,2023.08.10
52,Outskirts,Sam Hunt,457,35,422,57,0,1041400,34900,1006500,2989259,2023.08.10
53,Drinkin' Problems,Dillon Carmichael,559,71,488,73,0,990900,148000,842900,83512,2023.08.10
54,Bad Day To Be A Cold Beer,Chase Rice,553,-33,586,62,0,975500,-86100,1061600,197779,2023.08.10
55,Love You Again,Chase Matthew,430,58,372,46,0,901100,161800,739300,3122028,2023.08.10
56,Something's Gonna Kill Me,Corey Kent,429,36,393,54,0,893700,24400,869300,2931560,2023.08.10
57,I'M Not Pretty,Megan Moroney,227,101,126,41,0,770000,189400,580600,2278699,2023.08.10
58,Buy A Bar,Tim Dugger,309,18,291,39,0,763600,-69900,833500,31757,2023.08.10
59,Dance With You,Brett Young,395,79,316,81,0,648600,315100,333500,3454141,2023.08.10
60,Something Real,Dierks Bentley,367,8,359,53,0,638400,-33900,672300,453481,2023.08.10
61,Without You,Thompson Square,428,26,402,58,0,624700,35600,589100,27684,2023.08.10
62,Save The Roses,Lee Brice,253,-1,254,35,0,622000,31900,590100,623368,2023.08.10
63,Wine Country,Hannah Ellis,324,37,287,50,0,510900,88700,422200,113784,2023.08.10
64,Brokenhearted,Joe Nichols,301,27,274,42,0,414700,82700,332000,39352,2023.08.10
65,Sad In The Summer,Diplo & Lily Rose,104,,,57,0,402600,,,483314,2023.08.10
66,'98 Braves,Morgan Wallen,62,-28,90,5,0,385600,-178100,563700,3433534,2023.08.10
67,Tucson Too Late,Jordan Davis,46,20,26,8,0,363800,131400,232400,907388,2023.08.10
68,How Is She,Cole Swindell,48,7,41,1,0,335000,24000,311000,80616,2023.08.10
69,Trouble,Josh Ross,280,6,274,48,0,333400,-38100,371500,2054727,2023.08.10
70,Daylight Savings,Kidd G,188,18,170,32,0,292800,-63200,356000,206827,2023.08.10
71,Make You Mine,Marynn Taylor,321,33,288,48,0,291300,27700,263600,47902,2023.08.10
72,Dial Drunk,Noah Kahan,74,41,33,37,0,278000,123200,154800,9834230,2023.08.10
73,Two Flowers,Lily Rose,71,,,37,0,261200,,,0,2023.08.10
74,I Just Killed A Man,Catie Offerman,222,6,216,33,0,249500,-42000,291500,126663,2023.08.10
75,In Your Love,Tyler Childers,59,-53,112,39,0,241100,-280300,521400,8067743,2023.08.10
76,Heart To Break,Ryan Griffin,180,-5,185,36,0,210500,24400,186100,226191,2023.08.10
77,Nothing Compares To You,Mickey Guyton,120,,,23,0,206400,,,0,2023.08.10
78,Wasting All These Tears,Austin Snell,28,2,26,1,0,179400,12600,166800,873887,2023.08.10
79,Ain'T Missin' You,Dylan Schneider,155,19,136,23,0,172200,17700,154500,497319,2023.08.10
80,Oklahoma Smokeshow,Zach Bryan,55,-9,64,3,0,156600,-59300,215900,6110156,2023.08.10
81,Thicc As Thieves,Lauren Alaina,40,-5,45,2,0,143800,-7100,150900,1227646,2023.08.10
82,Best Of Me,David Nail,39,2,37,2,0,137100,20900,116200,13490,2023.08.10
83,Young Love & Saturday Nights,Chris Young,37,2,35,9,0,136300,-18500,154800,551315,2023.08.10
84,"Jesus, My Mama, My Therapist",Tiera Kennedy,48,,,48,0,103900,,,90441,2023.08.10
84,Already Crazy,Carter Faith,48,,,48,0,103900,,,20617,2023.08.10
86,5 Leaf Clover,Luke Combs,18,0,18,1,0,95300,-4500,99800,2582364,2023.08.10
87,One Of Us,Matt Stell,21,-4,25,3,0,94000,-4200,98200,991458,2023.08.10
88,The Star-Spangled Banner,Chris Stapleton,19,6,13,18,0,87400,22700,64700,312621,2023.08.10
89,Someone,Aaron Lewis,16,,,15,0,78600,,,879366,2023.08.10
90,Lovin You Gets In The Way,Ben Gallaher,53,-8,61,10,0,75500,-4400,79900,30476,2023.08.10
91,Colorado,Florida Georgia Line,12,-2,14,2,0,74800,-14800,89600,64234,2023.08.10
92,We Ride,Bryan Martin,26,13,13,11,0,64300,22700,41600,3147997,2023.08.10
93,She's Somebody's Daughter,Drew Baldridge,32,25,7,19,0,63000,53800,9200,119192,2023.08.10
94,Holy Water,Michael Ray,9,-1,10,1,0,57100,5400,51700,294978,2023.08.10
95,With You I Am,Cody Johnson,7,1,6,3,0,54000,-100,54100,1345711,2023.08.10
96,A Special Place,Danielle Bradbery,39,12,27,5,0,53000,9400,43600,231108,2023.08.10
97,Tulsa,Elle King,18,-3,21,2,0,51100,3300,47800,66796,2023.08.10
98,My Baby Does,Drew Parker,4,,,1,0,50700,,,6700,2023.08.10
99,Sun To Me,Zach Bryan,24,0,24,4,0,50000,-3800,53800,4700468,2023.08.10
100,The Star-Spangled Banner,Carly Pearce,5,1,4,5,0,42900,18200,24700,0,2023.08.10
101,Question The Universe,Teddy Robb,71,-1,72,18,0,42400,-8900,51300,3679,2023.08.10
102,Don't Think Jesus,Morgan Wallen,17,14,3,17,0,42100,38300,3800,1537260,2023.08.10
103,Neon You,Don Louis,4,-1,5,1,0,41500,-15700,57200,86714,2023.08.10
104,Too Soon To Say Goodbye,Wayland,66,11,55,18,0,41000,9000,32000,577,2023.08.10
105,Out Of Nowhere,Walker Montgomery,10,0,10,1,0,40600,-2500,43100,12432,2023.08.10
106,Heartfirst,Kelsea Ballerini,9,-2,11,1,0,38400,-5700,44100,632038,2023.08.10
107,Drink One For Me,Hardy,7,3,4,1,0,37700,12500,25200,170390,2023.08.10
108,Ain't That Some,Morgan Wallen,12,1,11,4,0,36500,19800,16700,5388643,2023.08.10
109,Star Spangled Banner,Abby Anderson,7,2,5,6,0,35900,14000,21900,0,2023.08.10
110,Tough Crowd,Jason Aldean,11,-6,17,1,0,35900,-5400,41300,1088504,2023.08.10
111,Tuggin' On My Heartstrings,Randall King,3,0,3,1,0,35400,25800,9600,26662,2023.08.10
112,Jealous Of Myself,Tenille Arts,38,-204,242,11,0,35200,-376600,411800,57576,2023.08.10
113,City Don'T,Billy Currington,14,,,14,0,32500,,,275603,2023.08.10
114,Talk About Georgia,Jason Aldean,4,3,1,2,0,32400,29800,2600,43323,2023.08.10
115,The Good I'Ll Do,Zach Bryan,12,4,8,1,0,31800,8600,23200,2819704,2023.08.10
116,Honey!,Rayne Johnson,54,1,53,18,0,31800,200,31600,33228,2023.08.10
117,Downtime,Roman Alexander,53,-19,72,18,0,31600,-10900,42500,27546,2023.08.10
118,How I Get High,Josh Kaiser,49,-2,51,13,0,31400,-500,31900,0,2023.08.10
119,Under A Southern Sky,Ian Flanigan,51,0,51,18,0,31200,300,30900,762,2023.08.10
120,"Love, Beer",Andrew Sevener,51,-4,55,17,0,31200,-800,32000,828,2023.08.10
121,Hell Yeah,Little Big Town,15,,,15,0,30800,,,296939,2023.08.10
122,First Rodeo,Daves Highway,52,-18,70,18,0,30600,-10500,41100,677,2023.08.10
123,Wild as You,Cody Johnson,6,3,3,4,0,29600,-2900,32500,1046812,2023.08.10
124,My Bar,Priscilla Block,6,3,3,3,0,29500,14200,15300,195205,2023.08.10
125,I Hope Heaven,Karissa Ella,53,-18,71,18,0,29300,-12600,41900,0,2023.08.10
126,When Will I Be Loved,"Ashley McBryde, Caylee Hammack & Pillbox Patti",12,11,1,6,0,28600,26500,2100,37148,2023.08.10
127,Stop Coming Over,Chris Lane,12,0,12,6,0,28600,2500,26100,39921,2023.08.10
128,Along For The Ride,Jordan Harvey,40,-18,58,12,0,27500,-31500,59000,34583,2023.08.10
129,Young Man's Blues,Parker Mccollum,3,0,3,1,0,27200,3900,23300,474696,2023.08.10
130,Strawberry Wine And A Cheap Six Pack,Travis Denning,9,,,2,0,25200,,,144037,2023.08.10
131,Leave You Alone,Kane Brown,5,-5,10,5,0,23600,-15900,39500,371393,2023.08.10
132,Lovin' Where It's Goin',Josh Ward,4,-1,5,1,0,22300,10800,11500,40739,2023.08.10
133,Loser,Mike Ryan,4,1,3,2,0,21400,10400,11000,14668,2023.08.10
134,Back At The Bar,Landon Parker,37,-16,53,18,0,21200,-10400,31600,3465,2023.08.10
135,When My Baby's In Boots,Randall King,2,1,1,2,0,20200,18200,2000,0,2023.08.10
136,Half a Song,Cody Johnson,2,,,2,0,20200,,,340087,2023.08.10
137,Quittin' Time,Morgan Wallen,5,-1,6,1,0,20100,10100,10000,1021390,2023.08.10
138,Must Be The Whiskey,Cody Jinks,2,,,2,0,19500,,,1736664,2023.08.10
139,Forever Bound,12/Oc,8,3,5,1,0,19400,3900,15500,3419,2023.08.10
140,You In A Honky Tonk,Randall King,3,-1,4,2,0,19200,-32200,51400,495042,2023.08.10
141,The Painter,Cody Johnson,4,,,3,0,19200,,,9779,2023.08.10
142,Heartless,Diplo & Julia Michaels Feat. Morgan Wallen,5,3,2,3,0,18700,12200,6500,6379103,2023.08.10
143,Cowboy's Cowgirl,Chad Cooke Band,1,0,1,1,0,18200,16200,2000,10924,2023.08.10
144,Wild Horses,Kin Faux,1,,,1,0,18200,,,4768,2023.08.10
144,Sunrise Tells The Story,Midland,1,,,1,0,18200,,,170349,2023.08.10
144,Stereotype,Cole Swindell,1,,,1,0,18200,,,298433,2023.08.10
144,The Day I Stop Dancin',Jon Pardi,1,,,1,0,18200,,,54666,2023.08.10
144,Gravity And You,Jake Bush,1,,,1,0,18200,,,0,2023.08.10
144,Tequila Sundown,Jon Wolfe,1,,,1,0,18200,,,5365,2023.08.10
144,Wait Outside,Parker Mccollum,1,,,1,0,18200,,,99567,2023.08.10
144,Red Dirt Texas,Hayden Haddock,1,,,1,0,18200,,,7290,2023.08.10
152,3 Tequila Floor,Josiah Siska,23,9,14,4,0,17700,-9000,26700,10000,2023.08.10
153,Longneck Way To Go,Midland Feat. Jon Pardi,4,0,4,1,0,17000,-2800,19800,176947,2023.08.10
154,National Anthem From Battle At Bristol,Jennifer Nettles,4,2,2,4,0,16000,6800,9200,0,2023.08.10
155,Nothin' On You,Cody Johnson,2,0,2,1,0,15900,-900,16800,1189168,2023.08.10
156,Love Is Real,Morgan Evans,5,-2,7,2,0,15800,-3800,19600,52314,2023.08.10
157,Loud and Heavy,Cody Jinks,9,0,9,2,0,15400,3500,11900,1909693,2023.08.10
158,The Great Divide,Luke Combs & Billy Strings,6,-2,8,1,0,15400,-8600,24000,225287,2023.08.10
159,Any Given Friday Night,Luke Combs,2,0,2,1,0,15200,0,15200,306285,2023.08.10
160,Humble And Kind (Nunca Te Olvides De Amar),Tim McGraw,4,3,1,3,0,15100,9100,6000,724,2023.08.10
161,National Anthem,Pryor & Lee,3,1,2,3,0,14700,13600,1100,0,2023.08.10
162,The Star Spangled Banner,Brad Paisley,3,2,1,3,0,14500,13500,1000,0,2023.08.10
163,Your Place,Ashley Cooke,6,5,1,6,0,14300,12900,1400,404069,2023.08.10
164,I Did This To Me,Brett Young,6,,,6,0,14300,,,249801,2023.08.10
164,Us,Hannah Ellis,6,,,6,0,14300,,,37043,2023.08.10
164,wAnt me back,Lindsay Ell,6,,,6,0,14300,,,31743,2023.08.10
164,Classic,Cam,6,,,6,0,14300,,,24533,2023.08.10
164,You Ain't Here To Kiss Me,Brett Young,6,,,6,0,14300,,,303883,2023.08.10
169,Damn Love,Kip Moore,8,-1,9,1,0,14200,4800,9400,135442,2023.08.10
170,That's Why We Fight,Ella Langley & Koe Wetzel,10,0,10,1,0,14100,1900,12200,1011309,2023.08.10
171,Star Spangled Banner,Maren Morris,1,-2,3,1,0,13700,-500,14200,0,2023.08.10
172,Spirits And Demons,Michael Ray,1,-5,6,1,0,13700,-25400,39100,0,2023.08.10
173,When It Comes To Loving You,Jon Langston,3,1,2,2,0,13300,8800,4500,115274,2023.08.10
174,"Houston, We Got A Problem",Luke Combs,3,1,2,2,0,13100,11100,2000,1384617,2023.08.10
175,Man Made A Bar,Morgan Wallen,7,1,6,2,0,13100,-5400,18500,3902946,2023.08.10
176,Codigo,George Strait,1,,,1,0,12900,,,37621,2023.08.10
177,Scars In Heaven,Nelons,2,,,2,0,12800,,,6033,2023.08.10
177,Pray All The Way Home,Austin Snell,2,,,2,0,12800,,,1087863,2023.08.10
177,A Few Hearts Ago,Kylie Morgan,2,,,2,0,12800,,,436233,2023.08.10
180,Playboys,Midland,3,,,2,0,12700,,,80194,2023.08.10
181,The Building,Emily Ann Roberts,2,1,1,2,0,12400,7500,4900,32119,2023.08.10
182,One Name,Jeff & Sheri Easter,2,0,2,2,0,12400,0,12400,16982,2023.08.10
183,The Weight Of The Badge,George Strait,3,2,1,2,0,12300,7700,4600,59090,2023.08.10
184,For What It's Worth,Breland,5,2,3,1,0,12100,-200,12300,1815207,2023.08.10
185,Goin' Crazy,Jameson Rodgers,10,2,8,1,0,12000,2800,9200,16948,2023.08.10
186,Missing One,Jameson Rodgers,12,0,12,2,0,12000,7600,4400,23389,2023.08.10
187,All Trucks Go To Heaven,Boomtown Saints,6,5,1,6,0,11800,11200,600,4396,2023.08.10
188,Psychopath,Morgan Wade,10,2,8,1,0,11800,6600,5200,566233,2023.08.10
189,Just Drive,Erin Kinsey,5,-1,6,5,0,11200,-3100,14300,143315,2023.08.10
190,Cowgirls,Morgan Wallen,6,-2,8,2,0,11200,-15800,27000,6665658,2023.08.10
191,You'Re Gonna Love Me,Tim Dugger,3,1,2,1,0,11000,1300,9700,9840,2023.08.10
192,Summer To Me,Wayland,19,18,1,18,0,10800,9100,1700,19079,2023.08.10
193,Build A Bridge,Ashley Cooke,7,2,5,1,0,10800,4400,6400,23983,2023.08.10
194,Cover Me Up,Morgan Wallen,4,2,2,2,0,10600,3300,7300,4719620,2023.08.10
195,Songs We Used To Sing,Ernest,4,2,2,1,0,10600,4600,6000,77271,2023.08.10
196,I'M Not For Everyone,Brothers Osborne,1,-4,5,1,0,10100,-25000,35100,481828,2023.08.10
197,Better Off,Trace Adkins,2,-2,4,2,0,9700,-2600,12300,16305,2023.08.10
198,Now You Know,Jon Langston,1,,,1,0,9700,,,42290,2023.08.10
199,If It Wasn't For Trucks,Riley Green,2,1,1,2,0,9600,5900,3700,594570,2023.08.10
200,Joe,Luke Combs,1,,,1,0,9500,,,756602,2023.08.10
200,Growin' Up And Gettin' Old,Luke Combs,1,,,1,0,9500,,,2262035,2023.08.10
1,Need A Favor,Jelly Roll,8427,140,8287,143,0,33538200,733300,32804900,8951259,2023.08.17
2,Love You Anyway,Luke Combs,7272,562,6710,144,0,28150000,2651900,25498100,6977176,2023.08.17
3,Last Night,Morgan Wallen,6051,-400,6451,144,0,27164700,-1429400,28594100,26502165,2023.08.17
4,Bury Me In Georgia,Kane Brown,6548,467,6081,144,0,24969300,1796800,23172500,6219231,2023.08.17
5,Your Heart Or Mine,Jon Pardi,6416,275,6141,144,0,23571900,665400,22906500,3654219,2023.08.17
6,Angels,Thomas Rhett,5565,366,5199,144,0,20359300,1017600,19341700,2663989,2023.08.17
7,Religiously,Bailey Zimmerman,5296,412,4884,144,0,19085500,1490000,17595500,13376452,2023.08.17
8,Girl In Mine,Parmalee,5005,415,4590,143,0,17856700,1528300,16328400,2158942,2023.08.17
9,Watermelon Moonshine,Lainey Wilson,4028,379,3649,144,0,14344300,1707100,12637200,7591645,2023.08.17
10,Everything I Love,Morgan Wallen,3825,345,3480,144,0,14223000,1104500,13118500,4535722,2023.08.17
11,Drinkaby,Cole Swindell,4070,158,3912,144,0,13880400,312200,13568200,2406736,2023.08.17
12,Try That In A Small Town,Jason Aldean,3709,456,3253,142,0,13759400,1608500,12150900,13863668,2023.08.17
13,But I Got A Beer In My Hand,Luke Bryan,3842,38,3804,144,0,13624700,281200,13343500,3130760,2023.08.17
14,Looking For You,Chris Young,3873,-11,3884,144,0,13382100,-138900,13521000,2260817,2023.08.17
15,God Gave Me A Girl,Russell Dickerson,3654,205,3449,142,0,13259200,848300,12410900,1201729,2023.08.17
16,Standing Room Only,Tim McGraw,3713,147,3566,144,0,12671800,439000,12232800,2726486,2023.08.17
17,Everything She Ain't,Hailey Whitters,3328,143,3185,144,0,10462300,350300,10112000,2424722,2023.08.17
18,Stars Like Confetti,Dustin Lynch,3006,305,2701,142,0,10236100,1157400,9078700,1593289,2023.08.17
19,Can'T Have Mine,Dylan Scott,3117,109,3008,144,0,10111100,328800,9782300,2546381,2023.08.17
20,If You Go Down (I'M Going Down Too),Kelsea Ballerini,3176,11,3165,144,0,9205000,-36500,9241500,2259063,2023.08.17
21,Save Me The Trouble,Dan + Shay,2224,266,1958,142,0,7234700,631400,6603300,2165973,2023.08.17
22,All I Need Is You,Chris Janson,2479,169,2310,139,0,6605300,338600,6266700,1035767,2023.08.17
23,Mind On You,George Birge,1989,55,1934,140,0,6160400,400000,5760400,248813,2023.08.17
24,We Got History,Mitchell Tenpenny,2031,117,1914,141,0,6110400,252000,5858400,1877938,2023.08.17
25,Light On In The Kitchen,Ashley McBryde,1918,-61,1979,143,0,5107200,-69800,5177000,2048462,2023.08.17
26,Thinkin' Bout Me,Morgan Wallen,1365,199,1166,93,0,5102300,676000,4426300,13975928,2023.08.17
27,Nobody's Nobody,Brothers Osborne,1883,99,1784,141,0,4571700,169600,4402100,1142399,2023.08.17
28,Creek Will Rise,Conner Smith,1917,10,1907,142,0,4523900,123500,4400400,1163837,2023.08.17
29,23,Chayce Beckham,1692,193,1499,137,0,4287900,490500,3797400,2930688,2023.08.17
30,Different 'Round Here,Riley Green,1475,143,1332,134,0,4104000,483000,3621000,2058973,2023.08.17
31,The Painter,Cody Johnson,802,798,4,96,0,3941100,3921900,19200,6883292,2023.08.17
32,White Horse,Chris Stapleton,1322,86,1236,129,0,3892200,-8000,3900200,7664674,2023.08.17
33,Fearless,Jackson Dean,1636,128,1508,142,0,3538700,346300,3192400,1122796,2023.08.17
34,See You Next Summer,Brian Kelley,1276,90,1186,136,0,3228000,314600,2913400,490397,2023.08.17
35,Pretty Little Poison,Warren Zeiders,968,58,910,73,0,3207400,267400,2940000,5849257,2023.08.17
36,World On Fire,Nate Smith,1193,163,1030,96,0,3176200,316700,2859500,4502091,2023.08.17
37,We Don'T Fight Anymore,Carly Pearce,1004,85,919,115,0,2916100,343000,2573100,3155181,2023.08.17
38,Glory Days,Gabby Barrett,1251,-17,1268,133,0,2801200,-190300,2991500,1877949,2023.08.17
39,Out Of That Truck,Carrie Underwood,873,-23,896,86,0,2700900,-10400,2711300,2059748,2023.08.17
40,Truck Bed,Hardy,1028,4,1024,99,0,2650000,55200,2594800,7304559,2023.08.17
41,Burn It Down,Parker Mccollum,810,-14,824,83,0,2531800,-55600,2587400,4387465,2023.08.17
42,Fires Don'T Start Themselves,Darius Rucker,1004,17,987,126,0,2529900,-6200,2536100,1280210,2023.08.17
43,On The Boat Again,Jake Owen,652,-5,657,73,0,1777500,26800,1750700,305730,2023.08.17
44,Save Me,Jelly Roll & Lainey Wilson,436,73,363,39,0,1767600,328100,1439500,6799686,2023.08.17
45,Giving Up On That,Dalton Dover,812,7,805,86,0,1572700,700,1572000,1615862,2023.08.17
46,Drive You Out Of My Mind,Kassi Ashton,722,-3,725,80,0,1464100,-59000,1523100,939902,2023.08.17
47,I'M Not Pretty,Megan Moroney,424,197,227,50,0,1267500,497500,770000,2558959,2023.08.17
48,Shoot Tequila,Tigirlily Gold,673,50,623,70,0,1160000,84400,1075600,1448959,2023.08.17
49,Outskirts,Sam Hunt,473,16,457,62,0,1114500,73100,1041400,2977597,2023.08.17
50,Somebody Else's Whiskey,Frank Ray,626,-54,680,72,0,1069200,-108800,1178000,150106,2023.08.17
51,Something's Gonna Kill Me,Corey Kent,450,21,429,56,0,999300,105600,893700,2965360,2023.08.17
52,Bad Day To Be A Cold Beer,Chase Rice,569,16,553,61,0,993000,17500,975500,209306,2023.08.17
53,Love You Again,Chase Matthew,462,32,430,49,0,942300,41200,901100,2925969,2023.08.17
54,Drinkin' Problems,Dillon Carmichael,539,-20,559,78,0,942300,-48600,990900,86111,2023.08.17
55,Marry That Girl,Easton Corbin,524,-46,570,70,0,938400,-116600,1055000,161888,2023.08.17
56,Buy A Bar,Tim Dugger,303,-6,309,40,0,763600,0,763600,29974,2023.08.17
57,Something Real,Dierks Bentley,355,-12,367,55,0,710800,72400,638400,464108,2023.08.17
58,Dance With You,Brett Young,416,21,395,73,0,669800,21200,648600,2447713,2023.08.17
59,Save The Roses,Lee Brice,263,10,253,36,0,623300,1300,622000,615120,2023.08.17
60,Without You,Thompson Square,428,0,428,58,0,593000,-31700,624700,24970,2023.08.17
61,Wine Country,Hannah Ellis,336,12,324,52,0,554000,43100,510900,118392,2023.08.17
62,Rich Men North Of Richmond,Oliver Anthony Music,127,,,31,0,516300,,,17487459,2023.08.17
63,Tucson Too Late,Jordan Davis,117,71,46,28,0,501900,138100,363800,877091,2023.08.17
64,'98 Braves,Morgan Wallen,79,17,62,6,0,440600,55000,385600,3663612,2023.08.17
65,Brokenhearted,Joe Nichols,294,-7,301,43,0,393700,-21000,414700,39487,2023.08.17
66,Trouble,Josh Ross,283,3,280,48,0,370900,37500,333400,1872137,2023.08.17
67,Best Damn Days,Eric Paslay,57,,,56,0,305200,,,63018,2023.08.17
68,Young Love & Saturday Nights,Chris Young,58,21,37,9,0,277400,141100,136300,855932,2023.08.17
69,In Your Love,Tyler Childers,102,43,59,12,0,277300,36200,241100,7195989,2023.08.17
70,Make You Mine,Marynn Taylor,311,-10,321,48,0,267900,-23400,291300,58483,2023.08.17
71,How Is She,Cole Swindell,37,-11,48,1,0,267600,-67400,335000,76193,2023.08.17
72,Daylight Savings,Kidd G,189,1,188,31,0,239100,-53700,292800,226708,2023.08.17
73,Flowers,Miley Cyrus,40,,,20,0,208600,,,11940458,2023.08.17
74,Ain'T Missin' You,Dylan Schneider,152,-3,155,23,0,177300,5100,172200,361747,2023.08.17
75,Mean Old Sun,Turnpike Troubadours,37,,,37,0,175200,,,478039,2023.08.17
76,Nothing Compares To You,Mickey Guyton,76,-44,120,19,0,152500,-53900,206400,0,2023.08.17
77,Heart To Break,Ryan Griffin,153,-27,180,23,0,150700,-59800,210500,223904,2023.08.17
78,One Of Us,Matt Stell,29,8,21,3,0,142600,48600,94000,756200,2023.08.17
79,Thicc As Thieves,Lauren Alaina,36,-4,40,3,0,138900,-4900,143800,1293048,2023.08.17
80,Wasting All These Tears,Austin Snell,19,-9,28,1,0,127000,-52400,179400,810551,2023.08.17
81,I Just Killed A Man,Catie Offerman,106,-116,222,25,0,126200,-123300,249500,132664,2023.08.17
82,Oklahoma Smokeshow,Zach Bryan,42,-13,55,2,0,124800,-31800,156600,5822423,2023.08.17
83,Best Of Me,David Nail,34,-5,39,1,0,115300,-21800,137100,12206,2023.08.17
84,Colorado,Florida Georgia Line,17,5,12,2,0,107200,32400,74800,64900,2023.08.17
85,1988,Lori McKenna,48,,,48,0,103900,,,4729,2023.08.17
85,Cowboy Forever,Carter Faith,48,,,48,0,103900,,,92349,2023.08.17
87,Highway Cry,Abby Anderson,43,,,43,0,87500,,,9500,2023.08.17
88,Blacktop Don'T,Boomtown Saints,16,,,15,0,78600,,,3316,2023.08.17
89,How You Make A Man,Craig Morgan,16,,,15,0,74000,,,64215,2023.08.17
90,Lovin You Gets In The Way,Ben Gallaher,43,-10,53,9,0,70200,-5300,75500,25899,2023.08.17
91,With You I Am,Cody Johnson,6,-1,7,3,0,63700,9700,54000,1317165,2023.08.17
92,Wild as You,Cody Johnson,6,0,6,3,0,62500,32900,29600,1033748,2023.08.17
93,Tulsa,Elle King,26,8,18,2,0,62300,11200,51100,66916,2023.08.17
94,Cab In A Solo,Scotty McCreery,8,,,2,0,60100,,,95,2023.08.17
95,When My Baby's In Boots,Randall King,5,3,2,2,0,59500,39300,20200,0,2023.08.17
96,Cowgirls,Morgan Wallen,17,11,6,4,0,57300,46100,11200,6951128,2023.08.17
97,Sun To Me,Zach Bryan,23,-1,24,3,0,52900,2900,50000,4808725,2023.08.17
98,Along For The Ride,Jordan Harvey,30,-10,40,8,0,50600,23100,27500,31058,2023.08.17
99,A Special Place,Danielle Bradbery,19,-20,39,4,0,48800,-4200,53000,224561,2023.08.17
100,My Baby Does,Drew Parker,6,2,4,1,0,45000,-5700,50700,6394,2023.08.17
101,Out Of Nowhere,Walker Montgomery,11,1,10,1,0,44600,4000,40600,12347,2023.08.17
102,We Ride,Bryan Martin,27,1,26,3,0,43300,-21000,64300,3317156,2023.08.17
103,Question The Universe,Teddy Robb,71,0,71,19,0,43000,600,42400,3844,2023.08.17
104,First Rodeo,Daves Highway,71,19,52,18,0,42200,11600,30600,662,2023.08.17
105,You In A Honky Tonk,Randall King,4,1,3,1,0,41500,22300,19200,484352,2023.08.17
106,My Bar,Priscilla Block,9,3,6,4,0,41300,11800,29500,186240,2023.08.17
107,The Star-Spangled Banner,Chris Stapleton,9,-10,19,8,0,41200,-46200,87400,334601,2023.08.17
108,Back At The Bar,Landon Parker,68,31,37,18,0,40900,19700,21200,6792,2023.08.17
109,5 Leaf Clover,Luke Combs,6,-12,18,1,0,39800,-55500,95300,2621200,2023.08.17
110,The Good I'Ll Do,Zach Bryan,12,0,12,1,0,39500,7700,31800,2804064,2023.08.17
111,We Ain't The Only Ones,Randy Rogers & Wade Bowen,3,2,1,2,0,38400,36400,2000,0,2023.08.17
112,She's Somebody's Daughter,Drew Baldridge,30,-2,32,6,0,37400,-25600,63000,121499,2023.08.17
113,Strawberry Wine And A Cheap Six Pack,Travis Denning,16,7,9,1,0,37200,12000,25200,123583,2023.08.17
114,Man Made A Bar,Morgan Wallen,9,2,7,3,0,36500,23400,13100,3904734,2023.08.17
115,Lovin' Where It's Goin',Josh Ward,3,-1,4,1,0,35400,13100,22300,38055,2023.08.17
116,That's Why We Fight,Ella Langley & Koe Wetzel,16,6,10,1,0,32200,18100,14100,996467,2023.08.17
117,Under A Southern Sky,Ian Flanigan,55,4,51,18,0,32000,800,31200,902,2023.08.17
118,Tough Crowd,Jason Aldean,12,1,11,2,0,32000,-3900,35900,1024550,2023.08.17
119,I Hope Heaven,Karissa Ella,53,0,53,18,0,31700,2400,29300,0,2023.08.17
120,"Love, Beer",Andrew Sevener,53,2,51,18,0,31600,400,31200,694,2023.08.17
121,Downtime,Roman Alexander,52,-1,53,18,0,31400,-200,31600,25226,2023.08.17
122,Tennessee Fan,Morgan Wallen,13,12,1,13,0,29900,21500,8400,2298143,2023.08.17
123,Holy Water,Michael Ray,6,-3,9,2,0,29200,-27900,57100,296932,2023.08.17
124,red,HARDY Feat. Morgan Wallen,4,,,1,0,28400,,,0,2023.08.17
125,Star Spangled Banner,Mickey Guyton,5,3,2,5,0,28300,25400,2900,0,2023.08.17
126,Drink One For Me,Hardy,4,-3,7,1,0,27500,-10200,37700,180415,2023.08.17
127,The Great Divide,Luke Combs & Billy Strings,8,2,6,1,0,25400,10000,15400,242296,2023.08.17
128,How I Get High,Josh Kaiser,41,-8,49,13,0,24700,-6700,31400,0,2023.08.17
129,Quittin' Time,Morgan Wallen,8,3,5,1,0,24400,4300,20100,1113176,2023.08.17
130,You'Re Gonna Love Me,Tim Dugger,3,0,3,1,0,24300,13300,11000,9924,2023.08.17
131,Ain't That Some,Morgan Wallen,12,0,12,1,0,24200,-12300,36500,5658036,2023.08.17
132,Heartless,Diplo & Julia Michaels Feat. Morgan Wallen,4,-1,5,2,0,23500,4800,18700,6458371,2023.08.17
133,Young Man's Blues,Parker Mccollum,3,0,3,1,0,23300,-3900,27200,485969,2023.08.17
134,Star Spangled Banner,Abby Anderson,3,-4,7,3,0,22600,-13300,35900,0,2023.08.17
135,Two Flowers,Lily Rose,10,-61,71,9,0,21600,-239600,261200,0,2023.08.17
136,Loser,Mike Ryan,4,0,4,2,0,21400,0,21400,15207,2023.08.17
137,Too Soon To Say Goodbye,Wayland,36,-30,66,18,0,21100,-19900,41000,445,2023.08.17
138,Summer To Me,Wayland,35,16,19,18,0,21000,10200,10800,13519,2023.08.17
139,Honey!,Rayne Johnson,35,-19,54,18,0,20700,-11100,31800,32237,2023.08.17
140,Loud and Heavy,Cody Jinks,10,1,9,3,0,19500,4100,15400,1927710,2023.08.17
141,Goodbye Looks Good On You,Alana Springsteen Feat. Mitchell Tenpenny,7,6,1,7,0,19200,14300,4900,1647139,2023.08.17
142,Heartfirst,Kelsea Ballerini,4,-5,9,2,0,19000,-19400,38400,647985,2023.08.17
143,Country Music Made Me Do It,Carly Pearce,4,,,4,0,18900,,,1106128,2023.08.17
144,One I Want,Flatland Cavalry,1,,,1,0,18200,,,206939,2023.08.17
144,Drinkin',Parker Mccollum,1,,,1,0,18200,,,214210,2023.08.17
144,Bad Medicine,Whiskey Myers,1,,,1,0,18200,,,21657,2023.08.17
144,Four Minutes,Chad Cooke Band,1,,,1,0,18200,,,2806,2023.08.17
144,Ragweed,Koe Wetzel,1,,,1,0,18200,,,441066,2023.08.17
149,He Went To Jared,HARDY Feat. Morgan Wallen,3,1,2,2,0,18000,11000,7000,1183933,2023.08.17
150,Stop Coming Over,Chris Lane,7,-5,12,6,0,17400,-11200,28600,43230,2023.08.17
151,Neon You,Don Louis,2,-2,4,1,0,17200,-24300,41500,84432,2023.08.17
152,Star Spangled Banner,Maren Morris,2,1,1,2,0,15900,2200,13700,0,2023.08.17
153,3 Tequila Floor,Josiah Siska,10,-13,23,3,0,15600,-2100,17700,9778,2023.08.17
154,Any Given Friday Night,Luke Combs,2,0,2,1,0,15200,0,15200,316455,2023.08.17
155,Trains I Missed,Balsam Range,2,1,1,1,0,15000,9700,5300,4675,2023.08.17
156,Other Side Of The Radio,Mike Ryan,3,,,1,0,14900,,,97185,2023.08.17
157,Southern And Slow,Luke Bryan,3,,,3,0,14800,,,1342484,2023.08.17
158,"Jesus, My Mama, My Therapist",Tiera Kennedy,3,-45,48,3,0,14700,-89200,103900,91841,2023.08.17
159,When Will I Be Loved,"Ashley McBryde, Caylee Hammack & Pillbox Patti",6,-6,12,6,0,14300,-14300,28600,36966,2023.08.17
160,Don'T Take The Girl,Brett Young,6,,,6,0,14300,,,586804,2023.08.17
160,Down On The Beach,Russell Dickerson,6,,,6,0,14300,,,131873,2023.08.17
160,Ride The Wave,Russell Dickerson,6,,,6,0,14300,,,507137,2023.08.17
163,Jealous Of Myself,Tenille Arts,18,-20,38,4,0,14200,-21000,35200,53201,2023.08.17
164,Outlaw,Morgan Wallen Feat. Ben Burgess,9,4,5,1,0,14100,5400,8700,527106,2023.08.17
165,The Star Spangled Banner,Locash,1,,,1,0,13700,,,0,2023.08.17
166,Cover Me Up,Morgan Wallen,4,0,4,3,0,13600,3000,10600,4999960,2023.08.17
167,Still,Luke Combs,5,4,1,1,0,13300,12000,1300,427757,2023.08.17
168,Songs We Used To Sing,Ernest,5,1,4,1,0,13300,2700,10600,76666,2023.08.17
169,White House Road,Tyler Childers & The Highwall,6,3,3,2,0,13100,10700,2400,3116940,2023.08.17
170,"1, 2 Many",Luke Combs & Brooks & Dunn,7,4,3,7,0,12800,8600,4200,1425872,2023.08.17
171,Halfway Up The Mountain,Tribute Quartet,2,1,1,2,0,12800,7500,5300,14714,2023.08.17
172,Sometimes She Stays,Kip Moore,11,2,9,1,0,12500,3600,8900,138630,2023.08.17
173,Queen For A Night,Casey Donahew,2,1,1,1,0,12200,6100,6100,24278,2023.08.17
174,I Wrote The Book,Morgan Wallen,2,1,1,2,0,12100,4800,7300,5071546,2023.08.17
175,Every Single Summer,Marynn Taylor,6,,,6,0,11800,,,8212,2023.08.17
176,The Star-Spangled Banner,Carly Pearce,3,-2,5,3,0,11600,-31300,42900,0,2023.08.17
177,I Know A Guy,Alex Hall,1,,,1,0,11300,,,107103,2023.08.17
178,Decoration,Jillian Riscoe,6,1,5,1,0,11000,3600,7400,4,2023.08.17
179,Still Telling My Story,Erwins,2,1,1,1,0,10600,3100,7500,0,2023.08.17
180,I'M Not For Everyone,Brothers Osborne,2,1,1,2,0,10400,300,10100,482529,2023.08.17
181,All Things,Sound,2,1,1,2,0,10200,5300,4900,5487,2023.08.17
182,The Keepers,Karen Peck & New River,2,1,1,2,0,10200,4900,5300,6120,2023.08.17
183,Think About There,Greater Vision,2,1,1,2,0,10200,2700,7500,11190,2023.08.17
184,Broadway Girls,Lil Durk Feat. Morgan Wallen,2,1,1,1,0,10000,1600,8400,5492407,2023.08.17
185,Build A Bridge,Ashley Cooke,5,-2,7,1,0,10000,-800,10800,22304,2023.08.17
186,Better Off,Trace Adkins,2,0,2,1,0,9700,0,9700,15686,2023.08.17
187,Star Spangled Banner,Demi Lovato,1,0,1,1,0,9400,7900,1500,69,2023.08.17
188,90s Country,Holdaways,7,0,7,1,0,9400,4400,5000,114,2023.08.17
189,Love Is Real,Morgan Evans,5,0,5,2,0,9300,-6500,15800,50043,2023.08.17
190,Give Her That,Carrie Underwood,2,,,2,0,9300,,,1213847,2023.08.17
190,Give Her That,Carrie Underwood,2,,,2,0,9300,,,0,2023.08.17
192,National Anthem From Battle At Bristol,Jennifer Nettles,1,-3,4,1,0,9000,-7000,16000,0,2023.08.17
193,I Can'T Breathe,Parker Mccollum,2,,,1,0,9000,,,1177157,2023.08.17
194,Soundtrack To A Small Town Sundown,Tyler Farr,2,1,1,1,0,8800,7500,1300,10923,2023.08.17
195,National Anthem,Pryor & Lee,2,-1,3,2,0,8500,-6200,14700,0,2023.08.17
196,Have You Forgotten?,Darryl Worley,1,0,1,1,0,8400,8200,200,84850,2023.08.17
197,When It Comes To Loving You,Jon Langston,1,-2,3,1,0,8400,-4900,13300,114070,2023.08.17
198,Children Sing,Nelons,1,,,1,0,8400,,,291,2023.08.17
198,Stones,Crabb Family,1,,,1,0,8400,,,4977,2023.08.17
198,A Song To Remember,A Thousand Horses,1,,,1,0,8400,,,9765,2023.08.17
198,The God I Know,Erwins,1,,,1,0,8400,,,9222,2023.08.17
198,There Was Jesus,Zach Williams & Dolly Parton,1,,,1,0,8400,,,1097598,2023.08.17
1,Need A Favor,Jelly Roll,7474,-1020,8494,144,0,29515000,-4112800,33627800,9413490,2023.08.24
2,Love You Anyway,Luke Combs,7542,222,7320,145,0,29295700,1088900,28206800,7083620,2023.08.24
3,Fast Car,Luke Combs,6856,-90,6946,144,0,28973000,-606100,29579100,20202874,2023.08.24
4,Your Heart Or Mine,Jon Pardi,7359,904,6455,145,0,27368000,3745600,23622400,3776780,2023.08.24
5,Last Night,Morgan Wallen,6047,-70,6117,144,0,27125000,-125600,27250600,26060510,2023.08.24
6,Bury Me In Georgia,Kane Brown,6727,139,6588,145,0,25954600,933100,25021500,5901378,2023.08.24
7,Angels,Thomas Rhett,5669,70,5599,145,0,20921400,515900,20405500,2605514,2023.08.24
8,Next Thing You Know,Jordan Davis,4532,-546,5078,143,0,20500500,-1833500,22334000,7615442,2023.08.24
9,Religiously,Bailey Zimmerman,5466,139,5327,145,0,19572100,448900,19123200,14280721,2023.08.24
10,Girl In Mine,Parmalee,5350,308,5042,144,0,18883800,976700,17907100,1910701,2023.08.24
11,Watermelon Moonshine,Lainey Wilson,4380,330,4050,145,0,15760000,1389800,14370200,7644259,2023.08.24
12,Try That In A Small Town,Jason Aldean,4225,478,3747,142,0,15597000,1788400,13808600,12640792,2023.08.24
13,God Gave Me A Girl,Russell Dickerson,3923,252,3671,144,0,14765500,1480600,13284900,1198912,2023.08.24
14,Everything I Love,Morgan Wallen,3855,18,3837,144,0,14644100,407300,14236800,4158957,2023.08.24
15,But I Got A Beer In My Hand,Luke Bryan,3871,-10,3881,145,0,13968000,288700,13679300,3010991,2023.08.24
16,Drinkaby,Cole Swindell,3960,-127,4087,145,0,13644100,-258000,13902100,2078802,2023.08.24
17,Looking For You,Chris Young,3814,-77,3891,144,0,13360500,-48200,13408700,2177547,2023.08.24
18,Standing Room Only,Tim McGraw,3944,224,3720,145,0,13353900,678200,12675700,4757826,2023.08.24
19,Stars Like Confetti,Dustin Lynch,3200,182,3018,143,0,11349300,1108000,10241300,1549657,2023.08.24
20,Can'T Have Mine,Dylan Scott,3230,96,3134,145,0,10388200,255600,10132600,2594626,2023.08.24
21,Everything She Ain't,Hailey Whitters,3222,-126,3348,145,0,10049100,-437600,10486700,2313776,2023.08.24
22,If You Go Down (I'M Going Down Too),Kelsea Ballerini,3152,-36,3188,144,0,9220300,10100,9210200,2244395,2023.08.24
23,Save Me The Trouble,Dan + Shay,2501,261,2240,144,0,8328800,1076400,7252400,2157755,2023.08.24
24,All I Need Is You,Chris Janson,2600,108,2492,140,0,7091400,480800,6610600,976811,2023.08.24
25,Thinkin' Bout Me,Morgan Wallen,1747,358,1389,129,0,6842200,1706400,5135800,13819055,2023.08.24
26,Mind On You,George Birge,2174,178,1996,141,0,6447600,284500,6163100,254054,2023.08.24
27,We Got History,Mitchell Tenpenny,2039,7,2032,142,0,5982900,-129600,6112500,1865765,2023.08.24
28,Light On In The Kitchen,Ashley McBryde,2035,116,1919,144,0,5231400,122100,5109300,1601589,2023.08.24
29,Nobody's Nobody,Brothers Osborne,1892,8,1884,142,0,4562800,-11000,4573800,1085310,2023.08.24
30,Different 'Round Here,Riley Green,1574,95,1479,137,0,4549000,444600,4104400,2285066,2023.08.24
31,23,Chayce Beckham,1631,-62,1693,138,0,4440700,150700,4290000,3101606,2023.08.24
32,Creek Will Rise,Conner Smith,1883,-35,1918,143,0,4418200,-107800,4526000,1116982,2023.08.24
33,Cab In A Solo,Scotty McCreery,998,990,8,130,0,4236700,4176600,60100,1126556,2023.08.24
34,White Horse,Chris Stapleton,1439,116,1323,132,0,4076000,183300,3892700,7045091,2023.08.24
35,World On Fire,Nate Smith,1396,203,1193,128,0,3718700,542500,3176200,4314060,2023.08.24
36,Pretty Little Poison,Warren Zeiders,1075,107,968,107,0,3631900,424500,3207400,6942984,2023.08.24
37,Fearless,Jackson Dean,1615,-22,1637,142,0,3608700,67900,3540800,1218142,2023.08.24
38,See You Next Summer,Brian Kelley,1336,51,1285,137,0,3235600,5500,3230100,1096933,2023.08.24
39,We Don'T Fight Anymore,Carly Pearce,990,-23,1013,119,0,2803100,-114700,2917800,2936480,2023.08.24
40,Out Of That Truck,Carrie Underwood,960,87,873,93,0,2773300,72400,2700900,1904830,2023.08.24
41,Truck Bed,Hardy,1058,29,1029,99,0,2756500,106000,2650500,7335919,2023.08.24
42,Burn It Down,Parker Mccollum,840,30,810,88,0,2540400,8600,2531800,4010160,2023.08.24
43,Glory Days,Gabby Barrett,1175,-85,1260,135,0,2394000,-408900,2802900,1727257,2023.08.24
44,Fires Don'T Start Themselves,Darius Rucker,980,-24,1004,126,0,2353800,-176100,2529900,1100293,2023.08.24
45,Rich Men North Of Richmond,Oliver Anthony Music,524,396,128,73,0,2043600,1525200,518400,22933251,2023.08.24
46,The Painter,Cody Johnson,647,-156,803,81,0,1982300,-1961300,3943600,5242540,2023.08.24
47,Save Me,Jelly Roll & Lainey Wilson,469,33,436,33,0,1812900,45300,1767600,7021328,2023.08.24
48,On The Boat Again,Jake Owen,637,-15,652,71,0,1657600,-119900,1777500,309114,2023.08.24
49,Drive You Out Of My Mind,Kassi Ashton,739,17,722,80,0,1520600,56500,1464100,863525,2023.08.24
50,Giving Up On That,Dalton Dover,803,-9,812,89,0,1502400,-70300,1572700,1511957,2023.08.24
51,I'M Not Pretty,Megan Moroney,474,50,424,51,0,1499100,231600,1267500,2522780,2023.08.24
52,Outskirts,Sam Hunt,543,70,473,75,0,1270700,156200,1114500,3306277,2023.08.24
53,Shoot Tequila,Tigirlily Gold,644,-29,673,75,0,1132200,-27800,1160000,1311859,2023.08.24
54,Somebody Else's Whiskey,Frank Ray,661,35,626,72,0,1064700,-4500,1069200,145977,2023.08.24
55,Love You Again,Chase Matthew,484,22,462,52,0,1049400,107100,942300,2862422,2023.08.24
56,Drinkin' Problems,Dillon Carmichael,574,35,539,77,0,1040400,98100,942300,73459,2023.08.24
57,Tucson Too Late,Jordan Davis,379,262,117,55,0,1034600,532700,501900,950233,2023.08.24
58,Something's Gonna Kill Me,Corey Kent,440,-10,450,56,0,966400,-32900,999300,2427196,2023.08.24
59,Marry That Girl,Easton Corbin,531,7,524,71,0,960400,22000,938400,136496,2023.08.24
60,Bad Day To Be A Cold Beer,Chase Rice,554,-15,569,63,0,923000,-70000,993000,208962,2023.08.24
61,Buy A Bar,Tim Dugger,314,11,303,41,0,661900,-101700,763600,29582,2023.08.24
62,Something Real,Dierks Bentley,355,0,355,55,0,651300,-59500,710800,312578,2023.08.24
63,In Your Love,Tyler Childers,203,100,103,70,0,631000,351200,279800,6396349,2023.08.24
64,Save The Roses,Lee Brice,251,-12,263,34,0,608100,-15200,623300,640584,2023.08.24
65,Wine Country,Hannah Ellis,343,7,336,54,0,562000,8000,554000,106594,2023.08.24
66,Without You,Thompson Square,433,5,428,59,0,558800,-34200,593000,18492,2023.08.24
67,Dance With You,Brett Young,390,-26,416,62,0,533000,-136800,669800,1734195,2023.08.24
68,'98 Braves,Morgan Wallen,85,6,79,4,0,488200,47600,440600,3498563,2023.08.24
69,Brokenhearted,Joe Nichols,298,4,294,44,0,488200,94500,393700,37031,2023.08.24
70,Young Love & Saturday Nights,Chris Young,66,8,58,8,0,424500,147100,277400,749673,2023.08.24
71,Mean Old Sun,Turnpike Troubadours,67,30,37,56,0,326300,151100,175200,443920,2023.08.24
72,Trouble,Josh Ross,289,6,283,48,0,312500,-58400,370900,2040033,2023.08.24
73,Make You Mine,Marynn Taylor,332,21,311,51,0,295000,27100,267900,57179,2023.08.24
74,Find Another Bar,Chris Lane,119,118,1,32,0,219200,217500,1700,540711,2023.08.24
75,Daylight Savings,Kidd G,171,-18,189,29,0,214300,-24800,239100,230650,2023.08.24
76,She's Somebody's Daughter,Drew Baldridge,104,74,30,43,0,192900,155500,37400,127270,2023.08.24
77,Nothing Compares To You,Mickey Guyton,103,27,76,31,0,191200,38700,152500,0,2023.08.24
78,One Of Us,Matt Stell,30,1,29,3,0,182400,39800,142600,756994,2023.08.24
79,Thicc As Thieves,Lauren Alaina,55,19,36,5,0,178000,39100,138900,1695617,2023.08.24
80,How Is She,Cole Swindell,26,-11,37,1,0,172900,-94700,267600,80509,2023.08.24
81,Ain'T Got A Worry,Old Dominion,17,,,1,0,172700,,,370721,2023.08.24
82,Heart To Break,Ryan Griffin,134,-19,153,22,0,152700,2000,150700,212616,2023.08.24
83,Ain'T Missin' You,Dylan Schneider,152,0,152,23,0,141600,-35700,177300,341399,2023.08.24
84,With You I Am,Cody Johnson,7,1,6,3,0,128400,64700,63700,1289988,2023.08.24
85,Oklahoma Smokeshow,Zach Bryan,43,1,42,2,0,119500,-5300,124800,6021518,2023.08.24
86,Wasting All These Tears,Austin Snell,19,0,19,1,0,115400,-11600,127000,869587,2023.08.24
87,Best Of Me,David Nail,34,0,34,1,0,114800,-500,115300,13592,2023.08.24
88,The Star-Spangled Banner,Chris Stapleton,21,12,9,16,0,110100,68900,41200,286555,2023.08.24
89,A Few Hearts Ago,Kylie Morgan,47,,,47,0,101800,,,162195,2023.08.24
89,ghost in my guitar,Alana Springsteen,47,,,47,0,101800,,,982847,2023.08.24
89,Glory Days,Chapel Hart,47,,,47,0,101800,,,2319,2023.08.24
92,We Ride,Bryan Martin,34,7,27,5,0,88900,45600,43300,3487743,2023.08.24
93,Colorado,Florida Georgia Line,13,-4,17,2,0,85100,-22100,107200,62861,2023.08.24
94,Country Boy's Dream Girl,Ella Langley,17,,,16,0,80700,,,1131741,2023.08.24
95,Lovin You Gets In The Way,Ben Gallaher,41,-2,43,7,0,71800,1600,70200,23894,2023.08.24
96,Tulsa,Elle King,20,-6,26,2,0,65300,3000,62300,62268,2023.08.24
97,Can't Break Up Now,Old Dominion,10,,,5,0,62400,,,2849338,2023.08.24
98,Cowgirls,Morgan Wallen,17,0,17,5,0,58500,1200,57300,6950831,2023.08.24
99,Spirits And Demons,Michael Ray,9,7,2,3,0,55400,53000,2400,0,2023.08.24
100,"Love, Beer",Andrew Sevener,87,34,53,18,0,52300,20700,31600,895,2023.08.24
101,Out Of Nowhere,Walker Montgomery,14,3,11,1,0,51200,6600,44600,12184,2023.08.24
102,Neon You,Don Louis,6,4,2,2,0,48000,30800,17200,83767,2023.08.24
103,Sun To Me,Zach Bryan,26,3,23,4,0,47700,-5200,52900,5118879,2023.08.24
104,My Bar,Priscilla Block,8,-1,9,3,0,46100,4800,41300,178983,2023.08.24
105,Got To Love Me,A Step Beyond,6,,,1,0,43200,,,0,2023.08.24
106,I Hope Heaven,Karissa Ella,70,17,53,18,0,42000,10300,31700,0,2023.08.24
107,Question The Universe,Teddy Robb,64,-8,72,20,0,41000,-4500,45500,3430,2023.08.24
108,I Can'T Breathe,Parker Mccollum,3,1,2,1,0,37000,28000,9000,1132895,2023.08.24
109,The Star-Spangled Banner,Carly Pearce,5,2,3,5,0,36900,25300,11600,0,2023.08.24
110,My Baby Does,Drew Parker,2,-4,6,1,0,36400,-8600,45000,8209,2023.08.24
111,A Special Place,Danielle Bradbery,17,-2,19,3,0,35700,-13100,48800,225076,2023.08.24
112,I Just Killed A Man,Catie Offerman,32,-74,106,5,0,34800,-91400,126200,126212,2023.08.24
113,Heartless,Diplo & Julia Michaels Feat. Morgan Wallen,8,4,4,3,0,34100,10600,23500,6448951,2023.08.24
114,Keith Whitley,Morgan Wallen,15,,,15,0,33700,,,1177650,2023.08.24
115,Summer To Me,Wayland,54,19,35,19,0,33300,12300,21000,3395,2023.08.24
116,Holy Water,Michael Ray,6,0,6,1,0,32700,3500,29200,300307,2023.08.24
117,That's Why We Fight,Ella Langley & Koe Wetzel,18,2,16,2,0,32200,0,32200,979051,2023.08.24
118,Under A Southern Sky,Ian Flanigan,56,1,55,18,0,32200,200,32000,977,2023.08.24
119,Back At The Bar,Landon Parker,56,-12,68,18,0,32200,-8700,40900,8846,2023.08.24
120,Honey!,Rayne Johnson,55,20,35,18,0,32000,11300,20700,29920,2023.08.24
121,Star Spangled Banner,Abby Anderson,6,3,3,6,0,31300,8700,22600,1,2023.08.24
122,Just Drive,Erin Kinsey,12,,,6,0,28600,,,139106,2023.08.24
123,Tough Crowd,Jason Aldean,10,-2,12,1,0,28200,-3800,32000,958154,2023.08.24
124,Over The Rainbow,Keith Jarrett,4,,,1,0,28000,,,765,2023.08.24
125,Ain't That Some,Morgan Wallen,10,-2,12,1,0,25300,1100,24200,5510482,2023.08.24
126,How I Get High,Josh Kaiser,40,-1,41,13,0,24500,-200,24700,0,2023.08.24
127,Lovin' Where It's Goin',Josh Ward,4,1,3,1,0,23900,-11500,35400,38804,2023.08.24
128,Make Me Wanna Smoke,Runaway June,36,35,1,6,0,23500,21000,2500,50096,2023.08.24
129,The Good I'Ll Do,Zach Bryan,9,-3,12,1,0,23300,-16200,39500,2999916,2023.08.24
130,Downtime,Roman Alexander,36,-16,52,18,0,21200,-10200,31400,38612,2023.08.24
131,First Rodeo,Daves Highway,35,-36,71,18,0,21000,-21200,42200,606,2023.08.24
132,We Ain't The Only Ones,Randy Rogers & Wade Bowen,2,-1,3,2,0,20200,-18200,38400,0,2023.08.24
133,Better Off,Trace Adkins,3,1,2,1,0,20000,10300,9700,15300,2023.08.24
134,Longneck Way To Go,Midland Feat. Jon Pardi,9,7,2,7,0,19500,13100,6400,162997,2023.08.24
135,Quittin' Time,Morgan Wallen,5,-3,8,1,0,19500,-4900,24400,1037727,2023.08.24
136,Give Me A Sunrise,Braxton Keith,3,,,1,0,19400,,,29249,2023.08.24
137,3 Tequila Floor,Josiah Siska,14,4,10,3,0,19200,3600,15600,9642,2023.08.24
138,All You Got,William Clark Green,1,,,1,0,18200,,,4773,2023.08.24
138,Rhinestoned,"Randy Rogers ,Wade Bowen",1,,,1,0,18200,,,30986,2023.08.24
138,Bad Guy,Casey Donahew,1,,,1,0,18200,,,62519,2023.08.24
138,Wrap You Up In Love,Darrin Morris Band,1,,,1,0,18200,,,1012,2023.08.24
138,Little More You,Josh Abbott Band,1,,,1,0,18200,,,25463,2023.08.24
138,Over Drinkin' Under Thinkin',Drake Milligan,1,,,1,0,18200,,,62689,2023.08.24
144,Stop Coming Over,Chris Lane,7,0,7,6,0,17400,0,17400,39538,2023.08.24
145,Peaked In High School,Priscilla Block,7,,,6,0,17400,,,17562,2023.08.24
146,Heart Of A Small Town,Tim Dugger,3,2,1,1,0,17200,15900,1300,16779,2023.08.24
147,When My Baby's In Boots,Randall King,4,-1,5,2,0,16900,-42600,59500,0,2023.08.24
148,"Jesus, My Mama, My Therapist",Tiera Kennedy,6,3,3,4,0,16300,1600,14700,90595,2023.08.24
149,Loud and Heavy,Cody Jinks,10,0,10,2,0,15500,-4000,19500,1915898,2023.08.24
150,Any Given Friday Night,Luke Combs,2,0,2,1,0,15200,0,15200,307956,2023.08.24
151,Should Have Known Better,Jessie James Decker,6,,,6,0,14300,,,90401,2023.08.24
151,Hits me,Lindsay Ell,6,,,6,0,14300,,,2391,2023.08.24
153,Outlaw,Morgan Wallen Feat. Ben Burgess,8,-1,9,1,0,13900,-200,14100,551481,2023.08.24
154,Star Spangled Banner,Maren Morris,1,-1,2,1,0,13700,-2200,15900,0,2023.08.24
155,Don't Think Jesus,Morgan Wallen,4,2,2,3,0,13600,10700,2900,1481224,2023.08.24
156,National Anthem From Battle At Bristol,Jennifer Nettles,4,3,1,4,0,13400,4400,9000,0,2023.08.24
157,Settle Me Down,Josh Abbott Band,4,2,2,3,0,13200,8100,5100,403400,2023.08.24
158,Codigo,George Strait,1,,,1,0,12900,,,31841,2023.08.24
159,I'M Not For Everyone,Brothers Osborne,3,1,2,1,0,12800,2400,10400,464510,2023.08.24
160,Record High,Dylan Marlowe,2,,,1,0,12800,,,645670,2023.08.24
161,Decoration,Jillian Riscoe,5,-1,6,1,0,12600,1600,11000,14,2023.08.24
162,White House Road,Tyler Childers & The Highwall,4,-2,6,2,0,12600,-500,13100,3094370,2023.08.24
163,Build A Bridge,Ashley Cooke,7,2,5,1,0,12400,2400,10000,19302,2023.08.24
164,Psychopath,Morgan Wade,9,-2,11,1,0,12200,4800,7400,534946,2023.08.24
165,Man Made A Bar,Morgan Wallen,4,-5,9,1,0,12200,-24300,36500,3792499,2023.08.24
166,When Will I Be Loved,"Ashley McBryde, Caylee Hammack & Pillbox Patti",6,0,6,6,0,11800,-2500,14300,36536,2023.08.24
167,Not Yet,Brett Young,6,,,6,0,11800,,,83305,2023.08.24
168,That's Why I Love Dirt Roads,Granger Smith,2,,,2,0,11800,,,106255,2023.08.24
169,Get Lost,Lucas Hoge,5,,,5,0,11200,,,1672,2023.08.24
170,Star Spangled Banner,Demi Lovato,2,1,1,2,0,10900,1500,9400,87,2023.08.24
171,The Great Divide,Luke Combs & Billy Strings,5,-3,8,1,0,10900,-14500,25400,250538,2023.08.24
172,Star Spangled Banner,Mickey Guyton,4,-1,5,4,0,10800,-17500,28300,0,2023.08.24
173,HOW I LEARNED TO PRAY,Charlie Worsham,1,,,1,0,10600,,,1896070,2023.08.24
174,Let It Be,Dolly Parton,1,,,1,0,10300,,,594040,2023.08.24
175,A Hundred Different Altars,Steeles,2,1,1,2,0,10200,4900,5300,5389,2023.08.24
176,Think About There,Greater Vision,2,0,2,2,0,10200,0,10200,14226,2023.08.24
177,Where The Wild Things Are,Luke Combs,1,0,1,1,0,9500,8500,1000,1601928,2023.08.24
178,Sometimes She Stays,Kip Moore,9,-2,11,1,0,8500,-4000,12500,141688,2023.08.24
179,Never Have I Ever,Danielle Bradbery,1,0,1,1,0,8400,900,7500,31103,2023.08.24
180,There Was Jesus,Zach Williams & Dolly Parton,1,0,1,1,0,8400,0,8400,1051206,2023.08.24
181,He Went To Jared,HARDY Feat. Morgan Wallen,2,-1,3,2,0,8400,-9600,18000,1145953,2023.08.24
182,Broadway Girls,Lil Durk Feat. Morgan Wallen,1,-1,2,1,0,8400,-1600,10000,5543196,2023.08.24
183,The River (Come On Down),Hillary Scott & The Scott Family,1,,,1,0,8400,,,6655,2023.08.24
183,Let Your Light Shine,Ball Brothers,1,,,1,0,8400,,,1826,2023.08.24
183,Home Run,Joe Nichols,1,,,1,0,8400,,,18016,2023.08.24
183,Silverado For Sale,Morgan Wallen,1,,,1,0,8400,,,1463916,2023.08.24
187,Everything Has Your Memory,Wade Bowen,2,1,1,2,0,8100,2000,6100,11320,2023.08.24
187,Nothing But Love Songs,Randy Rogers Band,2,1,1,2,0,8100,2000,6100,15540,2023.08.24
189,You In A Honky Tonk,Randall King,3,-1,4,3,0,8100,-33400,41500,461043,2023.08.24
190,Goin' Crazy,Jameson Rodgers,6,-3,9,1,0,8100,1100,7000,13748,2023.08.24
191,Brother Have You Heard,Doyle Lawson & Quicksilver,1,,,1,0,8100,,,588,2023.08.24
192,Strawberry Wine And A Cheap Six Pack,Travis Denning,6,-10,16,1,0,8000,-29200,37200,114418,2023.08.24
193,The Star-Spangled Banner,Eric Church & Jazmine Sullivan,3,2,1,2,0,7800,6800,1000,0,2023.08.24
194,Paradise To Me,Niko Moon,5,4,1,2,0,7700,5000,2700,559259,2023.08.24
195,Giving You Up,Kameron Marlowe,3,1,2,1,0,7700,3200,4500,982018,2023.08.24
196,All I Need To See,Mitch Rossell,1,,,1,0,7600,,,42572,2023.08.24
197,Midnight Crisis,Jordan Davis Feat. Danielle Bradbery,9,5,4,1,0,7500,5500,2000,78422,2023.08.24
198,Gettin' Ready To Breathe,Wes Hampton,1,0,1,1,0,7500,2600,4900,15302,2023.08.24
199,He Welcomes the Beggar,11th Hour,1,,,1,0,7500,,,3711,2023.08.24
199,His Name Is Jesus (Live),Cody Johnson,1,,,1,0,7500,,,48580,2023.08.24
199,First Church Of Mercy,Sound,1,,,1,0,7500,,,2237,2023.08.24
199,Mama's Rocking Chair,Ivan Parker,1,,,1,0,7500,,,207,2023.08.24
199,This Is The Church,Steeles,1,,,1,0,7500,,,141,2023.08.24
199,I Serve A Savior,Josh Turner,1,,,1,0,7500,,,59316,2023.08.24
199,Pieces,Kingdom Heirs,1,,,1,0,7500,,,345,2023.08.24
199,WE ARE NOT ASHAMED,Taylors,1,,,1,0,7500,,,673,2023.08.24
199,Hey,Karen Peck & New River,1,,,1,0,7500,,,494,2023.08.24
1,Love You Anyway,Luke Combs,8196,654,7542,145,0,31986100,2690400,29295700,6872690,2023.08.31
2,Need A Favor,Jelly Roll,6258,-1216,7474,144,0,26449500,-3065500,29515000,8881389,2023.08.31
3,Bury Me In Georgia,Kane Brown,6927,200,6727,145,0,26279800,325200,25954600,5370945,2023.08.31
4,Last Night,Morgan Wallen,5809,-238,6047,144,0,26027700,-1097300,27125000,24316729,2023.08.31
5,Angels,Thomas Rhett,6135,466,5669,145,0,22086500,1165100,20921400,2450930,2023.08.31
6,Religiously,Bailey Zimmerman,5862,396,5466,145,0,21142600,1570500,19572100,12992729,2023.08.31
7,Girl In Mine,Parmalee,5488,138,5350,144,0,19979200,1095400,18883800,1896984,2023.08.31
8,Your Heart Or Mine,Jon Pardi,4924,-2435,7359,145,0,19423300,-7944700,27368000,3599434,2023.08.31
9,Watermelon Moonshine,Lainey Wilson,5290,910,4380,145,0,19269800,3509800,15760000,7305404,2023.08.31
10,Try That In A Small Town,Jason Aldean,5143,918,4225,142,0,19176100,3579100,15597000,10516207,2023.08.31
11,God Gave Me A Girl,Russell Dickerson,4303,380,3923,145,0,16339400,1573900,14765500,1143051,2023.08.31
12,Everything I Love,Morgan Wallen,4018,163,3855,145,0,15477600,833500,14644100,3944927,2023.08.31
13,But I Got A Beer In My Hand,Luke Bryan,3913,42,3871,145,0,14129900,161900,13968000,2952767,2023.08.31
14,Drinkaby,Cole Swindell,4186,226,3960,144,0,14034800,390700,13644100,1920403,2023.08.31
15,Standing Room Only,Tim McGraw,3962,18,3944,145,0,13700500,346600,13353900,4996254,2023.08.31
16,Stars Like Confetti,Dustin Lynch,3578,378,3200,143,0,12779900,1430600,11349300,1575512,2023.08.31
17,Can'T Have Mine,Dylan Scott,3457,227,3230,145,0,11386000,997800,10388200,2463185,2023.08.31
18,Thinkin' Bout Me,Morgan Wallen,2655,908,1747,135,0,10105300,3263100,6842200,12532398,2023.08.31
19,Everything She Ain't,Hailey Whitters,3045,-177,3222,144,0,9696700,-352400,10049100,2201457,2023.08.31
20,If You Go Down (I'M Going Down Too),Kelsea Ballerini,3219,67,3152,144,0,9366000,145700,9220300,1872878,2023.08.31
21,Save Me The Trouble,Dan + Shay,2700,199,2501,144,0,8814200,485400,8328800,2059779,2023.08.31
22,All I Need Is You,Chris Janson,2713,113,2600,140,0,7358300,266900,7091400,926234,2023.08.31
23,Mind On You,George Birge,2270,96,2174,142,0,6832000,384400,6447600,216816,2023.08.31
24,We Got History,Mitchell Tenpenny,2112,73,2039,142,0,6212200,229300,5982900,1449603,2023.08.31
25,Light On In The Kitchen,Ashley McBryde,2143,108,2035,144,0,5554700,323300,5231400,1361569,2023.08.31
26,Different 'Round Here,Riley Green,1773,199,1574,139,0,5136700,587700,4549000,2063908,2023.08.31
27,Nobody's Nobody,Brothers Osborne,1915,23,1892,142,0,4886900,324100,4562800,1111549,2023.08.31
28,23,Chayce Beckham,1782,151,1631,141,0,4771600,330900,4440700,3090197,2023.08.31
29,Creek Will Rise,Conner Smith,1937,54,1883,143,0,4728900,310700,4418200,1059394,2023.08.31
30,White Horse,Chris Stapleton,1543,104,1439,132,0,4480300,404300,4076000,6914501,2023.08.31
31,World On Fire,Nate Smith,1606,210,1396,131,0,4420300,701600,3718700,3921161,2023.08.31
32,Fearless,Jackson Dean,1605,-10,1615,143,0,3795300,186600,3608700,1183349,2023.08.31
33,Pretty Little Poison,Warren Zeiders,1086,11,1075,78,0,3733100,101200,3631900,5610455,2023.08.31
34,See You Next Summer,Brian Kelley,1393,57,1336,136,0,3442600,207000,3235600,811892,2023.08.31
35,We Don'T Fight Anymore,Carly Pearce,1078,88,990,124,0,3103000,299900,2803100,2684997,2023.08.31
36,Truck Bed,Hardy,1152,94,1058,112,0,2844500,88000,2756500,6920611,2023.08.31
37,Burn It Down,Parker Mccollum,894,54,840,89,0,2693600,153200,2540400,3737128,2023.08.31
38,Glory Days,Gabby Barrett,1349,174,1175,136,0,2636200,242200,2394000,1620141,2023.08.31
39,Out Of That Truck,Carrie Underwood,896,-64,960,98,0,2526200,-247100,2773300,1893031,2023.08.31
40,The Painter,Cody Johnson,739,92,647,82,0,2229500,247200,1982300,4716593,2023.08.31
41,Fires Don'T Start Themselves,Darius Rucker,908,-72,980,126,0,2180700,-173100,2353800,950623,2023.08.31
42,Save Me,Jelly Roll & Lainey Wilson,562,93,469,54,0,2176900,364000,1812900,6902585,2023.08.31
43,Good With Me,Walker Hayes,582,,,82,0,2109300,,,1172083,2023.08.31
44,Rich Men North Of Richmond,Oliver Anthony Music,538,14,524,65,0,1985000,-58600,2043600,21149888,2023.08.31
45,Cab In A Solo,Scotty McCreery,776,-222,998,105,0,1838900,-2397800,4236700,671741,2023.08.31
46,Drive You Out Of My Mind,Kassi Ashton,760,21,739,82,0,1651900,131300,1520600,844082,2023.08.31
47,Giving Up On That,Dalton Dover,820,17,803,89,0,1543700,41300,1502400,824571,2023.08.31
48,I'M Not Pretty,Megan Moroney,488,14,474,58,0,1500700,1600,1499100,2536223,2023.08.31
49,Outskirts,Sam Hunt,565,22,543,66,0,1437700,167000,1270700,3404735,2023.08.31
50,Tucson Too Late,Jordan Davis,541,162,379,71,0,1418000,383400,1034600,1016657,2023.08.31
51,On The Boat Again,Jake Owen,544,-93,637,70,0,1355300,-302300,1657600,255151,2023.08.31
52,Shoot Tequila,Tigirlily Gold,666,22,644,76,0,1296600,164400,1132200,897429,2023.08.31
53,Somebody Else's Whiskey,Frank Ray,686,25,661,71,0,1119900,55200,1064700,130427,2023.08.31
54,Love You Again,Chase Matthew,524,40,484,53,0,1117400,68000,1049400,2517128,2023.08.31
55,Something's Gonna Kill Me,Corey Kent,460,20,440,59,0,1065800,99400,966400,2229203,2023.08.31
56,Marry That Girl,Easton Corbin,553,22,531,69,0,1005700,45300,960400,137004,2023.08.31
57,Drinkin' Problems,Dillon Carmichael,541,-33,574,80,0,987300,-53100,1040400,70988,2023.08.31
58,Bad Day To Be A Cold Beer,Chase Rice,573,19,554,63,0,965800,42800,923000,190341,2023.08.31
59,Without You,Thompson Square,457,24,433,58,0,709900,151100,558800,19892,2023.08.31
60,Something Real,Dierks Bentley,364,9,355,54,0,700500,49200,651300,303450,2023.08.31
61,Wine Country,Hannah Ellis,338,-5,343,56,0,636500,74500,562000,103612,2023.08.31
62,Dance With You,Brett Young,406,16,390,70,0,580100,47100,533000,1809525,2023.08.31
63,Buy A Bar,Tim Dugger,208,-106,314,40,0,576800,-85100,661900,25579,2023.08.31
64,Save The Roses,Lee Brice,225,-26,251,31,0,543800,-64300,608100,580965,2023.08.31
65,Brokenhearted,Joe Nichols,292,-6,298,44,0,494500,6300,488200,39405,2023.08.31
66,Ain'T Got A Worry,Old Dominion,41,24,17,1,0,446300,273600,172700,327187,2023.08.31
67,Young Love & Saturday Nights,Chris Young,85,19,66,13,0,408100,-16400,424500,592754,2023.08.31
68,'98 Braves,Morgan Wallen,74,-11,85,6,0,394400,-93800,488200,3386546,2023.08.31
69,Find Another Bar,Chris Lane,220,101,119,36,0,327600,108400,219200,312590,2023.08.31
70,Daylight Savings,Kidd G,192,21,171,31,0,306200,91900,214300,165971,2023.08.31
71,In Your Love,Tyler Childers,168,-35,203,19,0,298400,-332600,631000,6129861,2023.08.31
72,Spirits And Demons,Michael Ray With Meghan Patrick,138,129,9,36,0,290100,234700,55400,619572,2023.08.31
73,Trouble,Josh Ross,302,13,289,50,0,286700,-25800,312500,1651019,2023.08.31
74,Nashville Ca/L.A. Tennessee,Tim McGraw,45,,,45,0,281000,,,276289,2023.08.31
75,Find Yourself,Lukas Nelson & Promise Of The Real,57,,,56,0,280900,,,226376,2023.08.31
76,Hey Whiskey,Tim McGraw,43,,,43,0,275500,,,893295,2023.08.31
77,Make You Mine,Marynn Taylor,320,-12,332,46,0,263800,-31200,295000,59288,2023.08.31
78,She's Somebody's Daughter (2019),Drew Baldridge,125,21,104,35,0,247500,54600,192900,117941,2023.08.31
79,Hold On To It,Tim McGraw,41,,,41,0,247400,,,975000,2023.08.31
80,Fool Me Again,Tim McGraw,40,,,40,0,244400,,,283228,2023.08.31
81,Remember Me Well,Tim McGraw,24,,,23,0,210300,,,387357,2023.08.31
82,Thicc As Thieves,Lauren Alaina,56,1,55,7,0,204700,26700,178000,1097218,2023.08.31
83,One Of Us,Matt Stell,35,5,30,5,0,179200,-3200,182400,925979,2023.08.31
84,Time Is Money,Johnny Clawson,33,,,33,0,175500,,,444,2023.08.31
85,Wolfman Of The Ozarks,Old Crow Medicine Show,37,,,37,0,175200,,,22445,2023.08.31
86,I Remember Everything,Zach Bryan Feat. Kacey Musgraves,34,,,7,0,174800,,,33797218,2023.08.31
87,How Is She,Cole Swindell,25,-1,26,1,0,172200,-700,172900,72135,2023.08.31
88,Ain'T Missin' You,Dylan Schneider,152,0,152,25,0,158700,17100,141600,380426,2023.08.31
89,Two Flowers,Lily Rose,26,,,26,0,156100,,,0,2023.08.31
90,Heart To Break,Ryan Griffin,116,-18,134,21,0,147900,-4800,152700,193661,2023.08.31
91,We Ride,Bryan Martin,48,14,34,6,0,137700,48800,88900,3515974,2023.08.31
92,Still Gonna Miss You,Colbie Caillat,49,,,48,0,106300,,,154146,2023.08.31
93,The Kiss Or The Crash,Nikita Karmen,48,,,48,0,103900,,,741,2023.08.31
94,Best Of Me,David Nail,28,-6,34,1,0,103000,-11800,114800,11764,2023.08.31
95,Everybody Wants To Rule The World,Anna Vaus,47,,,47,0,101500,,,5209,2023.08.31
96,Nothing Compares To You,Mickey Guyton,74,-29,103,17,0,94400,-96800,191200,0,2023.08.31
97,Oklahoma Smokeshow,Zach Bryan,33,-10,43,2,0,94000,-25500,119500,6120134,2023.08.31
98,With You I Am,Cody Johnson,6,-1,7,3,0,88100,-40300,128400,1396396,2023.08.31
99,Cowgirls,Morgan Wallen,25,8,17,5,0,86600,28100,58500,6804821,2023.08.31
100,Colorado,Florida Georgia Line,12,-1,13,2,0,86600,1500,85100,55404,2023.08.31
101,Lovin You Gets In The Way,Ben Gallaher,34,-7,41,7,0,78900,7100,71800,23310,2023.08.31
102,This Side Of The Dirt,Neon Union,22,,,8,0,74400,,,135815,2023.08.31
103,That's The Life I Want,Alexander Ludwig,10,,,10,0,64600,,,2145,2023.08.31
104,Tulsa,Elle King,26,6,20,2,0,64100,-1200,65300,61858,2023.08.31
105,Sun To Me,Zach Bryan,28,2,26,3,0,63900,16200,47700,5406255,2023.08.31
106,Ain't That Some,Morgan Wallen,21,11,10,3,0,61100,35800,25300,5074758,2023.08.31
107,The Star-Spangled Banner,Chris Stapleton,16,-5,21,13,0,56900,-53200,110100,292870,2023.08.31
108,My Bar,Priscilla Block,10,2,8,4,0,56000,9900,46100,172278,2023.08.31
109,Question The Universe,Teddy Robb,82,18,64,21,0,53300,12300,41000,3258,2023.08.31
110,Make Me Wanna Smoke,Runaway June,57,21,36,8,0,52400,28900,23500,51114,2023.08.31
111,Out Of Nowhere,Walker Montgomery,12,-2,14,1,0,51800,600,51200,11210,2023.08.31
112,Longneck Way To Go,Midland Feat. Jon Pardi,9,0,9,2,0,43800,24300,19500,155500,2023.08.31
113,Back At The Bar,Landon Parker,70,14,56,18,0,42000,9800,32200,8264,2023.08.31
114,First Rodeo,Daves Highway,72,37,35,18,0,41600,20600,21000,432,2023.08.31
115,Can't Break Up Now,Old Dominion,7,-3,10,5,0,41400,-21000,62400,1961848,2023.08.31
116,Downtime,Roman Alexander,71,35,36,18,0,41300,20100,21200,24701,2023.08.31
117,Mr. Red White And Blue,Coffey Anderson And Drew Jacobs,5,,,1,0,41000,,,77763,2023.08.31
118,A Special Place,Danielle Bradbery,12,-5,17,3,0,40100,4400,35700,108274,2023.08.31
119,Fear And Friday's,Zach Bryan,13,,,2,0,38600,,,14067071,2023.08.31
120,Summer To Me,Wayland,61,7,54,19,0,37900,4600,33300,3045,2023.08.31
121,The Day I Stop Dancin',Jon Pardi,3,1,2,1,0,37000,31900,5100,53194,2023.08.31
122,What Ifs (Live 2020 iHeart Music Festival),Kane Brown,42,,,42,0,36100,,,0,2023.08.31
123,Holy Water,Michael Ray,8,2,6,1,0,35800,3100,32700,296079,2023.08.31
124,Heartless,Diplo & Julia Michaels Feat. Morgan Wallen,7,-1,8,3,0,34700,600,34100,6187387,2023.08.31
125,Cover Me Up,Morgan Wallen,9,7,2,4,0,33600,32600,1000,4674029,2023.08.31
126,I Hope Heaven,Karissa Ella,54,-16,70,18,0,31700,-10300,42000,0,2023.08.31
127,Honey!,Rayne Johnson,51,-4,55,18,0,31100,-900,32000,29446,2023.08.31
128,"Love, Beer",Andrew Sevener,54,-33,87,18,0,31100,-21200,52300,2584,2023.08.31
129,"Jesus, My Mama, My Therapist",Tiera Kennedy,24,18,6,7,0,29600,13300,16300,77134,2023.08.31
130,Seven Year Ache,Aaron Watson & Jenna Paulette,4,3,1,1,0,29200,27200,2000,0,2023.08.31
131,Last Drive Down Main,Morgan Wallen,12,,,12,0,28100,,,1356093,2023.08.31
132,Man Made A Bar,Morgan Wallen,9,5,4,3,0,26500,14300,12200,3784628,2023.08.31
133,That's Why We Fight,Ella Langley & Koe Wetzel,16,-2,18,2,0,26500,-5700,32200,892108,2023.08.31
134,Broadway Girls,Lil Durk Feat. Morgan Wallen,4,3,1,2,0,25500,17100,8400,5359238,2023.08.31
135,Loser,Mike Ryan,3,-2,5,2,0,24700,20300,4400,14719,2023.08.31
136,National Anthem From Battle At Bristol,Jennifer Nettles,4,0,4,4,0,22700,9300,13400,0,2023.08.31
137,The Great Divide,Luke Combs & Billy Strings,6,1,5,1,0,22600,11700,10900,252827,2023.08.31
138,Neon You,Don Louis,4,-2,6,1,0,22300,-25700,48000,80504,2023.08.31
139,I Just Killed A Man,Catie Offerman,21,-11,32,3,0,21400,-13400,34800,109513,2023.08.31
140,Under A Southern Sky,Ian Flanigan,36,-20,56,18,0,21200,-11000,32200,1713,2023.08.31
141,When My Baby's In Boots,Randall King,4,0,4,1,0,20000,3100,16900,0,2023.08.31
142,You'Re Gonna Love Me,Tim Dugger,3,2,1,1,0,19100,17800,1300,8093,2023.08.31
143,Days That End In Why,Morgan Wallen,5,3,2,2,0,18200,15300,2900,1367359,2023.08.31
144,Girl On Fire,Kameron Marlowe,1,0,1,1,0,18200,13700,4500,862878,2023.08.31
145,We Ain't The Only Ones,Randy Rogers & Wade Bowen,1,-1,2,1,0,18200,-2000,20200,0,2023.08.31
146,Stranger In My House,Ronnie Milsap,3,1,2,1,0,18000,11700,6300,140162,2023.08.31
147,So Will I,Phillip Phillips,8,,,8,0,17900,,,72721,2023.08.31
148,HOW I LEARNED TO PRAY,Charlie Worsham,3,2,1,3,0,17800,7200,10600,1094988,2023.08.31
149,Think About There,Greater Vision,3,1,2,3,0,17700,7500,10200,15387,2023.08.31
150,Somebody's Problem,Morgan Wallen,4,3,1,2,0,17500,10600,6900,3375347,2023.08.31
151,Wild as You,Cody Johnson,3,2,1,3,0,17000,16400,600,1237509,2023.08.31
152,Giving You Up,Kameron Marlowe,3,0,3,2,0,16800,9100,7700,940665,2023.08.31
153,Better Off,Trace Adkins,2,-1,3,1,0,16800,-3200,20000,15471,2023.08.31
154,The Good I'Ll Do,Zach Bryan,8,-1,9,1,0,16600,-6700,23300,2844169,2023.08.31
155,How I Get High,Josh Kaiser,26,-14,40,13,0,16200,-8300,24500,0,2023.08.31
156,Leave You Alone,Kane Brown,5,,,5,0,15900,,,408796,2023.08.31
157,Love Is Real,Morgan Evans,5,3,2,1,0,15500,10700,4800,58457,2023.08.31
158,I've Got To Get Sober,Oliver Anthony,12,8,4,1,0,15400,12000,3400,0,2023.08.31
159,I'M Not For Everyone,Brothers Osborne,2,-1,3,2,0,15300,2500,12800,476772,2023.08.31
160,Any Given Friday Night,Luke Combs,2,0,2,1,0,15200,0,15200,285144,2023.08.31
161,Outlaw,Morgan Wallen Feat. Ben Burgess,7,-1,8,1,0,14900,1000,13900,497945,2023.08.31
162,Loud and Heavy,Cody Jinks,9,-1,10,3,0,14700,-800,15500,1886878,2023.08.31
163,Star Spangled Banner,Abby Anderson,2,-4,6,2,0,14700,-16600,31300,0,2023.08.31
164,Don't Think Jesus,Morgan Wallen,5,1,4,3,0,14400,800,13600,1331208,2023.08.31
165,Just Drive,Erin Kinsey,6,-6,12,6,0,14300,-14300,28600,126360,2023.08.31
166,Keeping Me Up All Night,Chayce Beckham,6,,,6,0,14300,,,118738,2023.08.31
166,My First Car,Meghan Patrick,6,,,6,0,14300,,,760,2023.08.31
166,Hot Beer,Dillon Carmichael,6,,,6,0,14300,,,66173,2023.08.31
169,Psychopath,Morgan Wade,12,3,9,1,0,13900,1700,12200,1359907,2023.08.31
170,The Star Spangled Banner,Locash,1,,,1,0,13700,,,0,2023.08.31
171,One Name,Jeff & Sheri Easter,2,1,1,2,0,12400,7500,4900,10900,2023.08.31
172,There Is A God,Reba Mcentire,2,,,2,0,12400,,,2269,2023.08.31
173,Whiskey Friends,Morgan Wallen,3,2,1,1,0,12200,8600,3600,1988129,2023.08.31
174,Bits & Pieces,Walker County,5,,,5,0,12200,,,3246,2023.08.31
175,90s Country,Holdaways,5,0,5,1,0,11900,4500,7400,84,2023.08.31
176,Build A Bridge,Ashley Cooke,7,0,7,1,0,11700,-700,12400,18437,2023.08.31
177,God Only Knows,for King & Country,2,1,1,1,0,11600,10300,1300,1065772,2023.08.31
178,Soundtrack To A Small Town Sundown,Tyler Farr,2,0,2,1,0,11600,9000,2600,10132,2023.08.31
179,Buckles And Broken Hearts,Joe Peters,2,,,1,0,11200,,,1197,2023.08.31
180,I'Ve Seen Me Do It,Joe Peters,2,1,1,1,0,10600,9000,1600,404,2023.08.31
181,We Should Get Married,Dan + Shay,2,,,2,0,10500,,,1258843,2023.08.31
182,Pretender,Sarah Darling,17,,,17,0,10400,,,404,2023.08.31
183,All Things,Sound,2,1,1,2,0,10200,4900,5300,9502,2023.08.31
184,I Wrote The Book,Morgan Wallen,2,1,1,1,0,10200,7700,2500,4754344,2023.08.31
185,This Bar,Morgan Wallen,2,,,1,0,10200,,,2461089,2023.08.31
185,180 (Lifestyle),Morgan Wallen,2,,,1,0,10200,,,2049856,2023.08.31
185,865,Morgan Wallen,2,,,1,0,10200,,,2365428,2023.08.31
185,Sunrise,Morgan Wallen,2,,,1,0,10200,,,3715359,2023.08.31
185,Dying Man,Morgan Wallen,2,,,1,0,10200,,,2007487,2023.08.31
190,Short Skirt Weather,Kane Brown,1,,,1,0,10100,,,191905,2023.08.31
191,Up Yours,Trey Lewis,2,,,1,0,10000,,,14780,2023.08.31
192,Desafinado,Chick Corea,3,,,1,0,9900,,,482,2023.08.31
193,Where I'M Bound,Ashby Frank,2,,,2,0,9500,,,122,2023.08.31
194,Star Spangled Banner,Demi Lovato,1,-1,2,1,0,9400,-1500,10900,108,2023.08.31
195,Quittin' Time,Morgan Wallen,4,-1,5,1,0,9200,-10300,19500,1010802,2023.08.31
196,Star Spangled Banner,Maren Morris,1,0,1,1,0,9000,-4700,13700,0,2023.08.31
197,Forward,Niia,1,,,1,0,8700,,,275,2023.08.31
198,Nobody Like Jesus,LeFevre Quartet,1,0,1,1,0,8400,8000,400,4535,2023.08.31
199,His Name Is Jesus (Live),Cody Johnson,1,0,1,1,0,8400,900,7500,44401,2023.08.31
199,I Serve A Savior,Josh Turner,1,0,1,1,0,8400,900,7500,60772,2023.08.31
201,Sing,Chris Tomlin Feat. Russell Dickerson & Florida Georgia Line,1,,,1,0,8400,,,45865,2023.08.31
201,The Building,Emily Ann Roberts,1,,,1,0,8400,,,24993,2023.08.31
201,"Oh, How I Love Jesus",Reba Mcentire,1,,,1,0,8400,,,7604,2023.08.31
201,Home,Ernie Haase & Signature Sound And The Booth Brothers Feat. Paul Lancaster,1,,,1,0,8400,,,0,2023.08.31
201,Thy Will,Hillary Scott & The Scott Family,1,,,1,0,8400,,,419158,2023.08.31
1,Bury Me In Georgia,Kane Brown,7847,969,6878,144,0,29262300,2982500,26279800,5519487,2023.09.07
2,Love You Anyway,Luke Combs,7212,-937,8149,144,0,28492200,-3493900,31986100,6801348,2023.09.07
3,Need A Favor,Jelly Roll,5863,-365,6228,142,0,25456500,-993000,26449500,7959896,2023.09.07
4,Last Night,Morgan Wallen,5520,-260,5780,144,0,24868700,-1159000,26027700,23502128,2023.09.07
5,Angels,Thomas Rhett,6449,343,6106,144,0,24074400,1987900,22086500,2237112,2023.09.07
6,Religiously,Bailey Zimmerman,6211,398,5813,144,0,22573500,1430900,21142600,12971012,2023.09.07
7,Watermelon Moonshine,Lainey Wilson,5903,661,5242,144,0,21848600,2578800,19269800,7139713,2023.09.07
8,Try That In A Small Town,Jason Aldean,5915,801,5114,143,0,21708000,2531900,19176100,9374569,2023.09.07
9,Girl In Mine,Parmalee,5711,251,5460,143,0,21106700,1127500,19979200,1859921,2023.09.07
10,God Gave Me A Girl,Russell Dickerson,4495,219,4276,144,0,17751200,1411800,16339400,1107983,2023.09.07
11,Everything I Love,Morgan Wallen,4115,125,3990,144,0,15783200,305600,15477600,4053026,2023.09.07
12,Stars Like Confetti,Dustin Lynch,4218,667,3551,142,0,15413200,2633300,12779900,1632410,2023.09.07
13,Standing Room Only,Tim McGraw,4139,205,3934,144,0,14723800,1023300,13700500,4573916,2023.09.07
14,But I Got A Beer In My Hand,Luke Bryan,3969,103,3866,144,0,14684100,554200,14129900,2862128,2023.09.07
15,Thinkin' Bout Me,Morgan Wallen,3300,648,2652,138,0,12742100,2636800,10105300,12561391,2023.09.07
16,Can'T Have Mine,Dylan Scott,3587,178,3409,144,0,12435100,1049100,11386000,2328848,2023.09.07
17,Save Me The Trouble,Dan + Shay,3036,353,2683,144,0,9930100,1115900,8814200,1866314,2023.09.07
18,If You Go Down (I'M Going Down Too),Kelsea Ballerini,3296,103,3193,144,0,9596800,230800,9366000,1922544,2023.09.07
19,Mind On You,George Birge,2592,350,2242,141,0,8487000,1655000,6832000,209608,2023.09.07
20,All I Need Is You,Chris Janson,2842,156,2686,142,0,8269600,911300,7358300,1194292,2023.09.07
21,Light On In The Kitchen,Ashley McBryde,2369,244,2125,143,0,6657500,1102800,5554700,1408569,2023.09.07
22,We Got History,Mitchell Tenpenny,2259,164,2095,142,0,6346900,134700,6212200,1402312,2023.09.07
23,Different 'Round Here,Riley Green,2051,294,1757,142,0,6043100,906400,5136700,2315862,2023.09.07
24,White Horse,Chris Stapleton,1808,282,1526,130,0,5738200,1257900,4480300,6853777,2023.09.07
25,23,Chayce Beckham,2048,293,1755,141,0,5618900,847300,4771600,2960120,2023.09.07
26,Everything She Ain't,Hailey Whitters,1541,-1477,3018,139,0,5535400,-4161300,9696700,1904424,2023.09.07
27,Creek Will Rise,Conner Smith,2134,214,1920,142,0,5223800,494900,4728900,1103628,2023.09.07
28,World On Fire,Nate Smith,1797,207,1590,133,0,5181000,760700,4420300,3734275,2023.09.07
29,Nobody's Nobody,Brothers Osborne,1961,63,1898,141,0,4921600,34700,4886900,1155565,2023.09.07
30,Pretty Little Poison,Warren Zeiders,1370,289,1081,116,0,4457900,724800,3733100,5150026,2023.09.07
31,Fearless,Jackson Dean,1715,136,1579,141,0,4005500,210200,3795300,1189164,2023.09.07
32,See You Next Summer,Brian Kelley,1407,31,1376,138,0,3536300,93700,3442600,807342,2023.09.07
33,Save Me,Jelly Roll & Lainey Wilson,831,269,562,79,0,3126900,950000,2176900,6395162,2023.09.07
34,Truck Bed,Hardy,1280,154,1126,129,0,3102900,258400,2844500,7038991,2023.09.07
35,We Don'T Fight Anymore,Carly Pearce,1103,41,1062,124,0,3031100,-71900,3103000,2711441,2023.09.07
36,Burn It Down,Parker Mccollum,1031,143,888,113,0,3003100,309500,2693600,3700191,2023.09.07
37,Glory Days,Gabby Barrett,1367,33,1334,135,0,2804200,168000,2636200,2218425,2023.09.07
38,Out Of That Truck,Carrie Underwood,1066,178,888,131,0,2657400,131200,2526200,1853479,2023.09.07
39,The Painter,Cody Johnson,899,166,733,92,0,2566400,336900,2229500,4820619,2023.09.07
40,Cab In A Solo,Scotty McCreery,930,170,760,102,0,2279300,440400,1838900,639076,2023.09.07
41,Tucson Too Late,Jordan Davis,670,135,535,73,0,1772300,354300,1418000,872222,2023.09.07
42,Drive You Out Of My Mind,Kassi Ashton,763,30,733,80,0,1763800,111900,1651900,1054665,2023.09.07
43,I'M Not Pretty,Megan Moroney,548,68,480,64,0,1732400,231700,1500700,2836757,2023.09.07
44,Giving Up On That,Dalton Dover,834,20,814,89,0,1678700,135000,1543700,805887,2023.09.07
45,Outskirts,Sam Hunt,611,52,559,74,0,1494100,56400,1437700,2871247,2023.09.07
46,Rich Men North Of Richmond,Oliver Anthony Music,400,-137,537,49,0,1487200,-497800,1985000,18952892,2023.09.07
47,Shoot Tequila,Tigirlily Gold,707,46,661,73,0,1407600,111000,1296600,893363,2023.09.07
48,Somebody Else's Whiskey,Frank Ray,709,29,680,71,0,1324700,204800,1119900,138870,2023.09.07
49,Drinkin' Problems,Dillon Carmichael,639,105,534,81,0,1320900,333600,987300,74737,2023.09.07
50,Love You Again,Chase Matthew,558,40,518,53,0,1294800,177400,1117400,2747845,2023.09.07
51,Marry That Girl,Easton Corbin,538,1,537,69,0,1154900,149200,1005700,126925,2023.09.07
52,Bad Day To Be A Cold Beer,Chase Rice,538,-27,565,61,0,1039200,73400,965800,183561,2023.09.07
53,Something's Gonna Kill Me,Corey Kent,456,0,456,60,0,970800,-95000,1065800,2515122,2023.09.07
54,On The Boat Again,Jake Owen,294,-234,528,51,0,828400,-526900,1355300,268980,2023.09.07
55,Something Real,Dierks Bentley,407,50,357,57,0,796100,95600,700500,207741,2023.09.07
56,Wine Country,Hannah Ellis,398,76,322,58,0,784800,148300,636500,95405,2023.09.07
57,Without You,Thompson Square,457,7,450,59,0,727400,17500,709900,13395,2023.09.07
58,Dance With You,Brett Young,419,19,400,68,0,596100,16000,580100,1730296,2023.09.07
59,Brokenhearted,Joe Nichols,327,41,286,56,0,546900,52400,494500,30555,2023.09.07
60,Good With Me,Walker Hayes,225,-357,582,33,0,538700,-1570600,2109300,529511,2023.09.07
61,I Remember Everything,Zach Bryan Feat. Kacey Musgraves,132,98,34,26,0,535400,360600,174800,31803068,2023.09.07
62,Save The Roses,Lee Brice,182,-37,219,27,0,534800,-9000,543800,573173,2023.09.07
63,Spirits And Demons,Michael Ray With Meghan Patrick,285,147,138,42,0,522600,232500,290100,614883,2023.09.07
64,Young Love & Saturday Nights,Chris Young,111,26,85,13,0,472900,64800,408100,555886,2023.09.07
65,Buy A Bar,Tim Dugger,192,-9,201,39,0,472100,-104700,576800,27035,2023.09.07
66,'98 Braves,Morgan Wallen,69,-5,74,4,0,454300,59900,394400,3468755,2023.09.07
67,Ain'T Got A Worry,Old Dominion,41,0,41,1,0,432800,-13500,446300,300052,2023.09.07
68,She Smoked In The House,Brandy Clark,106,,,57,0,414200,,,5773,2023.09.07
69,In Your Love,Tyler Childers,180,12,168,19,0,378100,79700,298400,7062897,2023.09.07
70,One Of Us,Matt Stell,69,34,35,5,0,342600,163400,179200,817769,2023.09.07
71,Hey Driver,Zach Bryan Feat. The War and Treaty,73,72,1,38,0,337900,336300,1600,13587000,2023.09.07
72,Make You Mine,Marynn Taylor,332,19,313,47,0,314300,50500,263800,26100,2023.09.07
73,Find Another Bar,Chris Lane,251,36,215,38,0,311900,-15700,327600,322664,2023.09.07
74,Trouble,Josh Ross,305,10,295,49,0,311300,24600,286700,1435586,2023.09.07
75,Daylight Savings,Kidd G,196,9,187,30,0,295500,-10700,306200,192053,2023.09.07
76,Thicc As Thieves,Lauren Alaina,70,14,56,10,0,232300,27600,204700,1467254,2023.09.07
77,She's Somebody's Daughter,Drew Baldridge,126,,,19,0,204500,,,473763,2023.09.07
78,Cowgirls,Morgan Wallen,38,13,25,4,0,185500,98900,86600,6985870,2023.09.07
79,Pass It On,Ryan Hurd,37,,,37,0,175200,,,24098,2023.09.07
80,Ain'T Missin' You,Dylan Schneider,170,20,150,27,0,173900,15200,158700,748260,2023.09.07
81,We Ride,Bryan Martin,51,3,48,5,0,164000,26300,137700,3405710,2023.09.07
82,Heart To Break,Ryan Griffin,106,-10,116,18,0,162900,15000,147900,241977,2023.09.07
83,How Is She,Cole Swindell,27,2,25,1,0,159200,-13000,172200,70014,2023.09.07
84,Nothing Compares To You,Mickey Guyton,80,9,71,17,0,148300,53900,94400,27,2023.09.07
85,Can't Break Up Now,Old Dominion,29,22,7,2,0,127800,86400,41400,1538475,2023.09.07
86,With You I Am,Cody Johnson,8,2,6,2,0,126900,38800,88100,1361287,2023.09.07
87,Oklahoma Smokeshow,Zach Bryan,39,6,33,2,0,111200,17200,94000,6172676,2023.09.07
88,Ask Me To Dance (Feat. Hayes Carll),Catie Offerman,49,,,48,0,109500,,,31859,2023.09.07
89,On This Piano,Gray Robinson,47,,,47,0,104700,,,310,2023.09.07
90,Ain't That Some,Morgan Wallen,17,-4,21,2,0,97700,36600,61100,5139813,2023.09.07
91,Colorado,Florida Georgia Line,16,4,12,2,0,91300,4700,86600,56837,2023.09.07
92,Where The Wild Things Are,Luke Combs,20,,,4,0,89300,,,1534900,2023.09.07
93,My Bar,Priscilla Block,14,4,10,5,0,87600,31600,56000,169457,2023.09.07
94,The Star-Spangled Banner,Chris Stapleton,13,-3,16,12,0,86300,29400,56900,258484,2023.09.07
95,Fear And Friday's,Zach Bryan,29,16,13,4,0,81900,43300,38600,8014913,2023.09.07
96,Make Me Wanna Smoke,Runaway June,91,34,57,24,0,80200,27800,52400,36536,2023.09.07
97,180 (Lifestyle),Morgan Wallen,7,5,2,2,0,77100,66900,10200,2098436,2023.09.07
98,Used Car,Neal Mccoy,16,,,15,0,77100,,,13301,2023.09.07
99,Mr. Red White And Blue,Coffey Anderson And Drew Jacobs,10,5,5,1,0,70400,29400,41000,75599,2023.09.07
100,Lovin You Gets In The Way,Ben Gallaher,30,-4,34,6,0,67100,-11800,78900,18619,2023.09.07
101,Best Of Me,David Nail,21,-7,28,1,0,66500,-36500,103000,10019,2023.09.07
102,Tulsa,Elle King,28,2,26,2,0,66100,2000,64100,60510,2023.09.07
103,"Jesus, My Mama, My Therapist",Tiera Kennedy,54,30,24,9,0,65200,35600,29600,63329,2023.09.07
104,Try Jesus,Elle King,10,,,10,0,64000,,,31771,2023.09.07
105,Hillbilly Hippie,Lainey Wilson,7,,,6,0,61900,,,137943,2023.09.07
105,Wildflowers And Wild Horses,Lainey Wilson,7,,,6,0,61900,,,246280,2023.09.07
107,Hold My Halo,Lainey Wilson,7,,,6,0,61600,,,425411,2023.09.07
107,Those Boots (Deddy's Song),Lainey Wilson,7,,,6,0,61600,,,142324,2023.09.07
109,Man Made A Bar,Morgan Wallen,10,1,9,2,0,59100,32600,26500,3685861,2023.09.07
110,Heartless,Diplo & Julia Michaels Feat. Morgan Wallen,8,1,7,3,0,53900,19200,34700,5927006,2023.09.07
111,F150-50,Morgan Wallen,5,,,1,0,53100,,,1140720,2023.09.07
112,Somebody's Problem,Morgan Wallen,5,1,4,1,0,51700,34200,17500,3399773,2023.09.07
113,Neon Star (Country Boy Lullaby),Morgan Wallen,6,,,1,0,51700,,,1917785,2023.09.07
114,Paradise To Me,Niko Moon,7,5,2,3,0,49300,44400,4900,559316,2023.09.07
115,Summer To Me,Wayland,76,15,61,19,0,47800,9900,37900,5832,2023.09.07
116,El Dorado,Zach Bryan,9,8,1,2,0,44600,37400,7200,8108328,2023.09.07
117,Out Of Nowhere,Walker Montgomery,11,-1,12,1,0,44600,-7200,51800,9758,2023.09.07
118,Young Man's Blues,Parker Mccollum,5,4,1,2,0,43500,39600,3900,443966,2023.09.07
119,I Hope Heaven,Karissa Ella,72,18,54,18,0,42400,10700,31700,0,2023.09.07
120,Back At The Bar,Landon Parker,71,1,70,18,0,42200,200,42000,7090,2023.09.07
121,Don't Think Jesus,Morgan Wallen,7,2,5,3,0,41600,27200,14400,1347334,2023.09.07
122,Sun To Me,Zach Bryan,21,-7,28,3,0,41100,-22800,63900,5328305,2023.09.07
123,Question The Universe,Teddy Robb,66,-16,82,20,0,41000,-12300,53300,2777,2023.09.07
124,Good Times Roll,Jimmie Allen & Nelly,4,,,1,0,39900,,,328554,2023.09.07
125,The Star-Spangled Banner,Carly Pearce,3,2,1,3,0,36400,30300,6100,0,2023.09.07
126,Runnin' Through That T,Thomas Edwards,4,,,1,0,36400,,,17760,2023.09.07
127,Cover Me Up,Morgan Wallen,6,-3,9,3,0,35000,1400,33600,4656915,2023.09.07
128,I'M Not For Everyone,Brothers Osborne,4,2,2,2,0,34500,19200,15300,484681,2023.09.07
129,Holy Water,Michael Ray,5,-3,8,1,0,33200,-2600,35800,266311,2023.09.07
130,First Rodeo,Daves Highway,56,-16,72,18,0,32200,-9400,41600,378,2023.09.07
131,Under A Southern Sky,Ian Flanigan,51,15,36,17,0,31200,10000,21200,6259,2023.09.07
132,Honey!,Rayne Johnson,53,2,51,18,0,31100,0,31100,29126,2023.09.07
133,Ain'T A Train,Cody Jinks,3,,,2,0,30400,,,168044,2023.09.07
134,Dangerous,Morgan Wallen,13,11,2,13,0,29900,26300,3600,1579348,2023.09.07
135,Saltwater Gospel,Eli Young Band & Jimmy Buffett,16,13,3,13,0,25400,19900,5500,415975,2023.09.07
136,That's Why We Fight,Ella Langley & Koe Wetzel,16,0,16,2,0,25200,-1300,26500,866151,2023.09.07
137,This Side Of The Dirt,Neon Union,25,3,22,5,0,25100,-49300,74400,56979,2023.09.07
138,How I Get High,Josh Kaiser,39,13,26,13,0,24200,8000,16200,0,2023.09.07
139,Other Side Of The Radio,Mike Ryan,4,0,4,1,0,23900,21500,2400,89757,2023.09.07
140,Leave You Alone,Kane Brown,5,0,5,5,0,23600,7700,15900,371035,2023.09.07
141,I Just Killed A Man,Catie Offerman,21,0,21,4,0,23300,1900,21400,99331,2023.09.07
142,Wasting All These Tears,Austin Snell,6,2,4,2,0,21800,14200,7600,733461,2023.09.07
143,"Love, Beer",Andrew Sevener,35,-19,54,18,0,21000,-10100,31100,2142,2023.09.07
144,Downtime,Roman Alexander,34,-37,71,17,0,20800,-20500,41300,28862,2023.09.07
145,Marlboros & Avon,McBride & The Ride,4,,,4,0,20100,,,1124,2023.09.07
146,The Devil Don'T Scare Me,Josh Ward,2,1,1,2,0,19800,18200,1600,41510,2023.09.07
147,865,Morgan Wallen,2,0,2,1,0,19700,9500,10200,2351648,2023.09.07
148,Seven Year Ache,Aaron Watson & Jenna Paulette,3,-1,4,1,0,19400,-9800,29200,0,2023.09.07
149,Dust On The Bottle,Kenny Chesney,1,,,1,0,19200,,,0,2023.09.07
150,Loud and Heavy,Cody Jinks,8,-1,9,2,0,18900,4200,14700,1777023,2023.09.07
151,Hold On To It,Tim McGraw,4,-37,41,4,0,18900,-228500,247400,394154,2023.09.07
152,All Things,Sound,3,1,2,3,0,18600,8400,10200,7262,2023.09.07
153,Star Spangled Banner,Abby Anderson,2,0,2,2,0,18400,3700,14700,0,2023.09.07
154,I Wrote The Book,Morgan Wallen,2,0,2,1,0,18300,8100,10200,4610032,2023.09.07
155,She Gone,Randall King,1,,,1,0,18200,,,10533,2023.09.07
155,T For Texas (With Lyle Lovett),Robert Earl Keen,1,,,1,0,18200,,,1891,2023.09.07
155,Feels Like Country Music,Jon Wolfe,1,,,1,0,18200,,,3360,2023.09.07
155,Everywhere I Need To Be,Hayden Haddock,1,,,1,0,18200,,,1065,2023.09.07
159,Quittin' Time,Morgan Wallen,5,1,4,1,0,17900,8700,9200,1060945,2023.09.07
160,The Great Divide,Luke Combs & Billy Strings,6,0,6,1,0,17800,-4800,22600,254184,2023.09.07
161,Ours,Taylor Swift,4,,,2,0,17200,,,147946,2023.09.07
162,Better Off,Trace Adkins,2,0,2,1,0,16800,0,16800,14864,2023.09.07
163,Giving You Up,Kameron Marlowe,2,0,2,1,0,15900,-900,16800,920437,2023.09.07
164,We Didn't Start The Fire,Fall Out Boy,5,,,5,0,15800,,,2276852,2023.09.07
165,The Good I'Ll Do,Zach Bryan,8,0,8,1,0,15300,-1300,16600,2556788,2023.09.07
166,Heart They Didn'T Break,Maddie & Tae,3,,,2,0,15300,,,383431,2023.09.07
167,I Bet You Think About Me (Taylor's Version) (From The Vault),Taylor Swift Feat. Chris Stapleton,7,,,7,0,15200,,,1141348,2023.09.07
168,Jesus' Fault,Zach Williams Feat. Walker Hayes,1,0,1,1,0,14500,9600,4900,105797,2023.09.07
169,When Will I Be Loved,"Ashley McBryde, Caylee Hammack & Pillbox Patti",6,5,1,6,0,14300,12200,2100,82151,2023.09.07
170,Psychopath,Morgan Wade,14,2,12,1,0,14300,400,13900,1268608,2023.09.07
171,"Salt, Lime & Tequila",Ryan Griffin,6,,,6,0,14300,,,94272,2023.09.07
171,Halfway To Hell,Jelly Roll,6,,,6,0,14300,,,1706174,2023.09.07
173,Cancelled,Randy Houser,12,,,2,0,13700,,,0,2023.09.07
174,Think About There,Greater Vision,3,0,3,3,0,13200,-4500,17700,11166,2023.09.07
175,White House Road,Tyler Childers & The Highwall,7,3,4,2,0,13000,6700,6300,3085248,2023.09.07
176,Short Skirt Weather,Kane Brown,3,2,1,2,0,12900,2800,10100,194277,2023.09.07
177,Ain'T About You,Huntergirl,14,13,1,1,0,12600,7600,5000,14613,2023.09.07
178,Build A Bridge,Ashley Cooke,7,0,7,1,0,12100,400,11700,16883,2023.09.07
179,Wreckage,Nate Smith,6,,,6,0,12100,,,1948488,2023.09.07
180,I'Ve Seen Me Do It,Joe Peters,3,1,2,1,0,12000,1400,10600,359,2023.09.07
181,Take It Slow,Conner Smith,6,,,6,0,11800,,,454867,2023.09.07
182,The Star-Spangled Banner,Eric Church & Jazmine Sullivan,2,,,2,0,11700,,,0,2023.09.07
183,Pain Killer,Warren Zeiders,2,,,2,0,11600,,,537064,2023.09.07
184,You'Re Gonna Love Me,Tim Dugger,3,0,3,1,0,11000,-8100,19100,7627,2023.09.07
185,"1, 2 Many",Luke Combs & Brooks & Dunn,7,6,1,7,0,10900,9600,1300,1406261,2023.09.07
186,Run It Back,Blane Howard,2,1,1,1,0,10800,6200,4600,10828,2023.09.07
187,Nothin' On You,Cody Johnson,2,,,1,0,10700,,,1122034,2023.09.07
188,Decoration,Jillian Riscoe,4,1,3,1,0,10600,4900,5700,6,2023.09.07
189,Star Spangled Banner,Mickey Guyton,3,2,1,3,0,10200,7800,2400,0,2023.09.07
190,Once And For All,Gold City,2,1,1,2,0,10200,5300,4900,12044,2023.09.07
191,Turn Your Back,Justified Quartet,2,1,1,2,0,10200,4900,5300,118,2023.09.07
192,Love Is Real,Morgan Evans,7,2,5,2,0,10100,-5400,15500,58588,2023.09.07
193,Star Spangled Banner,Demi Lovato,1,0,1,1,0,9400,0,9400,105,2023.09.07
194,Crazy One More Time (2022),Kip Moore,1,,,1,0,9200,,,11127,2023.09.07
195,I Can'T Breathe,Parker Mccollum,2,-1,3,1,0,9000,3300,5700,1191491,2023.09.07
196,I've Got To Get Sober,Oliver Anthony,10,-2,12,1,0,8800,-6600,15400,0,2023.09.07
197,Tough Crowd,Jason Aldean,5,2,3,1,0,8700,6000,2700,912204,2023.09.07
198,Forward,Niia,1,0,1,1,0,8700,0,8700,264,2023.09.07
199,Whiskey Train,Jameson Rodgers,2,,,1,0,8700,,,428161,2023.09.07
200,Broadway Girls,Lil Durk Feat. Morgan Wallen,1,-3,4,1,0,8400,-17100,25500,5462552,2023.09.07
201,Ticking,Zach Bryan,3,,,3,0,8400,,,7620404,2023.09.07
202,Give It To Jesus,3 Heath Brothers,1,,,1,0,8400,,,702,2023.09.07
202,My Feet Are On The Rock,Gaither Vocal Band,1,,,1,0,8400,,,1290,2023.09.07
202,I Saw The Light,Josh Turner,1,,,1,0,8400,,,89208,2023.09.07
202,I'Ll Fly Away,Randall King,1,,,1,0,8400,,,34074,2023.09.07
202,Leavin' On My Mind,Kim Hopper,1,,,1,0,8400,,,174,2023.09.07
1,Angels,Thomas Rhett,7447,998,6449,144,0,27465200,3390800,24074400,2105835,2023.09.14
2,Religiously,Bailey Zimmerman,6626,415,6211,144,0,24528500,1955000,22573500,12818164,2023.09.14
3,Watermelon Moonshine,Lainey Wilson,6544,641,5903,144,0,23946800,2098200,21848600,6933897,2023.09.14
4,Bury Me In Georgia,Kane Brown,6383,-1464,7847,144,0,23871100,-5391200,29262300,5314712,2023.09.14
5,Last Night,Morgan Wallen,5351,-169,5520,143,0,23800100,-1068600,24868700,22173922,2023.09.14
6,Try That In A Small Town,Jason Aldean,6392,477,5915,143,0,23671300,1963300,21708000,8102945,2023.09.14
7,Love You Anyway,Luke Combs,5500,-1712,7212,143,0,22398000,-6094200,28492200,6687767,2023.09.14
8,Girl In Mine,Parmalee,5850,139,5711,143,0,21666200,559500,21106700,1787011,2023.09.14
9,God Gave Me A Girl,Russell Dickerson,4895,400,4495,144,0,18875500,1124300,17751200,1441398,2023.09.14
10,Everything I Love,Morgan Wallen,4511,396,4115,144,0,17144800,1361600,15783200,3905555,2023.09.14
11,Stars Like Confetti,Dustin Lynch,4497,279,4218,142,0,17092500,1679300,15413200,1612824,2023.09.14
12,Thinkin' Bout Me,Morgan Wallen,4082,782,3300,142,0,16194100,3452000,12742100,12005511,2023.09.14
13,Standing Room Only,Tim McGraw,4421,282,4139,144,0,15501600,777800,14723800,2665152,2023.09.14
14,But I Got A Beer In My Hand,Luke Bryan,4081,112,3969,144,0,14986300,302200,14684100,2271715,2023.09.14
15,Can'T Have Mine,Dylan Scott,3858,271,3587,144,0,13854000,1418900,12435100,2426911,2023.09.14
16,Save Me The Trouble,Dan + Shay,3164,128,3036,144,0,10403000,472900,9930100,1938716,2023.09.14
17,If You Go Down (I'M Going Down Too),Kelsea Ballerini,3311,15,3296,144,0,9894100,297300,9596800,1718660,2023.09.14
18,Mind On You,George Birge,2958,366,2592,142,0,9624200,1137200,8487000,242702,2023.09.14
19,All I Need Is You,Chris Janson,2889,47,2842,142,0,8637700,368100,8269600,1006253,2023.09.14
20,White Horse,Chris Stapleton,2161,353,1808,142,0,7440400,1702200,5738200,6599003,2023.09.14
21,Light On In The Kitchen,Ashley McBryde,2573,204,2369,143,0,7250000,592500,6657500,2180358,2023.09.14
22,We Got History,Mitchell Tenpenny,2437,178,2259,142,0,7150900,804000,6346900,1356075,2023.09.14
23,Different 'Round Here,Riley Green,2178,127,2051,138,0,6249500,206400,6043100,2267033,2023.09.14
24,23,Chayce Beckham,2119,71,2048,143,0,6163500,544600,5618900,2951222,2023.09.14
25,Creek Will Rise,Conner Smith,2332,198,2134,144,0,6013000,789200,5223800,1111945,2023.09.14
26,World On Fire,Nate Smith,2007,210,1797,135,0,5992600,811600,5181000,3088305,2023.09.14
27,Nobody's Nobody,Brothers Osborne,2028,67,1961,140,0,5397600,476000,4921600,1756636,2023.09.14
28,Save Me,Jelly Roll & Lainey Wilson,1349,518,831,128,0,5019100,1892200,3126900,8566366,2023.09.14
29,Back Then Right Now,Tyler Hubbard,1080,1079,1,108,0,4902100,4901200,900,1842382,2023.09.14
30,Pretty Little Poison,Warren Zeiders,1477,107,1370,116,0,4633800,175900,4457900,5318117,2023.09.14
31,Fearless,Jackson Dean,1640,-75,1715,142,0,4124600,119100,4005500,1140813,2023.09.14
32,See You Next Summer,Brian Kelley,1526,119,1407,138,0,3887300,351000,3536300,747686,2023.09.14
33,Burn It Down,Parker Mccollum,1262,231,1031,122,0,3538300,535200,3003100,3788583,2023.09.14
34,Truck Bed,Hardy,1425,145,1280,130,0,3360500,257600,3102900,6553547,2023.09.14
35,The Painter,Cody Johnson,1036,137,899,96,0,3194900,628500,2566400,4578673,2023.09.14
36,We Don'T Fight Anymore,Carly Pearce,1183,80,1103,135,0,3060500,29400,3031100,2732669,2023.09.14
37,Out Of That Truck,Carrie Underwood,1239,173,1066,131,0,2977000,319600,2657400,1514083,2023.09.14
38,Glory Days,Gabby Barrett,1354,-13,1367,137,0,2767400,-36800,2804200,2215191,2023.09.14
39,Cab In A Solo,Scotty McCreery,1064,134,930,116,0,2455700,176400,2279300,686413,2023.09.14
40,Tucson Too Late,Jordan Davis,762,92,670,76,0,1966500,194200,1772300,1057422,2023.09.14
41,Rich Men North Of Richmond,Oliver Anthony Music,529,129,400,49,0,1965400,478200,1487200,15869670,2023.09.14
42,I'M Not Pretty,Megan Moroney,663,115,548,67,0,1876700,144300,1732400,2638918,2023.09.14
43,Giving Up On That,Dalton Dover,918,84,834,89,0,1867000,188300,1678700,816113,2023.09.14
44,Drive You Out Of My Mind,Kassi Ashton,782,19,763,81,0,1801300,37500,1763800,809505,2023.09.14
45,I Remember Everything,Zach Bryan Feat. Kacey Musgraves,524,392,132,46,0,1798200,1262800,535400,30250571,2023.09.14
46,Outskirts,Sam Hunt,670,59,611,74,0,1689700,195600,1494100,3012172,2023.09.14
47,Shoot Tequila,Tigirlily Gold,707,0,707,73,0,1383400,-24200,1407600,818837,2023.09.14
48,Drinkin' Problems,Dillon Carmichael,650,11,639,84,0,1298700,-22200,1320900,71964,2023.09.14
49,Somebody Else's Whiskey,Frank Ray,692,-17,709,75,0,1263500,-61200,1324700,132879,2023.09.14
50,Love You Again,Chase Matthew,574,16,558,54,0,1260600,-34200,1294800,2385545,2023.09.14
51,Something's Gonna Kill Me,Corey Kent,516,60,456,63,0,1123900,153100,970800,2365311,2023.09.14
52,Marry That Girl,Easton Corbin,529,-9,538,68,0,1045700,-109200,1154900,124279,2023.09.14
53,Something Real,Dierks Bentley,436,29,407,56,0,896300,100200,796100,205000,2023.09.14
54,Wine Country,Hannah Ellis,404,6,398,53,0,844700,59900,784800,114392,2023.09.14
55,Young Love & Saturday Nights,Chris Young,189,78,111,18,0,779700,306800,472900,573498,2023.09.14
56,Without You,Thompson Square,472,15,457,58,0,695700,-31700,727400,13792,2023.09.14
57,Dance With You,Brett Young,429,10,419,70,0,631200,35100,596100,1571981,2023.09.14
58,Good With Me,Walker Hayes,237,12,225,31,0,602500,63800,538700,549356,2023.09.14
59,Spirits And Demons,Michael Ray With Meghan Patrick,398,113,285,60,0,585700,63100,522600,615596,2023.09.14
60,Brokenhearted,Joe Nichols,329,2,327,58,0,542900,-4000,546900,26272,2023.09.14
61,Bad Day To Be A Cold Beer,Chase Rice,283,-255,538,49,0,517700,-521500,1039200,165382,2023.09.14
62,Buy A Bar,Tim Dugger,195,3,192,44,0,484500,12400,472100,22713,2023.09.14
63,In Your Love,Tyler Childers,204,24,180,24,0,471300,93200,378100,8026577,2023.09.14
64,Sad In The Summer,Diplo & Lily Rose,120,,,56,0,445000,,,334715,2023.09.14
65,Save The Roses,Lee Brice,130,-52,182,9,0,444300,-90500,534800,556577,2023.09.14
66,Ain'T Got A Worry,Old Dominion,40,-1,41,1,0,430800,-2000,432800,315310,2023.09.14
67,'98 Braves,Morgan Wallen,68,-1,69,3,0,414600,-39700,454300,3413506,2023.09.14
68,Find Another Bar,Chris Lane,278,27,251,42,0,351800,39900,311900,344553,2023.09.14
69,All About That Bass,Meghan Trainor,73,,,37,0,348400,,,1044032,2023.09.14
70,Trouble,Josh Ross,312,7,305,49,0,325600,14300,311300,1401995,2023.09.14
71,Make You Mine,Marynn Taylor,423,91,332,63,0,323200,8900,314300,39617,2023.09.14
72,Where The Wild Things Are,Luke Combs,45,25,20,4,0,310400,221100,89300,1497871,2023.09.14
73,Chipping Mill,Turnpike Troubadours,57,,,56,0,304700,,,563251,2023.09.14
74,Can't Break Up Now,Old Dominion,52,23,29,13,0,286700,158900,127800,1602746,2023.09.14
75,Daylight Savings,Kidd G,216,20,196,30,0,279500,-16000,295500,200444,2023.09.14
76,She's Somebody's Daughter,Drew Baldridge,155,29,126,22,0,241900,37400,204500,456117,2023.09.14
77,Thicc As Thieves,Lauren Alaina,85,15,70,12,0,230600,-1700,232300,1195889,2023.09.14
78,One Of Us,Matt Stell,44,-25,69,5,0,226000,-116600,342600,816926,2023.09.14
79,We Ride,Bryan Martin,56,5,51,7,0,213800,49800,164000,3661764,2023.09.14
80,On The Boat Again,Jake Owen,68,-226,294,14,0,198200,-630200,828400,183899,2023.09.14
81,Coldest Beer In Town,Ashley McBryde,46,,,45,0,194700,,,160801,2023.09.14
82,Ain'T Missin' You,Dylan Schneider,173,3,170,26,0,183800,9900,173900,658970,2023.09.14
83,Wolfman Of The Ozarks,Old Crow Medicine Show,33,,,33,0,182100,,,7567,2023.09.14
84,Women Ain't Whiskey,Ashley McBryde,37,,,37,0,175200,,,0,2023.09.14
85,How Is She,Cole Swindell,24,-3,27,1,0,160100,900,159200,65931,2023.09.14
86,Nothing Compares To You,Mickey Guyton,92,12,80,17,0,143200,-5100,148300,555,2023.09.14
87,Man Made A Bar,Morgan Wallen,26,16,10,2,0,137300,78200,59100,3460586,2023.09.14
88,Heart To Break,Ryan Griffin,84,-22,106,12,0,126900,-36000,162900,185398,2023.09.14
89,Oklahoma Smokeshow,Zach Bryan,36,-3,39,2,0,120400,9200,111200,6151525,2023.09.14
90,Cowgirls,Morgan Wallen,30,-8,38,2,0,107800,-77700,185500,6670321,2023.09.14
91,Fear And Friday's,Zach Bryan,41,12,29,5,0,106100,24200,81900,6291322,2023.09.14
92,Colorado,Florida Georgia Line,16,0,16,2,0,103400,12100,91300,55495,2023.09.14
93,Runaways,Danielle Bradbery,47,,,47,0,101500,,,119118,2023.09.14
94,The Star-Spangled Banner,Chris Stapleton,20,7,13,18,0,96100,9800,86300,199357,2023.09.14
95,Ask Me To Dance (Feat. Hayes Carll),Catie Offerman,46,-3,49,46,0,93400,-16100,109500,31985,2023.09.14
96,Cancelled,Randy Houser,32,20,12,7,0,93000,79300,13700,0,2023.09.14
97,Dead Man Walking,Jelly Roll,48,,,48,0,92000,,,662027,2023.09.14
97,She,Jelly Roll,48,,,48,0,92000,,,1582570,2023.09.14
99,My Bar,Priscilla Block,16,2,14,7,0,88900,1300,87600,165799,2023.09.14
100,With You I Am,Cody Johnson,6,-2,8,2,0,87200,-39700,126900,1475376,2023.09.14
101,Shot In The Dark,Ashley Cooke,17,,,16,0,80700,,,28367,2023.09.14
102,Make Me Wanna Smoke,Runaway June,101,10,91,18,0,77900,-2300,80200,46371,2023.09.14
103,Best Of Me,David Nail,20,-1,21,1,0,75100,8600,66500,8705,2023.09.14
104,This Side Of The Dirt,Neon Union,56,31,25,6,0,70900,45800,25100,60758,2023.09.14
105,Tulsa,Elle King,28,0,28,2,0,70800,4700,66100,64454,2023.09.14
106,"Jesus, My Mama, My Therapist",Tiera Kennedy,57,3,54,10,0,65700,500,65200,70584,2023.09.14
107,World On Fire,Dolly Parton,9,,,9,0,61200,,,126730,2023.09.14
108,Let It Be,Dolly Parton,9,,,9,0,60600,,,67443,2023.09.14
109,Lovin You Gets In The Way,Ben Gallaher,34,4,30,5,0,58200,-8900,67100,18652,2023.09.14
110,El Dorado,Zach Bryan,8,-1,9,2,0,49900,5300,44600,6367088,2023.09.14
111,Star Spangled Banner,Abby Anderson,8,6,2,6,0,45700,27300,18400,0,2023.09.14
112,Out Of Nowhere,Walker Montgomery,12,1,11,1,0,44600,0,44600,9688,2023.09.14
113,Honey!,Rayne Johnson,71,18,53,18,0,42100,11000,31100,26782,2023.09.14
114,Holy Water,Michael Ray,9,4,5,3,0,36200,3000,33200,262616,2023.09.14
115,Ain't That Some,Morgan Wallen,14,-3,17,2,0,36000,-61700,97700,4741513,2023.09.14
116,Back At The Bar,Landon Parker,55,-16,71,18,0,31900,-10300,42200,6925,2023.09.14
117,First Rodeo,Daves Highway,54,-2,56,18,0,31800,-400,32200,351,2023.09.14
118,Summer To Me,Wayland,54,-22,76,18,0,31800,-16000,47800,5125,2023.09.14
119,Downtime,Roman Alexander,53,19,34,18,0,31600,10800,20800,21541,2023.09.14
120,Under A Southern Sky,Ian Flanigan,52,1,51,18,0,31500,300,31200,6599,2023.09.14
121,Tea Was A Little Sweeter,Matt Rogers,52,,,18,0,31200,,,0,2023.09.14
122,Oklahoma Sooner,Jake Banfield,9,,,1,0,31000,,,59037,2023.09.14
123,Loser,Mike Ryan,5,2,3,2,0,29800,24100,5700,10913,2023.09.14
124,If She Wants A Cowboy,Zach Bryan,4,,,1,0,28400,,,625458,2023.09.14
125,Sun To Me,Zach Bryan,13,-8,21,2,0,27700,-13400,41100,5147564,2023.09.14
126,Georgia Girl,Megan Moroney,4,,,1,0,27500,,,90136,2023.09.14
127,I Just Killed A Man,Catie Offerman,25,4,21,4,0,27200,3900,23300,108383,2023.09.14
128,That's Why We Fight,Ella Langley & Koe Wetzel,16,0,16,1,0,27000,1800,25200,932870,2023.09.14
129,Giving You Up,Kameron Marlowe,4,2,2,1,0,25600,9700,15900,928981,2023.09.14
130,Tuggin' On My Heartstrings,Randall King,4,0,4,1,0,23900,17600,6300,24746,2023.09.14
131,Quittin' Time,Morgan Wallen,8,3,5,1,0,23200,5300,17900,991505,2023.09.14
132,Star Spangled Banner,Maren Morris,2,1,1,2,0,22700,18500,4200,0,2023.09.14
133,Sad Boy,Twinnie,39,,,17,0,22400,,,960,2023.09.14
134,National Anthem From Battle At Bristol,Jennifer Nettles,5,,,5,0,21900,,,0,2023.09.14
135,Question The Universe,Teddy Robb,31,-35,66,20,0,21800,-19200,41000,2659,2023.09.14
136,I Hope Heaven,Karissa Ella,35,-37,72,17,0,21500,-20900,42400,0,2023.09.14
137,Neon You,Don Louis,4,2,2,2,0,19800,14700,5100,72070,2023.09.14
138,Tourniquet,Zach Bryan,8,4,4,1,0,19100,12700,6400,9995111,2023.09.14
139,Ain'T About You,Huntergirl,16,2,14,1,0,19000,6400,12600,10867,2023.09.14
140,Better By The Beer,Jake Bush,1,,,1,0,18200,,,1391,2023.09.14
140,Can Down,Mike Ryan,1,,,1,0,18200,,,29889,2023.09.14
140,Boots On A Dance Floor,Jon Wolfe,1,,,1,0,18200,,,72569,2023.09.14
140,Real Damn Good,Josh Abbott Band,1,,,1,0,18200,,,22588,2023.09.14
140,Like A Cowboy,Parker Mccollum,1,,,1,0,18200,,,473248,2023.09.14
140,Four Minutes,Chad Cooke Band,1,,,1,0,18200,,,2024,2023.09.14
146,Heart They Didn'T Break,Maddie & Tae,10,7,3,3,0,17900,2600,15300,867901,2023.09.14
147,Star Spangled Banner,Mickey Guyton,3,0,3,3,0,17300,7100,10200,0,2023.09.14
148,Outlaw,Morgan Wallen Feat. Ben Burgess,10,3,7,1,0,17200,9600,7600,480673,2023.09.14
149,I Can'T Breathe,Parker Mccollum,2,0,2,1,0,17200,8200,9000,1221552,2023.09.14
150,Wild as You,Cody Johnson,3,1,2,3,0,17000,11600,5400,1377604,2023.09.14
151,Heartless,Diplo & Julia Michaels Feat. Morgan Wallen,2,-6,8,1,0,16800,-37100,53900,5642838,2023.09.14
152,Heart Of A Small Town,Tim Dugger,2,,,1,0,16800,,,14801,2023.09.14
153,Mr. Red White And Blue,Coffey Anderson And Drew Jacobs,2,-8,10,1,0,16400,-54000,70400,82230,2023.09.14
154,Still,Luke Combs,6,3,3,1,0,16000,12700,3300,369486,2023.09.14
155,Scars In Heaven,Casting Crowns,2,,,1,0,15900,,,428974,2023.09.14
156,Whiskey's Fine,Adam Doleac,2,,,1,0,15400,,,31050,2023.09.14
157,Any Given Friday Night,Luke Combs,2,1,1,1,0,15200,7600,7600,258830,2023.09.14
158,The Star Spangled Banner,Brad Paisley,3,1,2,3,0,15100,9900,5200,0,2023.09.14
159,Broadway Girls,Lil Durk Feat. Morgan Wallen,3,2,1,1,0,14800,6400,8400,5127928,2023.09.14
160,Used Car,Neal Mccoy,7,-9,16,1,0,14700,-62400,77100,6726,2023.09.14
161,When Will I Be Loved,"Ashley McBryde, Caylee Hammack & Pillbox Patti",6,0,6,6,0,14300,0,14300,52542,2023.09.14
162,Get Lost,Lucas Hoge,6,,,6,0,14300,,,778,2023.09.14
162,Most Nights,Kat & Alex,6,,,6,0,14300,,,2136,2023.09.14
162,Polaroid,Keith Urban,6,,,6,0,14300,,,14005,2023.09.14
162,Stop Coming Over,Chris Lane,6,,,6,0,14300,,,38755,2023.09.14
166,Better Off,Trace Adkins,4,2,2,1,0,14200,-2600,16800,14871,2023.09.14
167,The Great Divide,Luke Combs & Billy Strings,4,-2,6,1,0,14200,-3600,17800,294802,2023.09.14
168,Spotless,Zach Bryan,2,,,1,0,14200,,,8844161,2023.09.14
169,Soundtrack To A Small Town Sundown,Tyler Farr,3,1,2,1,0,13900,11300,2600,8862,2023.09.14
170,Loud and Heavy,Cody Jinks,10,2,8,2,0,13500,-5400,18900,1793432,2023.09.14
171,Psychopath,Morgan Wade,11,-3,14,1,0,13500,-800,14300,1105027,2023.09.14
172,"Burn, Burn, Burn",Zach Bryan,2,,,1,0,13400,,,4840220,2023.09.14
173,Love Is Real,Morgan Evans,5,-2,7,1,0,13300,3200,10100,58145,2023.09.14
174,One Name,Jeff & Sheri Easter,2,,,2,0,13300,,,11733,2023.09.14
175,Cover Me Up,Morgan Wallen,5,-1,6,3,0,13100,-21900,35000,4416915,2023.09.14
176,I Think I'm In Love With You,Chris Stapleton,2,,,2,0,13100,,,3995229,2023.09.14
177,Kiss That Girl Goodbye,Aaron Watson,3,2,1,2,0,12900,6800,6100,14567,2023.09.14
178,When It Comes To Loving You,Jon Langston,3,1,2,1,0,12900,6500,6400,101743,2023.09.14
179,The Weight Of The Badge,George Strait,1,0,1,1,0,12900,6800,6100,56636,2023.09.14
180,Paradise To Me,Niko Moon,5,-2,7,2,0,12800,-36500,49300,481315,2023.09.14
181,Oklahoman Son,Zach Bryan,8,,,1,0,12800,,,4179193,2023.09.14
182,The Star-Spangled Banner,Carly Pearce,3,0,3,2,0,12700,-23700,36400,0,2023.09.14
183,Think About There,Greater Vision,2,-1,3,2,0,12400,-800,13200,11849,2023.09.14
184,Braggin' On Jesus,Steeles,2,,,2,0,12400,,,1460,2023.09.14
185,National Anthem,Pryor & Lee,3,,,3,0,12200,,,0,2023.09.14
186,When My Baby's In Boots,Randall King,2,-2,4,2,0,11800,5500,6300,0,2023.09.14
187,Runnin' Through That T,Thomas Edwards,1,-3,4,1,0,11700,-24700,36400,15687,2023.09.14
188,Star Spangled Banner,Demi Lovato,2,1,1,2,0,10900,1500,9400,133,2023.09.14
189,"Love, Beer",Andrew Sevener,19,-16,35,18,0,10800,-10200,21000,2038,2023.09.14
190,Things I Take For Granted,Larry Fleet,1,,,1,0,10600,,,419614,2023.09.14
191,Superpower,Caroline Jones,2,,,2,0,10500,,,1080,2023.09.14
192,All Things,Sound,2,-1,3,2,0,10200,-8400,18600,9272,2023.09.14
193,A Song Was Born,Luke Combs,2,,,2,0,10200,,,198468,2023.09.14
194,I'M Not For Everyone,Brothers Osborne,1,-3,4,1,0,10100,-24400,34500,510408,2023.09.14
195,I'll Be Here,Colbie Caillat,5,,,1,0,10000,,,1131028,2023.09.14
196,Tattoo On A Sunburn,Luke Combs,1,,,1,0,9500,,,336734,2023.09.14
197,House Fire,Tyler Childers,2,1,1,1,0,9400,8100,1300,1185208,2023.09.14
198,Detours,Jordan Davis,1,,,1,0,9200,,,102392,2023.09.14
199,Tough Crowd,Jason Aldean,4,-1,5,2,0,9100,400,8700,487909,2023.09.14
200,BELLS,Rachelle Garniez,1,,,1,0,8700,,,0,2023.09.14
1,Religiously,Bailey Zimmerman,7684,1058,6626,144,0,28388100,3859600,24528500,13192618,2023.09.21
2,Watermelon Moonshine,Lainey Wilson,6849,305,6544,144,0,25972500,2025700,23946800,7042892,2023.09.21
3,Try That In A Small Town,Jason Aldean,6599,207,6392,144,0,25043600,1372300,23671300,7531836,2023.09.21
4,Girl In Mine,Parmalee,6014,164,5850,143,0,22823700,1157500,21666200,1899822,2023.09.21
5,Last Night,Morgan Wallen,5168,-183,5351,143,0,22394300,-1405800,23800100,21483428,2023.09.21
6,God Gave Me A Girl,Russell Dickerson,5422,527,4895,144,0,20424600,1549100,18875500,1376730,2023.09.21
7,Angels,Thomas Rhett,5421,-2026,7447,144,0,20410900,-7054300,27465200,2176756,2023.09.21
8,Stars Like Confetti,Dustin Lynch,4889,392,4497,142,0,19097100,2004600,17092500,1333363,2023.09.21
9,Thinkin' Bout Me,Morgan Wallen,4749,667,4082,142,0,18985700,2791600,16194100,12312548,2023.09.21
10,Everything I Love,Morgan Wallen,4663,152,4511,144,0,17453200,308400,17144800,3762094,2023.09.21
11,Standing Room Only,Tim McGraw,4709,288,4421,144,0,17040000,1538400,15501600,2576441,2023.09.21
12,But I Got A Beer In My Hand,Luke Bryan,4183,102,4081,144,0,15523000,536700,14986300,2424936,2023.09.21
13,Can'T Have Mine,Dylan Scott,4179,321,3858,144,0,14945600,1091600,13854000,2445724,2023.09.21
14,Save Me The Trouble,Dan + Shay,3458,294,3164,144,0,11965200,1562200,10403000,3163066,2023.09.21
15,Mind On You,George Birge,3142,184,2958,142,0,10452100,827900,9624200,308525,2023.09.21
16,If You Go Down (I'M Going Down Too),Kelsea Ballerini,3395,84,3311,143,0,10385300,491200,9894100,1347835,2023.09.21
17,All I Need Is You,Chris Janson,3218,329,2889,143,0,10045800,1408100,8637700,1047238,2023.09.21
18,White Horse,Chris Stapleton,2466,305,2161,142,0,8099000,658600,7440400,6821251,2023.09.21
19,We Got History,Mitchell Tenpenny,2571,134,2437,141,0,7858700,707800,7150900,1390895,2023.09.21
20,Light On In The Kitchen,Ashley McBryde,2611,38,2573,143,0,7117400,-132600,7250000,1518025,2023.09.21
21,23,Chayce Beckham,2350,231,2119,141,0,7027900,864400,6163500,2997755,2023.09.21
22,Different 'Round Here,Riley Green,2394,216,2178,140,0,6890100,640600,6249500,2161502,2023.09.21
23,World On Fire,Nate Smith,2261,254,2007,135,0,6835500,842900,5992600,3315061,2023.09.21
24,Save Me,Jelly Roll & Lainey Wilson,1655,306,1349,120,0,6791900,1772800,5019100,8541758,2023.09.21
25,Creek Will Rise,Conner Smith,2428,96,2332,144,0,6624000,611000,6013000,1056506,2023.09.21
26,Nobody's Nobody,Brothers Osborne,2134,106,2028,144,0,5774600,377000,5397600,1997821,2023.09.21
27,Pretty Little Poison,Warren Zeiders,1761,284,1477,132,0,5329300,695500,4633800,5061868,2023.09.21
28,Fearless,Jackson Dean,1660,20,1640,141,0,4235700,111100,4124600,1272408,2023.09.21
29,See You Next Summer,Brian Kelley,1576,50,1526,138,0,4118300,231000,3887300,702538,2023.09.21
30,Truck Bed,Hardy,1522,97,1425,132,0,3962600,602100,3360500,6429046,2023.09.21
31,The Painter,Cody Johnson,1154,118,1036,105,0,3697200,502300,3194900,4227013,2023.09.21
32,Burn It Down,Parker Mccollum,1366,104,1262,130,0,3689000,150700,3538300,2984276,2023.09.21
33,We Don'T Fight Anymore,Carly Pearce,1241,58,1183,134,0,3337200,276700,3060500,2583196,2023.09.21
34,I Remember Everything,Zach Bryan Feat. Kacey Musgraves,893,369,524,57,0,3190100,1391900,1798200,28498676,2023.09.21
35,Glory Days,Gabby Barrett,1357,3,1354,139,0,2907300,139900,2767400,1682145,2023.09.21
36,Out Of That Truck,Carrie Underwood,1225,-14,1239,125,0,2901300,-75700,2977000,1652339,2023.09.21
37,Cab In A Solo,Scotty McCreery,1145,81,1064,121,0,2882300,426600,2455700,705496,2023.09.21
38,Rich Men North Of Richmond,Oliver Anthony Music,677,148,529,42,0,2336400,371000,1965400,14329802,2023.09.21
39,Tucson Too Late,Jordan Davis,758,-4,762,80,0,2091400,124900,1966500,927599,2023.09.21
40,I'M Not Pretty,Megan Moroney,718,55,663,81,0,2089200,212500,1876700,2733517,2023.09.21
41,Giving Up On That,Dalton Dover,907,-11,918,93,0,2043800,176800,1867000,1098315,2023.09.21
42,Back Then Right Now,Tyler Hubbard,740,-340,1080,84,0,1986100,-2916000,4902100,1177914,2023.09.21
43,Drive You Out Of My Mind,Kassi Ashton,803,21,782,86,0,1841600,40300,1801300,882407,2023.09.21
44,Outskirts,Sam Hunt,685,15,670,74,0,1795800,106100,1689700,3344682,2023.09.21
45,Shoot Tequila,Tigirlily Gold,939,232,707,104,0,1683600,300200,1383400,822198,2023.09.21
46,Love You Again,Chase Matthew,638,64,574,55,0,1511400,250800,1260600,2370627,2023.09.21
47,Somebody Else's Whiskey,Frank Ray,766,74,692,80,0,1329700,66200,1263500,167975,2023.09.21
48,Drinkin' Problems,Dillon Carmichael,696,46,650,86,0,1264800,-33900,1298700,75885,2023.09.21
49,Marry That Girl,Easton Corbin,553,24,529,68,0,1060000,14300,1045700,125678,2023.09.21
50,Something's Gonna Kill Me,Corey Kent,522,6,516,64,0,1055600,-68300,1123900,2254679,2023.09.21
51,I Can Feel It,Kane Brown,158,,,50,0,1029500,,,202705,2023.09.21
52,Something Real,Dierks Bentley,460,24,436,63,0,986000,89700,896300,308826,2023.09.21
53,Wine Country,Hannah Ellis,422,18,404,58,0,931700,87000,844700,81230,2023.09.21
54,Young Love & Saturday Nights,Chris Young,227,38,189,18,0,921600,141900,779700,497694,2023.09.21
55,Spirits And Demons,Michael Ray With Meghan Patrick,432,34,398,61,0,725400,139700,585700,648651,2023.09.21
56,Good With Me,Walker Hayes,265,28,237,45,0,700700,98200,602500,561970,2023.09.21
57,Dance With You,Brett Young,461,32,429,73,0,688800,57600,631200,1756515,2023.09.21
58,Without You,Thompson Square,451,-21,472,60,0,628300,-67400,695700,16890,2023.09.21
59,In Your Love,Tyler Childers,272,68,204,38,0,598400,127100,471300,6564133,2023.09.21
60,Can't Break Up Now,Old Dominion,155,103,52,44,0,540300,253600,286700,1573660,2023.09.21
61,Brokenhearted,Joe Nichols,337,8,329,57,0,516700,-26200,542900,39245,2023.09.21
62,Where The Wild Things Are,Luke Combs,80,35,45,3,0,511700,201300,310400,1415046,2023.09.21
63,Ain'T Got A Worry,Old Dominion,43,3,40,1,0,452400,21600,430800,335184,2023.09.21
64,Make You Mine,Marynn Taylor,439,16,423,68,0,386000,62800,323200,41775,2023.09.21
65,Buy A Bar,Tim Dugger,146,-49,195,32,0,378500,-106000,484500,24308,2023.09.21
66,'98 Braves,Morgan Wallen,63,-5,68,3,0,378200,-36400,414600,3064655,2023.09.21
67,Thicc As Thieves,Lauren Alaina,159,74,85,26,0,364300,133700,230600,1080464,2023.09.21
68,Find Another Bar,Chris Lane,303,25,278,52,0,357000,5200,351800,378358,2023.09.21
69,Dreams,NEEDTOBREATHE,74,,,37,0,350400,,,547977,2023.09.21
69,Shape Of You,Ed Sheeran,74,,,37,0,350400,,,4048396,2023.09.21
71,West Texas Wind,NEEDTOBREATHE,71,,,37,0,333600,,,33885,2023.09.21
72,We Should Get Married,Dan + Shay,55,,,53,0,327900,,,505596,2023.09.21
73,She's Somebody's Daughter,Drew Baldridge,216,61,155,43,0,319700,77800,241900,460515,2023.09.21
74,Save The Roses,Lee Brice,87,-43,130,8,0,305400,-138900,444300,592325,2023.09.21
75,Breakin' Up With A Broken Heart,Dan + Shay,45,,,44,0,304600,,,0,2023.09.21
76,Bigger Houses,Dan + Shay,52,,,51,0,300100,,,579903,2023.09.21
77,Trouble,Josh Ross,315,3,312,48,0,299900,-25700,325600,1423020,2023.09.21
78,Hey There Hometown,Abby Leigh Anderson,74,,,37,0,278000,,,9098,2023.09.21
79,Daylight Savings,Kidd G,204,-12,216,30,0,262700,-16800,279500,170197,2023.09.21
80,We Ride,Bryan Martin,116,60,56,19,0,248700,34900,213800,3634289,2023.09.21
81,Who Says You Can'T Have Everything,Brothers Osborne,48,,,47,0,201800,,,1067083,2023.09.21
82,Nothing Compares To You,Mickey Guyton,99,7,92,19,0,200800,57600,143200,866,2023.09.21
83,Ain'T Missin' You,Dylan Schneider,181,8,173,29,0,194800,11000,183800,850329,2023.09.21
84,Man Made A Bar,Morgan Wallen,38,12,26,4,0,190300,53000,137300,3373458,2023.09.21
85,Cancelled,Randy Houser,88,56,32,13,0,189000,96000,93000,0,2023.09.21
86,One Of Us,Matt Stell,44,0,44,3,0,187500,-38500,226000,814721,2023.09.21
87,Heaven + Back,Dan + Shay,22,,,22,0,181400,,,548328,2023.09.21
88,How Is She,Cole Swindell,25,1,24,1,0,177100,17000,160100,64704,2023.09.21
89,Coldest Beer In Town,Ashley McBryde,32,-14,46,32,0,175700,-19000,194700,77599,2023.09.21
90,Cowgirls,Morgan Wallen,40,10,30,4,0,159300,51500,107800,6385615,2023.09.21
91,Georgia Girl,Megan Moroney,23,19,4,1,0,146100,118600,27500,95811,2023.09.21
92,Always Gonna Be,Dan + Shay,30,,,29,0,140800,,,1078737,2023.09.21
93,Where It Ends,Bailey Zimmerman,19,18,1,16,0,122900,117700,5200,2085270,2023.09.21
94,Heart They Didn'T Break,Maddie & Tae,72,62,10,22,0,113900,96000,17900,639590,2023.09.21
95,On The Boat Again,Jake Owen,22,-46,68,3,0,111300,-86900,198200,166159,2023.09.21
96,Make Me Wanna Smoke,Runaway June,129,28,101,20,0,107800,29900,77900,42600,2023.09.21
97,Women Ain't Whiskey,Ashley McBryde,21,-16,37,21,0,107800,-67400,175200,0,2023.09.21
98,The Day That I'M Over You,Danielle Bradbery,48,,,48,0,103900,,,59731,2023.09.21
99,A Sunday Kind Of Love,The War And Treaty,47,,,47,0,100500,,,6080,2023.09.21
100,Oklahoma Smokeshow,Zach Bryan,38,2,36,1,0,98700,-21700,120400,5858213,2023.09.21
101,Colorado,Florida Georgia Line,16,0,16,2,0,93800,-9600,103400,53034,2023.09.21
102,"Jesus, My Mama, My Therapist",Tiera Kennedy,69,12,57,13,0,90200,24500,65700,70605,2023.09.21
103,Oklahoma Sooner,Jake Banfield,26,17,9,1,0,89400,58400,31000,18316,2023.09.21
104,This Side Of The Dirt,Neon Union,65,9,56,10,0,78000,7100,70900,56392,2023.09.21
105,Heart On Fire In Mexico,Abby Anderson,17,,,16,0,77100,,,295022,2023.09.21
106,The Champion,Carrie Underwood Feat. Ludacris,17,,,16,0,76100,,,588737,2023.09.21
107,Fear And Friday's,Zach Bryan,29,-12,41,3,0,74700,-31400,106100,5040504,2023.09.21
108,Neon Cowgirl,Dan + Shay,12,,,12,0,68000,,,2051400,2023.09.21
109,The Comeback,Zac Brown Band,10,,,10,0,64600,,,46723,2023.09.21
110,You Never Gave Up On Me,Reba Mcentire,10,,,10,0,64000,,,13620,2023.09.21
111,My Bar,Priscilla Block,13,-3,16,4,0,63900,-25000,88900,160826,2023.09.21
112,Tulsa,Elle King,28,0,28,2,0,63700,-7100,70800,58461,2023.09.21
113,Ain'T About You,Huntergirl,29,13,16,17,0,63400,44400,19000,8306,2023.09.21
114,With You I Am,Cody Johnson,5,-1,6,3,0,60200,-27000,87200,1404967,2023.09.21
115,The Star-Spangled Banner,Chris Stapleton,9,-11,20,9,0,56900,-39200,96100,203805,2023.09.21
116,Heart To Break,Ryan Griffin,58,-26,84,7,0,55400,-71500,126900,190121,2023.09.21
117,Best Of Me,David Nail,17,-3,20,1,0,53000,-22100,75100,8455,2023.09.21
118,Lovin You Gets In The Way,Ben Gallaher,27,-7,34,5,0,52800,-5400,58200,14878,2023.09.21
119,I'M Not For Everyone,Brothers Osborne,19,18,1,19,0,48900,38800,10100,482767,2023.09.21
120,I'm In Love,Hailey Whitters,12,10,2,2,0,48400,42500,5900,406901,2023.09.21
121,I'll Be Here,Colbie Caillat,15,10,5,1,0,45300,35300,10000,769809,2023.09.21
122,The Star-Spangled Banner,Carly Pearce,4,1,3,4,0,43700,31000,12700,0,2023.09.21
123,First Rodeo,Daves Highway,71,17,54,18,0,42200,10400,31800,451,2023.09.21
124,Ain't That Some,Morgan Wallen,17,3,14,15,0,41800,5800,36000,4636955,2023.09.21
125,Wasting All These Tears,Austin Snell,6,4,2,1,0,36400,35000,1400,752526,2023.09.21
126,Out Of Nowhere,Walker Montgomery,9,-3,12,1,0,35900,-8700,44600,9851,2023.09.21
127,Wild as You,Cody Johnson,5,2,3,3,0,34700,17700,17000,1288852,2023.09.21
128,Tea Was A Little Sweeter,Matt Rogers,54,2,52,19,0,34700,3500,31200,10076,2023.09.21
129,Chevrolet,Dustin Lynch,7,,,5,0,33500,,,0,2023.09.21
130,Think I’m In Love With You,Chris Stapleton,16,14,2,1,0,32700,19600,13100,3376680,2023.09.21
131,Under A Southern Sky,Ian Flanigan,57,5,52,18,0,32400,900,31500,21522,2023.09.21
132,Back At The Bar,Landon Parker,56,1,55,18,0,32200,300,31900,6748,2023.09.21
133,Sad Boy,Twinnie,53,14,39,18,0,31600,9200,22400,1086,2023.09.21
134,I Hope Heaven,Karissa Ella,52,17,35,18,0,31400,9900,21500,0,2023.09.21
135,Summer To Me,Wayland,52,-2,54,18,0,30700,-1100,31800,5692,2023.09.21
136,Holy Water,Michael Ray,6,-3,9,2,0,30300,-5900,36200,277399,2023.09.21
137,That's Why We Fight,Ella Langley & Koe Wetzel,15,-1,16,2,0,29600,2600,27000,938978,2023.09.21
138,Along For The Ride,Jordan Harvey,13,11,2,7,0,26500,25400,1100,31281,2023.09.21
139,Drinkin' It Wrong,Adam Doleac,12,,,6,0,26100,,,12188,2023.09.21
140,A Little Bit Closer,Braxton Keith,3,2,1,1,0,23300,22700,600,66840,2023.09.21
141,Tourniquet,Zach Bryan,10,2,8,1,0,22700,3600,19100,8571717,2023.09.21
142,Should'Ve Known Better,Erin Viancourt,2,1,1,1,0,22700,22100,600,6203,2023.09.21
143,When My Baby's In Boots,Randall King,2,0,2,1,0,22700,10900,11800,0,2023.09.21
144,Then Again,Dan + Shay,3,,,3,0,22700,,,564142,2023.09.21
145,Rollercoaster (Forever And A Day),Brothers Osborne,4,,,4,0,22100,,,99985,2023.09.21
146,Quittin' Time,Morgan Wallen,6,-2,8,1,0,22000,-1200,23200,1008352,2023.09.21
147,Heart On Ice,Jon Langston,5,,,5,0,21800,,,154995,2023.09.21
148,Loud and Heavy,Cody Jinks,8,-2,10,3,0,21700,8200,13500,1770174,2023.09.21
149,Wolfman Of The Ozarks,Old Crow Medicine Show,10,-23,33,9,0,21600,-160500,182100,5913,2023.09.21
150,Neon You,Don Louis,4,0,4,2,0,21400,1600,19800,74078,2023.09.21
151,Grandaddy's Watch,Jon Langston,4,,,4,0,21300,,,48004,2023.09.21
152,Giving You Up,Kameron Marlowe,3,-1,4,1,0,20000,-5600,25600,934228,2023.09.21
153,Must Be The Whiskey,Cody Jinks,2,1,1,2,0,19500,17500,2000,1596087,2023.09.21
154,Heartbreak On The Map,Dan + Shay,7,,,7,0,19300,,,449168,2023.09.21
155,God Only Knows,for King & Country,3,2,1,1,0,19100,15900,3200,1054162,2023.09.21
156,The Day I Stop Dancin',Jon Pardi,2,1,1,1,0,18800,18200,600,51088,2023.09.21
157,I Can'T Breathe,Parker Mccollum,2,0,2,1,0,18800,1600,17200,1184746,2023.09.21
158,Long Live Cowgirls,Ian Munsick & Cody Johnson,5,,,5,0,18800,,,952745,2023.09.21
159,Heartless,Diplo & Julia Michaels Feat. Morgan Wallen,3,1,2,3,0,18600,1800,16800,5599039,2023.09.21
160,Used Car,Neal Mccoy,11,4,7,1,0,18500,3800,14700,4695,2023.09.21
161,Half a Song,Cody Johnson,1,0,1,1,0,18200,16200,2000,326401,2023.09.21
162,My Baby Does,Drew Parker,1,-2,3,1,0,18200,12500,5700,5303,2023.09.21
163,We Ain't The Only Ones,Randy Rogers & Wade Bowen,1,,,1,0,18200,,,0,2023.09.21
164,The Great Divide,Luke Combs & Billy Strings,8,4,4,1,0,17600,3400,14200,234895,2023.09.21
165,Hey Driver,Zach Bryan Feat. The War and Treaty,4,1,3,1,0,17400,9500,7900,10063274,2023.09.21
166,Young Man's Blues,Parker Mccollum,2,0,2,1,0,17200,16000,1200,460733,2023.09.21
167,Heart Of A Small Town,Tim Dugger,2,0,2,1,0,16800,0,16800,15478,2023.09.21
168,Sun To Me,Zach Bryan,11,-2,13,2,0,16600,-11100,27700,5042877,2023.09.21
169,"The Father, My Son, And The Holy Ghost",Craig Morgan,2,,,1,0,15900,,,52526,2023.09.21
170,For The Both Of Us,Dan + Shay,7,,,7,0,15700,,,666022,2023.09.21
171,Any Given Friday Night,Luke Combs,2,0,2,1,0,15200,0,15200,263156,2023.09.21
172,The Tree,Maren Morris,2,,,2,0,15200,,,2529585,2023.09.21
173,"Salt, Lime & Tequila",Ryan Griffin,7,,,7,0,15000,,,76978,2023.09.21
174,Tuggin' On My Heartstrings,Randall King,5,1,4,1,0,14700,-9200,23900,27926,2023.09.21
175,Come Back To Bed,Sean Stemaly,6,,,6,0,14300,,,228864,2023.09.21
175,Peaked In High School,Priscilla Block,6,,,6,0,14300,,,16083,2023.09.21
175,Take It Slow,Conner Smith,6,,,6,0,14300,,,419320,2023.09.21
178,The Star Spangled Banner,Locash,1,,,1,0,13700,,,0,2023.09.21
179,National Anthem From Battle At Bristol,Jennifer Nettles,3,-2,5,3,0,13400,-8500,21900,0,2023.09.21
180,Better Off,Trace Adkins,3,-1,4,1,0,12900,-1300,14200,14593,2023.09.21
181,Don't Think Jesus,Morgan Wallen,4,1,3,2,0,12300,9600,2700,1216607,2023.09.21
182,Beach Cowboy,Brian Kelley,2,1,1,1,0,12300,5100,7200,85237,2023.09.21
183,Ain'T A Train,Cody Jinks,2,1,1,1,0,12200,6100,6100,165169,2023.09.21
184,White House Road,Tyler Childers & The Highwall,4,2,2,2,0,12000,8000,4000,2885715,2023.09.21
185,Things I Take For Granted,Larry Fleet,2,1,1,2,0,12000,1400,10600,367208,2023.09.21
186,Broadway Girls,Lil Durk Feat. Morgan Wallen,2,-1,3,1,0,11900,-2900,14800,4942572,2023.09.21
187,Hungover You,Emily Brooke,6,,,6,0,11800,,,767,2023.09.21
188,Runnin' Through That T,Thomas Edwards,1,0,1,1,0,11700,0,11700,8470,2023.09.21
189,Whole Lotta Little,Emily Ann Roberts,1,,,1,0,11700,,,41073,2023.09.21
189,Devil Wears Denim,Emily Ann Roberts,1,,,1,0,11700,,,9,2023.09.21
191,Come Back Down,Flatland Cavalry,2,,,2,0,11400,,,170871,2023.09.21
192,Black Sheep,Leah Marie Mason,1,,,1,0,11300,,,29395,2023.09.21
193,Stop Coming Over,Chris Lane,5,-1,6,5,0,11200,-3100,14300,36583,2023.09.21
193,Polaroid,Keith Urban,5,-1,6,5,0,11200,-3100,14300,13667,2023.09.21
195,Downtime,Roman Alexander,18,-35,53,18,0,10600,-21000,31600,19727,2023.09.21
196,Honey!,Rayne Johnson,17,-54,71,17,0,10400,-31700,42100,25976,2023.09.21
197,Oklahoman Son,Zach Bryan,7,-1,8,1,0,10300,-2500,12800,3307016,2023.09.21
198,Sunday Saints,Jordan Davis,2,,,1,0,10300,,,44920,2023.09.21
198,We Ain't Good At Breaking Up,Brothers Osborne,2,,,1,0,10300,,,0,2023.09.21
200,All Things,Sound,2,0,2,2,0,10200,0,10200,13372,2023.09.21
201,Think About There,Greater Vision,2,0,2,2,0,10200,-2200,12400,19391,2023.09.21
202,Love Is Real,Morgan Evans,4,-1,5,1,0,10200,-3100,13300,57475,2023.09.21
1,Watermelon Moonshine,Lainey Wilson,7152,303,6849,144,0,27168600,1196100,25972500,6934308,2023.09.28
2,Try That In A Small Town,Jason Aldean,6847,248,6599,144,0,26461100,1417500,25043600,6987139,2023.09.28
3,Girl In Mine,Parmalee,7155,1141,6014,144,0,26403400,3579700,22823700,1652213,2023.09.28
4,Religiously,Bailey Zimmerman,6769,-915,7684,144,0,25665100,-2723000,28388100,13264054,2023.09.28
5,Fast Car,Luke Combs,5725,-98,5823,144,0,25333200,-494300,25827500,16245889,2023.09.28
6,Need A Favor,Jelly Roll,5622,116,5506,143,0,24477600,178400,24299200,6921151,2023.09.28
7,Thinkin' Bout Me,Morgan Wallen,5764,1015,4749,143,0,23333400,4347700,18985700,12150371,2023.09.28
8,God Gave Me A Girl,Russell Dickerson,5722,300,5422,144,0,21559000,1134400,20424600,1250416,2023.09.28
9,Stars Like Confetti,Dustin Lynch,5426,537,4889,143,0,20989300,1892200,19097100,1373794,2023.09.28
10,Everything I Love,Morgan Wallen,4859,196,4663,144,0,18059000,605800,17453200,3634148,2023.09.28
11,Standing Room Only,Tim McGraw,5014,305,4709,144,0,18002100,962100,17040000,2537910,2023.09.28
12,Can'T Have Mine,Dylan Scott,4639,460,4179,144,0,16706200,1760600,14945600,2724041,2023.09.28
13,But I Got A Beer In My Hand,Luke Bryan,4347,164,4183,144,0,16387100,864100,15523000,2406897,2023.09.28
14,Save Me The Trouble,Dan + Shay,3626,168,3458,144,0,12447200,482000,11965200,2063273,2023.09.28
15,Mind On You,George Birge,3457,315,3142,142,0,11637200,1185100,10452100,319388,2023.09.28
16,All I Need Is You,Chris Janson,3418,200,3218,143,0,11109100,1063300,10045800,917127,2023.09.28
17,If You Go Down (I'M Going Down Too),Kelsea Ballerini,3399,4,3395,143,0,10397000,11700,10385300,1281616,2023.09.28
18,Save Me,Jelly Roll & Lainey Wilson,2318,663,1655,140,0,9378600,2586700,6791900,8746679,2023.09.28
19,White Horse,Chris Stapleton,2855,389,2466,142,0,9201000,1102000,8099000,6525080,2023.09.28
20,We Got History,Mitchell Tenpenny,2611,40,2571,142,0,8287100,428400,7858700,1202710,2023.09.28
21,Different 'Round Here,Riley Green,2630,236,2394,141,0,8250000,1359900,6890100,2168086,2023.09.28
22,World On Fire,Nate Smith,2587,326,2261,137,0,7932500,1097000,6835500,3577461,2023.09.28
23,Light On In The Kitchen,Ashley McBryde,2705,94,2611,143,0,7502300,384900,7117400,1509289,2023.09.28
24,23,Chayce Beckham,2430,80,2350,142,0,7476800,448900,7027900,3196121,2023.09.28
25,Creek Will Rise,Conner Smith,2659,231,2428,144,0,7163800,539800,6624000,1023686,2023.09.28
26,Nobody's Nobody,Brothers Osborne,2225,91,2134,141,0,5752400,-22200,5774600,1826086,2023.09.28
27,Pretty Little Poison,Warren Zeiders,1880,119,1761,131,0,5468300,139000,5329300,5030638,2023.09.28
28,Fearless,Jackson Dean,1724,64,1660,140,0,4648100,412400,4235700,1043440,2023.09.28
29,Truck Bed,Hardy,1685,163,1522,131,0,4571800,609200,3962600,6413142,2023.09.28
30,The Painter,Cody Johnson,1461,307,1154,138,0,4501000,803800,3697200,4599385,2023.09.28
31,See You Next Summer,Brian Kelley,1686,110,1576,140,0,4246900,128600,4118300,660475,2023.09.28
32,I Can Feel It,Kane Brown,983,825,158,125,0,4138800,3109300,1029500,4477221,2023.09.28
33,I Remember Everything,Zach Bryan Feat. Kacey Musgraves,1099,206,893,64,0,3893100,703000,3190100,26600988,2023.09.28
34,Burn It Down,Parker Mccollum,1342,-24,1366,130,0,3778100,89100,3689000,3118853,2023.09.28
35,Glory Days,Gabby Barrett,1558,201,1357,139,0,3588200,680900,2907300,1580584,2023.09.28
36,We Don'T Fight Anymore,Carly Pearce,1298,57,1241,138,0,3388700,51500,3337200,2633587,2023.09.28
37,Cab In A Solo,Scotty McCreery,1269,124,1145,131,0,3212600,330300,2882300,694892,2023.09.28
38,Out Of That Truck,Carrie Underwood,1216,-9,1225,126,0,3010400,109100,2901300,2067409,2023.09.28
39,I'M Not Pretty,Megan Moroney,778,60,718,82,0,2303300,214100,2089200,2558047,2023.09.28
40,Tucson Too Late,Jordan Davis,776,18,758,87,0,2120100,28700,2091400,908633,2023.09.28
41,Giving Up On That,Dalton Dover,916,9,907,92,0,2092700,48900,2043800,930609,2023.09.28
42,Back Then Right Now,Tyler Hubbard,781,41,740,82,0,2021800,35700,1986100,1053319,2023.09.28
43,Rich Men North Of Richmond,Oliver Anthony Music,635,-42,677,50,0,1934100,-402300,2336400,13019795,2023.09.28
44,Drive You Out Of My Mind,Kassi Ashton,789,-14,803,88,0,1904900,63300,1841600,498091,2023.09.28
45,Love You Again,Chase Matthew,751,113,638,71,0,1767900,256500,1511400,2399420,2023.09.28
46,Outskirts,Sam Hunt,706,21,685,79,0,1683600,-112200,1795800,2898128,2023.09.28
47,Drinkin' Problems,Dillon Carmichael,737,41,696,90,0,1487400,222600,1264800,117544,2023.09.28
48,Somebody Else's Whiskey,Frank Ray,805,39,766,79,0,1450600,120900,1329700,133000,2023.09.28
49,Something Real,Dierks Bentley,508,48,460,59,0,1107500,121500,986000,174220,2023.09.28
50,Something's Gonna Kill Me,Corey Kent,559,37,522,73,0,1098000,42400,1055600,2330761,2023.09.28
51,Young Love & Saturday Nights,Chris Young,254,27,227,25,0,999500,77900,921600,450762,2023.09.28
52,Wine Country,Hannah Ellis,436,14,422,66,0,978600,46900,931700,84661,2023.09.28
53,Marry That Girl,Easton Corbin,559,6,553,70,0,970000,-90000,1060000,154493,2023.09.28
54,Can't Break Up Now,Old Dominion,328,173,155,49,0,857600,317300,540300,2150282,2023.09.28
55,Dance With You,Brett Young,474,13,461,68,0,853800,165000,688800,1565907,2023.09.28
56,In Your Love,Tyler Childers,321,49,272,45,0,744200,145800,598400,5894808,2023.09.28
57,Without You,Thompson Square,477,26,451,57,0,729900,101600,628300,18250,2023.09.28
58,Make You Mine,Marynn Taylor,630,191,439,83,0,719300,333300,386000,36693,2023.09.28
59,Good With Me,Walker Hayes,266,1,265,35,0,687800,-12900,700700,518296,2023.09.28
60,Spirits And Demons,Michael Ray With Meghan Patrick,454,22,432,66,0,670500,-54900,725400,609365,2023.09.28
61,We Ride,Bryan Martin,226,110,116,37,0,615400,366700,248700,3574928,2023.09.28
62,Where The Wild Things Are,Luke Combs,79,-1,80,4,0,546800,35100,511700,1313608,2023.09.28
63,Brokenhearted,Joe Nichols,322,-15,337,45,0,518600,1900,516700,38560,2023.09.28
64,Thicc As Thieves,Lauren Alaina,248,89,159,44,0,501600,137300,364300,1003346,2023.09.28
65,Buy A Bar,Tim Dugger,139,-7,146,31,0,484000,105500,378500,21695,2023.09.28
66,'98 Braves,Morgan Wallen,84,21,63,18,0,439100,60900,378200,2886816,2023.09.28
67,Ain'T Got A Worry,Old Dominion,38,-5,43,1,0,428200,-24200,452400,301363,2023.09.28
68,Find Another Bar,Chris Lane,314,11,303,46,0,388900,31900,357000,266317,2023.09.28
69,Royal Family,Jaret Ray Reddick,57,,,56,0,301900,,,804,2023.09.28
70,Trouble,Josh Ross,302,-13,315,49,0,299000,-900,299900,1672374,2023.09.28
71,She's Somebody's Daughter,Drew Baldridge,183,-33,216,29,0,286700,-33000,319700,473244,2023.09.28
72,Daylight Savings,Kidd G,172,-32,204,30,0,247900,-14800,262700,142845,2023.09.28
73,Ain'T Missin' You,Dylan Schneider,201,20,181,27,0,239100,44300,194800,1004223,2023.09.28
74,Nothing Compares To You,Mickey Guyton,113,14,99,19,0,219200,18400,200800,961,2023.09.28
75,Where It Ends,Bailey Zimmerman,40,21,19,19,0,218000,95100,122900,2128757,2023.09.28
76,Cancelled,Randy Houser,109,21,88,14,0,210300,21300,189000,0,2023.09.28
76,Cancel,Randy Houser,109,21,88,14,0,210300,21300,189000,18,2023.09.28
78,Hey There Hometown,Abby Leigh Anderson,75,1,74,37,0,209200,-68800,278000,4354,2023.09.28
79,Man Made A Bar,Morgan Wallen,40,2,38,3,0,196400,6100,190300,3288195,2023.09.28
80,How Is She,Cole Swindell,28,3,25,1,0,185100,8000,177100,60518,2023.09.28
81,She's A Bad Mama Jama,Lamont Landers,37,,,37,0,175200,,,0,2023.09.28
81,(Sittin' On) The Dock Of The Bay,Lamont Landers,37,,,37,0,175200,,,0,2023.09.28
81,Just The Two Of Us,Lamont Landers,37,,,37,0,175200,,,0,2023.09.28
81,Let's Stay Together,Lamont Landers,37,,,37,0,175200,,,0,2023.09.28
81,Dear Friend,Lamont Landers,37,,,37,0,175200,,,0,2023.09.28
86,What's Up,Dolly Parton,36,,,36,0,173200,,,559103,2023.09.28
87,Uptown Funk!,Mark Ronson Feat. Bruno Mars,30,,,16,0,166800,,,4158381,2023.09.28
88,Heart They Didn'T Break,Maddie & Tae,149,77,72,25,0,165400,51500,113900,1049177,2023.09.28
89,Make Me Wanna Smoke,Runaway June,131,2,129,21,0,164600,56800,107800,40087,2023.09.28
90,I'll Be Here,Colbie Caillat,66,51,15,48,0,158400,113100,45300,720222,2023.09.28
91,Cowgirls,Morgan Wallen,37,-3,40,3,0,148100,-11200,159300,6253303,2023.09.28
92,Georgia Girl,Megan Moroney,24,1,23,1,0,132700,-13400,146100,158260,2023.09.28
93,On The Boat Again,Jake Owen,19,-3,22,2,0,125600,14300,111300,145787,2023.09.28
94,One Of Us,Matt Stell,33,-11,44,3,0,106500,-81000,187500,719333,2023.09.28
95,Superpower,Caroline Jones,48,,,47,0,105900,,,792,2023.09.28
96,Strays,Margo Price,47,,,47,0,101500,,,1992,2023.09.28
97,Wasting All These Tears,Austin Snell,16,10,6,2,0,99600,63200,36400,808206,2023.09.28
98,Save The Roses,Lee Brice,30,-57,87,2,0,97000,-208400,305400,598249,2023.09.28
99,Colorado,Florida Georgia Line,14,-2,16,2,0,95400,1600,93800,50871,2023.09.28
100,This Side Of The Dirt,Neon Union,104,39,65,24,0,95000,17000,78000,56866,2023.09.28
101,The Star-Spangled Banner,Chris Stapleton,20,11,9,18,0,91700,34800,56900,197660,2023.09.28
102,Tulsa,Elle King,34,6,28,2,0,86500,22800,63700,54091,2023.09.28
103,Loser,Mike Ryan,20,16,4,18,0,83900,76200,7700,15711,2023.09.28
104,With You I Am,Cody Johnson,6,1,5,2,0,82300,22100,60200,1517546,2023.09.28
105,"Jesus, My Mama, My Therapist",Tiera Kennedy,70,1,69,12,0,82300,-7900,90200,62177,2023.09.28
106,Oklahoma Sooner,Jake Banfield,24,-2,26,1,0,81300,-8100,89400,13340,2023.09.28
107,Sunday Saints,Jordan Davis,13,11,2,1,0,75800,65500,10300,40915,2023.09.28
108,Heart To Break,Ryan Griffin,54,-4,58,6,0,72200,16800,55400,180682,2023.09.28
109,Oklahoma Smokeshow,Zach Bryan,26,-12,38,1,0,69300,-29400,98700,5659612,2023.09.28
110,Lovin You Gets In The Way,Ben Gallaher,26,-1,27,4,0,57800,5000,52800,12819,2023.09.28
111,Ain'T About You,Huntergirl,30,1,29,17,0,55800,-7600,63400,8606,2023.09.28
112,I'm In Love,Hailey Whitters,13,1,12,3,0,52100,3700,48400,369221,2023.09.28
113,Think I’m In Love With You,Chris Stapleton,23,7,16,1,0,50300,17600,32700,2979167,2023.09.28
114,I Hope Heaven,Karissa Ella,73,21,52,18,0,42600,11200,31400,0,2023.09.28
115,Sad Boy,Twinnie,73,20,53,18,0,42600,11000,31600,1014,2023.09.28
116,Save Me,Jelly Roll,11,10,1,2,0,40800,35300,5500,3230845,2023.09.28
117,Hey Driver,Zach Bryan Feat. The War and Treaty,12,8,4,2,0,40000,22600,17400,8995710,2023.09.28
118,If It Wasn't For Trucks,Riley Green,3,0,3,2,0,38100,33800,4300,548774,2023.09.28
119,My Bar,Priscilla Block,10,-3,13,4,0,36900,-27000,63900,147558,2023.09.28
120,Out Of Nowhere,Walker Montgomery,10,1,9,1,0,36300,400,35900,9143,2023.09.28
121,Summer To Me,Wayland,55,3,52,18,0,35700,5000,30700,3897,2023.09.28
122,The Tree,Maren Morris,9,7,2,3,0,34900,19700,15200,1287487,2023.09.28
123,Quittin' Time,Morgan Wallen,9,3,6,1,0,34900,12900,22000,982755,2023.09.28
124,The Devil I Know,Ashley McBryde,9,,,7,0,34600,,,79474,2023.09.28
125,Tea Was A Little Sweeter,Matt Rogers,53,-1,54,19,0,34500,-200,34700,2617,2023.09.28
126,Women Ain't Whiskey,Ashley McBryde,15,-6,21,14,0,34200,-73600,107800,0,2023.09.28
127,Fear And Friday's,Zach Bryan,31,2,29,15,0,33900,-40800,74700,4327981,2023.09.28
128,Star Spangled Banner,Abby Anderson,5,3,2,4,0,33000,23500,9500,0,2023.09.28
129,Under A Southern Sky,Ian Flanigan,55,-2,57,18,0,32000,-400,32400,19133,2023.09.28
130,Honey!,Rayne Johnson,54,37,17,18,0,31800,21400,10400,25679,2023.09.28
131,Downtime,Roman Alexander,53,35,18,18,0,31600,21000,10600,17003,2023.09.28
132,First Rodeo,Daves Highway,53,-18,71,18,0,31600,-10600,42200,496,2023.09.28
133,Fix'N To Break,Bailey Zimmerman,15,,,1,0,31400,,,1778682,2023.09.28
134,Back At The Bar,Landon Parker,51,-5,56,18,0,31200,-1000,32200,6526,2023.09.28
135,Hungover You,Emily Brooke,13,7,6,6,0,30700,18900,11800,702,2023.09.28
136,Stop Coming Over,Chris Lane,12,7,5,6,0,28600,17400,11200,35575,2023.09.28
137,Every Single Summer,Marynn Taylor,12,,,6,0,28600,,,3322,2023.09.28
138,Country Music,Tuten Brothers,9,5,4,1,0,27500,23500,4000,1607,2023.09.28
139,Holy Water,Michael Ray,5,-1,6,1,0,26900,-3400,30300,279010,2023.09.28
140,"Salt, Lime & Tequila",Ryan Griffin,3,-4,7,1,0,26500,11500,15000,71970,2023.09.28
141,Codigo,George Strait,2,,,1,0,25800,,,29969,2023.09.28
142,Runnin' Through That T,Thomas Edwards,2,1,1,1,0,25000,13300,11700,11156,2023.09.28
143,Give Me A Sunrise,Braxton Keith,4,3,1,1,0,23900,23300,600,26821,2023.09.28
144,Other Side Of The Radio,Mike Ryan,3,1,2,1,0,23300,22100,1200,93882,2023.09.28
145,Tuggin' On My Heartstrings,Randall King,3,-2,5,1,0,23300,8600,14700,26320,2023.09.28
146,I Can'T Breathe,Parker Mccollum,4,2,2,1,0,22300,3500,18800,1259012,2023.09.28
147,Best Of Me,David Nail,10,-7,17,1,0,20600,-32400,53000,8841,2023.09.28
148,That's Why We Fight,Ella Langley & Koe Wetzel,14,-1,15,1,0,20000,-9600,29600,871404,2023.09.28
149,Does He Love You,Reba Mcentire W/ Dolly Parton,1,,,1,0,19600,,,0,2023.09.28
150,Still,Luke Combs,8,5,3,1,0,19400,13300,6100,307595,2023.09.28
151,Seven Year Ache,Aaron Watson & Jenna Paulette,2,1,1,1,0,18800,18200,600,0,2023.09.28
152,When My Baby's In Boots,Randall King,5,3,2,1,0,18600,-4100,22700,0,2023.09.28
153,We Ain't The Only Ones,Randy Rogers & Wade Bowen,1,0,1,1,0,18200,0,18200,0,2023.09.28
154,Dancin' With The Devil,Josh Ward,1,,,1,0,18200,,,14524,2023.09.28
155,Think About There,Greater Vision,3,1,2,3,0,17700,7500,10200,16012,2023.09.28
156,Most Nights,Kat & Alex,7,,,6,0,17400,,,2274,2023.09.28
157,Love Is Real,Morgan Evans,6,2,4,2,0,16900,6700,10200,52775,2023.09.28
158,Heart Of A Small Town,Tim Dugger,2,0,2,1,0,16800,0,16800,21519,2023.09.28
159,Tourniquet,Zach Bryan,6,-4,10,1,0,16700,-6000,22700,7609536,2023.09.28
160,Used Car,Neal Mccoy,11,0,11,1,0,16600,-1900,18500,4690,2023.09.28
161,National Anthem From Battle At Bristol,Jennifer Nettles,3,0,3,3,0,16400,3000,13400,0,2023.09.28
162,High Time,Kacey Musgraves,6,2,4,1,0,16200,8200,8000,35978,2023.09.28
163,Better Off,Trace Adkins,2,-1,3,1,0,15900,3000,12900,14470,2023.09.28
164,Leave You Alone,Kane Brown,5,,,5,0,15900,,,492889,2023.09.28
165,Star Spangled Banner,Maren Morris,2,,,2,0,15900,,,0,2023.09.28
166,Sun To Me,Zach Bryan,13,2,11,2,0,15500,-1100,16600,5131037,2023.09.28
167,Any Given Friday Night,Luke Combs,2,0,2,1,0,15200,0,15200,230743,2023.09.28
168,Love You Back,Lady A,3,,,2,0,15100,,,834460,2023.09.28
169,House Fire,Tyler Childers,6,3,3,1,0,14800,4700,10100,1176654,2023.09.28
170,Loud and Heavy,Cody Jinks,9,1,8,2,0,14700,-7000,21700,1824500,2023.09.28
171,Made For This,Ashley McBryde,6,5,1,6,0,14300,12700,1600,51852,2023.09.28
172,Your Place,Ashley Cooke,6,5,1,6,0,14300,9100,5200,391473,2023.09.28
173,What Took You So Long,Dan + Shay,6,5,1,6,0,14300,8400,5900,155138,2023.09.28
174,Breakin' Up With A Broken Heart,Dan + Shay,6,-39,45,6,0,14300,-290300,304600,0,2023.09.28
175,Single At The Same Time,Ashley McBryde,6,,,6,0,14300,,,341416,2023.09.28
175,Learned To Lie,Ashley McBryde,6,,,6,0,14300,,,0,2023.09.28
175,When Will I Be Loved,"Ashley McBryde, Caylee Hammack & Pillbox Patti",6,,,6,0,14300,,,45338,2023.09.28
178,Along For The Ride,Jordan Harvey,7,-6,13,6,0,13900,-12600,26500,31032,2023.09.28
179,Here He Comes,Joseph Habedank,2,,,2,0,12800,,,2373,2023.09.28
180,One Name,Jeff & Sheri Easter,2,1,1,2,0,12400,7500,4900,15252,2023.09.28
181,The Great Divide,Luke Combs & Billy Strings,6,-2,8,1,0,12200,-5400,17600,222364,2023.09.28
182,Record High,Randall King,2,,,1,0,12200,,,27804,2023.09.28
182,From Austin,Zach Bryan,2,,,1,0,12200,,,2078646,2023.09.28
184,Heartless,Diplo & Julia Michaels Feat. Morgan Wallen,2,-1,3,2,0,12100,-6500,18600,5321302,2023.09.28
185,Outlaw,Morgan Wallen Feat. Ben Burgess,6,2,4,1,0,12000,9900,2100,469534,2023.09.28
186,Oklahoman Son,Zach Bryan,8,1,7,1,0,11900,1600,10300,2493673,2023.09.28
187,Polaroid,Keith Urban,6,1,5,6,0,11800,600,11200,12786,2023.09.28
188,Don't Think Jesus,Morgan Wallen,4,0,4,3,0,11700,-600,12300,1178266,2023.09.28
189,Halfway To Hell,Jelly Roll,1,,,1,0,11700,,,1567852,2023.09.28
190,Soundtrack To A Small Town Sundown,Tyler Farr,2,1,1,1,0,11600,3200,8400,8152,2023.09.28
191,God Only Knows,for King & Country,2,-1,3,1,0,11600,-7500,19100,1021180,2023.09.28
192,Star Spangled Banner,Demi Lovato,2,1,1,2,0,10900,1500,9400,115,2023.09.28
193,Things I Take For Granted,Larry Fleet,1,-1,2,1,0,10600,-1400,12000,400008,2023.09.28
194,Gonna Love You,Parmalee,2,,,2,0,10500,,,371287,2023.09.28
195,Wild as You,Cody Johnson,4,-1,5,2,0,10300,-24400,34700,1402322,2023.09.28
196,Halfway Up The Mountain,Tribute Quartet,2,1,1,2,0,10200,4900,5300,12221,2023.09.28
197,All Things,Sound,2,0,2,2,0,10200,0,10200,12945,2023.09.28
198,Giving You Up,Kameron Marlowe,2,-1,3,2,0,10000,-10000,20000,951563,2023.09.28
199,Country Dance,Aaron Goodvin,1,,,1,0,9900,,,3389,2023.09.28
200,Broadway Girls,Lil Durk Feat. Morgan Wallen,2,0,2,1,0,9800,-2100,11900,4715677,2023.09.28
1,Watermelon Moonshine,Lainey Wilson,7980,828,7152,144,0,30374700,3206100,27168600,7350004,2023.10.05
2,Try That In A Small Town,Jason Aldean,7281,434,6847,144,0,28714300,2253200,26461100,6553596,2023.10.05
3,Thinkin' Bout Me,Morgan Wallen,7024,1260,5764,143,0,28100000,4766600,23333400,12615797,2023.10.05
4,Fast Car,Luke Combs,5503,-222,5725,144,0,24738600,-594600,25333200,15803855,2023.10.05
5,God Gave Me A Girl,Russell Dickerson,6275,553,5722,144,0,23870600,2311600,21559000,1271967,2023.10.05
6,Need A Favor,Jelly Roll,5396,-226,5622,143,0,23649400,-828200,24477600,7085730,2023.10.05
7,Stars Like Confetti,Dustin Lynch,5837,411,5426,143,0,22428100,1438800,20989300,1350997,2023.10.05
8,Religiously,Bailey Zimmerman,5193,-1576,6769,144,0,20089300,-5575800,25665100,12099121,2023.10.05
9,Girl In Mine,Parmalee,4880,-2275,7155,144,0,19098200,-7305200,26403400,1626271,2023.10.05
10,Standing Room Only,Tim McGraw,5316,302,5014,144,0,18745900,743800,18002100,2919079,2023.10.05
11,Can'T Have Mine,Dylan Scott,4908,269,4639,144,0,18411200,1705000,16706200,2693010,2023.10.05
12,Everything I Love,Morgan Wallen,4945,86,4859,144,0,18018800,-40200,18059000,3700748,2023.10.05
13,But I Got A Beer In My Hand,Luke Bryan,4526,179,4347,144,0,17070300,683200,16387100,2254105,2023.10.05
14,Save Me The Trouble,Dan + Shay,3865,239,3626,144,0,13449000,1001800,12447200,2170438,2023.10.05
15,Mind On You,George Birge,3759,302,3457,143,0,13051200,1414000,11637200,349576,2023.10.05
16,Save Me,Jelly Roll & Lainey Wilson,2991,673,2318,143,0,12155500,2776900,9378600,8643108,2023.10.05
17,All I Need Is You,Chris Janson,3595,177,3418,144,0,11880500,771400,11109100,969790,2023.10.05
18,If You Go Down (I'M Going Down Too),Kelsea Ballerini,3512,113,3399,144,0,11107300,710300,10397000,1236152,2023.10.05
19,White Horse,Chris Stapleton,3178,323,2855,144,0,10568100,1367100,9201000,8382137,2023.10.05
20,We Got History,Mitchell Tenpenny,2937,326,2611,142,0,9485600,1198500,8287100,1381594,2023.10.05
21,World On Fire,Nate Smith,2788,201,2587,138,0,9228100,1295600,7932500,3308025,2023.10.05
22,Different 'Round Here,Riley Green,2830,200,2630,143,0,9148300,898300,8250000,2354201,2023.10.05
23,23,Chayce Beckham,2731,301,2430,142,0,8249500,772700,7476800,3270697,2023.10.05
24,Creek Will Rise,Conner Smith,2771,112,2659,144,0,7641300,477500,7163800,798098,2023.10.05
25,Light On In The Kitchen,Ashley McBryde,2646,-59,2705,143,0,7258900,-243400,7502300,1207284,2023.10.05
26,Pretty Little Poison,Warren Zeiders,2085,205,1880,136,0,6193200,724900,5468300,5049909,2023.10.05
27,Nobody's Nobody,Brothers Osborne,2185,-40,2225,141,0,5727600,-24800,5752400,1248511,2023.10.05
28,The Painter,Cody Johnson,1553,92,1461,138,0,5210700,709700,4501000,4455561,2023.10.05
29,Fearless,Jackson Dean,1761,37,1724,142,0,4931400,283300,4648100,1125050,2023.10.05
30,Truck Bed,Hardy,1791,106,1685,132,0,4790300,218500,4571800,6584824,2023.10.05
31,I Can Feel It,Kane Brown,1221,238,983,98,0,4560100,421300,4138800,2710516,2023.10.05
32,I Remember Everything,Zach Bryan Feat. Kacey Musgraves,1280,181,1099,84,0,4413100,520000,3893100,25293657,2023.10.05
33,See You Next Summer,Brian Kelley,1714,28,1686,140,0,4330300,83400,4246900,667188,2023.10.05
34,Burn It Down,Parker Mccollum,1488,146,1342,133,0,4233000,454900,3778100,4096295,2023.10.05
35,Cab In A Solo,Scotty McCreery,1422,153,1269,139,0,3482700,270100,3212600,700216,2023.10.05
36,Glory Days,Gabby Barrett,1526,-32,1558,139,0,3347300,-240900,3588200,1572994,2023.10.05
37,Out Of That Truck,Carrie Underwood,1327,111,1216,128,0,3251400,241000,3010400,1533731,2023.10.05
38,We Don'T Fight Anymore,Carly Pearce,1216,-82,1298,137,0,3201700,-187000,3388700,2519938,2023.10.05
39,I'M Not Pretty,Megan Moroney,966,188,778,101,0,2714800,411500,2303300,2777865,2023.10.05
40,Back Then Right Now,Tyler Hubbard,1017,236,781,87,0,2699700,677900,2021800,1053058,2023.10.05
41,Mamaw's House,Thomas Rhett,475,,,101,0,2578200,,,6849461,2023.10.05
42,Tucson Too Late,Jordan Davis,793,17,776,89,0,2214500,94400,2120100,1400814,2023.10.05
43,Giving Up On That,Dalton Dover,929,13,916,93,0,2084700,-8000,2092700,988121,2023.10.05
44,Love You Again,Chase Matthew,796,45,751,56,0,1985700,217800,1767900,2545551,2023.10.05
45,Outskirts,Sam Hunt,746,40,706,81,0,1916900,233300,1683600,2932572,2023.10.05
46,Drive You Out Of My Mind,Kassi Ashton,839,50,789,103,0,1832400,-72500,1904900,505709,2023.10.05
47,Drinkin' Problems,Dillon Carmichael,773,36,737,91,0,1411900,-75500,1487400,104406,2023.10.05
48,Somebody Else's Whiskey,Frank Ray,758,-47,805,80,0,1325800,-124800,1450600,90620,2023.10.05
49,Young Love & Saturday Nights,Chris Young,335,81,254,40,0,1316700,317200,999500,499675,2023.10.05
50,Rich Men North Of Richmond,Oliver Anthony Music,446,-189,635,47,0,1309300,-624800,1934100,11667290,2023.10.05
51,Something's Gonna Kill Me,Corey Kent,585,26,559,68,0,1251200,153200,1098000,2622091,2023.10.05
52,Something Real,Dierks Bentley,513,5,508,61,0,1115200,7700,1107500,197250,2023.10.05
53,Can't Break Up Now,Old Dominion,465,137,328,62,0,1092500,234900,857600,1726224,2023.10.05
54,Where It Ends,Bailey Zimmerman,212,172,40,30,0,1060700,842700,218000,2365221,2023.10.05
55,Marry That Girl,Easton Corbin,555,-4,559,70,0,1042900,72900,970000,185174,2023.10.05
56,Wine Country,Hannah Ellis,451,15,436,56,0,1040600,62000,978600,84934,2023.10.05
57,Dance With You,Brett Young,504,30,474,66,0,1031800,178000,853800,1559190,2023.10.05
58,Spirits And Demons,Michael Ray With Meghan Patrick,504,50,454,68,0,921600,251100,670500,621208,2023.10.05
59,We Ride,Bryan Martin,345,119,226,41,0,910000,294600,615400,3289170,2023.10.05
60,In Your Love,Tyler Childers,336,15,321,46,0,897000,152800,744200,5517937,2023.10.05
61,Without You,Thompson Square,458,-19,477,59,0,704400,-25500,729900,16197,2023.10.05
62,Thicc As Thieves,Lauren Alaina,291,43,248,52,0,666500,164900,501600,1088167,2023.10.05
63,Good With Me,Walker Hayes,270,4,266,35,0,637500,-50300,687800,716212,2023.10.05
64,Brokenhearted,Joe Nichols,380,58,322,48,0,623600,105000,518600,25204,2023.10.05
65,Hey There Hometown,Abby Leigh Anderson,145,70,75,59,0,596400,387200,209200,4344,2023.10.05
66,Where The Wild Things Are,Luke Combs,97,18,79,13,0,550100,3300,546800,1346018,2023.10.05
67,She's Somebody's Daughter,Drew Baldridge,252,69,183,35,0,418000,131300,286700,452374,2023.10.05
68,Make You Mine,Marynn Taylor,335,-295,630,71,0,383500,-335800,719300,37490,2023.10.05
69,Find Another Bar,Chris Lane,338,24,314,49,0,374700,-14200,388900,266806,2023.10.05
70,'98 Braves,Morgan Wallen,59,-25,84,2,0,357700,-81400,439100,3071013,2023.10.05
71,Trouble,Josh Ross,310,8,302,50,0,335500,36500,299000,1593476,2023.10.05
72,Cancelled,Randy Houser,148,39,109,22,0,291400,81100,210300,0,2023.10.05
72,Cancel,Randy Houser,148,39,109,22,0,291400,81100,210300,185863,2023.10.05
74,Ain'T Got A Worry,Old Dominion,28,-10,38,1,0,256900,-171300,428200,302425,2023.10.05
75,Make Me Wanna Smoke,Runaway June,164,33,131,24,0,241100,76500,164600,39967,2023.10.05
76,Can't Say That (In A Country Song),Bobby Bones & The Raging Idiots,52,,,37,0,240400,,,0,2023.10.05
77,Ain't Missin' You,Dylan Schneider,197,-4,201,29,0,219700,-19400,239100,1016570,2023.10.05
78,This Side Of The Dirt,Neon Union,184,80,104,26,0,200100,105100,95000,52698,2023.10.05
79,Man Made A Bar,Morgan Wallen,35,-5,40,3,0,197900,1500,196400,3354707,2023.10.05
80,(Sittin' On) The Dock Of The Bay,Lamont Landers,62,25,37,46,0,189600,14400,175200,0,2023.10.05
81,Buy A Bar,Tim Dugger,87,-52,139,14,0,185900,-298100,484000,20475,2023.10.05
82,How Is She,Cole Swindell,26,-2,28,1,0,181300,-3800,185100,66903,2023.10.05
83,Heart They Didn'T Break,Maddie & Tae,147,-2,149,25,0,158400,-7000,165400,826740,2023.10.05
84,Nothing Compares To You,Mickey Guyton,102,-11,113,21,0,148600,-70600,219200,871,2023.10.05
85,I'm In Love,Hailey Whitters,34,21,13,7,0,139600,87500,52100,376344,2023.10.05
86,Georgia Girl,Megan Moroney,20,-4,24,1,0,116500,-16200,132700,127473,2023.10.05
87,"Jesus, My Mama, My Therapist",Tiera Kennedy,85,15,70,26,0,115600,33300,82300,60239,2023.10.05
88,Tim + Faith,Madeline Merlo,48,,,48,0,103900,,,38542,2023.10.05
89,One Of Us,Matt Stell,21,-12,33,3,0,101800,-4700,106500,787334,2023.10.05
90,Colorado,Florida Georgia Line,16,2,14,2,0,101700,6300,95400,52345,2023.10.05
91,A Sunday Kind Of Love,The War And Treaty,47,,,47,0,101500,,,4379,2023.10.05
92,Sunday Saints,Jordan Davis,15,2,13,1,0,91300,15500,75800,44107,2023.10.05
93,Cowgirls,Morgan Wallen,19,-18,37,3,0,86300,-61800,148100,6266630,2023.10.05
94,Oklahoma Sooner,Jake Banfield,25,1,24,1,0,82900,1600,81300,9686,2023.10.05
95,Anybody But You,Lauren Watkins,17,,,16,0,78000,,,180442,2023.10.05
96,With You I Am,Cody Johnson,5,-1,6,2,0,77800,-4500,82300,1634418,2023.10.05
97,Save The Roses,Lee Brice,29,-1,30,3,0,72900,-24100,97000,604413,2023.10.05
98,Ain'T About You,Huntergirl,35,5,30,19,0,70200,14400,55800,8457,2023.10.05
99,Daylight Savings,Kidd G,66,-106,172,28,0,65900,-182000,247900,101676,2023.10.05
100,Tulsa,Elle King,32,-2,34,2,0,65000,-21500,86500,56372,2023.10.05
101,Lovin You Gets In The Way,Ben Gallaher,18,-8,26,3,0,61900,4100,57800,12979,2023.10.05
102,Silverado,Caleb Lee Hutchinson,105,,,18,0,60700,,,22089,2023.10.05
103,Fix'N To Break,Bailey Zimmerman,29,14,15,1,0,57900,26500,31400,1829149,2023.10.05
104,Ol' Church Hymn,Darius Rucker Feat. Chapel Hart,9,,,9,0,56600,,,36420,2023.10.05
105,Oklahoma Smokeshow,Zach Bryan,22,-4,26,2,0,55400,-13900,69300,5605723,2023.10.05
106,Lift Me Up,Darius Rucker,8,,,8,0,53800,,,24907,2023.10.05
107,Holy Water,Michael Ray,10,5,5,2,0,53600,26700,26900,269894,2023.10.05
108,I'll Be Here,Colbie Caillat,17,-49,66,1,0,45600,-112800,158400,609861,2023.10.05
109,Love You Back,Lady A,12,9,3,2,0,43800,28700,15100,368963,2023.10.05
110,The Tree,Maren Morris,17,8,9,1,0,42900,8000,34900,1258618,2023.10.05
111,Gonna Love You,Parmalee,8,6,2,7,0,41700,31200,10500,234081,2023.10.05
112,Stranger In My House,Ronnie Milsap,5,1,4,2,0,40300,8800,31500,152503,2023.10.05
113,The Star-Spangled Banner,Chris Stapleton,6,-14,20,6,0,38100,-53600,91700,200752,2023.10.05
114,Star Spangled Banner,Abby Anderson,7,2,5,6,0,37600,4600,33000,0,2023.10.05
115,We Ain't The Only Ones,Randy Rogers & Wade Bowen,2,1,1,1,0,36400,18200,18200,0,2023.10.05
116,On The Boat Again,Jake Owen,10,-9,19,2,0,35500,-90100,125600,137262,2023.10.05
117,Quittin' Time,Morgan Wallen,11,2,9,1,0,35100,200,34900,1029841,2023.10.05
118,Heart To Break,Ryan Griffin,43,-11,54,4,0,34100,-38100,72200,170800,2023.10.05
119,Don'T Let The Old Man In,Toby Keith,7,,,6,0,33600,,,765718,2023.10.05
120,Bad Man,Twinnie,57,,,18,0,32400,,,1105,2023.10.05
121,Back At The Bar,Landon Parker,55,4,51,18,0,32000,800,31200,4725,2023.10.05
122,Under A Southern Sky,Ian Flanigan,55,0,55,18,0,32000,0,32000,12019,2023.10.05
123,Summer To Me,Wayland,54,-1,55,18,0,31800,-3900,35700,2432,2023.10.05
124,When Will I Be Loved,"Ashley McBryde, Caylee Hammack & Pillbox Patti",12,6,6,6,0,28600,14300,14300,43939,2023.10.05
125,Just Drive,Erin Kinsey,12,,,6,0,28600,,,114217,2023.10.05
126,Roots,Parmalee,5,,,5,0,28400,,,8586,2023.10.05
127,She's Gotta Know,Conner Sweet,46,,,18,0,28300,,,1,2023.10.05
128,Honky Tonk Heartbreaker,Dustin Lynch,6,,,5,0,27600,,,631266,2023.10.05
129,Heart On Ice,Jon Langston,6,5,1,5,0,26500,21300,5200,110757,2023.10.05
130,My Bar,Priscilla Block,9,-1,10,5,0,26400,-10500,36900,162689,2023.10.05
131,Out Of Nowhere,Walker Montgomery,8,-2,10,1,0,25500,-10800,36300,9509,2023.10.05
132,Tea Was A Little Sweeter,Matt Rogers,36,-17,53,19,0,24100,-10400,34500,2073,2023.10.05
133,Loud and Heavy,Cody Jinks,12,3,9,3,0,23900,9200,14700,1734162,2023.10.05
134,Every Single Summer,Marynn Taylor,12,0,12,7,0,23400,-5200,28600,3210,2023.10.05
135,Chevrolet,Dustin Lynch,8,2,6,5,0,23300,13800,9500,0,2023.10.05
136,The Star-Spangled Banner,Carly Pearce,3,2,1,3,0,23000,16900,6100,0,2023.10.05
137,The Weight Of The Badge,George Strait,3,,,3,0,22900,,,51796,2023.10.05
138,Marlboros & Avon,McBride & The Ride,4,,,4,0,22100,,,1075,2023.10.05
138,No Horse To Ride,Luke Grimes,4,,,4,0,22100,,,367243,2023.10.05
140,Best Of Me,David Nail,10,0,10,1,0,21000,400,20600,8815,2023.10.05
141,But A Beer Can,Eric Burgett,35,,,18,0,21000,,,9992,2023.10.05
142,Sun To Me,Zach Bryan,14,1,13,2,0,20800,5300,15500,4908331,2023.10.05
143,Summer Soundtrack,Craig Campbell,32,,,17,0,19500,,,1898,2023.10.05
144,Breakin' In Boots,Matt Stell,1,,,1,0,19500,,,248,2023.10.05
145,Seven Year Ache,Aaron Watson & Jenna Paulette,3,1,2,1,0,19400,600,18800,0,2023.10.05
146,Young Man's Blues,Parker Mccollum,3,0,3,1,0,19400,13700,5700,449154,2023.10.05
147,I Can'T Breathe,Parker Mccollum,3,-1,4,1,0,19400,-2900,22300,1235740,2023.10.05
148,Giving You Up,Kameron Marlowe,3,1,2,1,0,19100,9100,10000,917239,2023.10.05
149,Neon You,Don Louis,2,1,1,1,0,18800,18200,600,67131,2023.10.05
150,Rain In The Rearview,Anne Wilson,7,,,5,0,18800,,,571203,2023.10.05
151,Heartless,Diplo & Julia Michaels Feat. Morgan Wallen,4,2,2,3,0,18700,6600,12100,5416265,2023.10.05
152,The Great Divide,Luke Combs & Billy Strings,7,1,6,1,0,18700,6500,12200,240209,2023.10.05
153,Leave Her Wild,Sundance Head,1,,,1,0,18200,,,4285,2023.10.05
153,Like A Hurricane,Cody Jinks,1,,,1,0,18200,,,98157,2023.10.05
153,A Life Where We Work Out,Flatland Cavalry,1,,,1,0,18200,,,852387,2023.10.05
156,Heart Of A Small Town,Tim Dugger,3,1,2,1,0,18100,1300,16800,12439,2023.10.05
157,I'M Not For Everyone,Brothers Osborne,3,2,1,3,0,18000,12800,5200,499891,2023.10.05
158,House Fire,Tyler Childers,6,0,6,1,0,16800,2000,14800,1173094,2023.10.05
159,National Anthem From Battle At Bristol,Jennifer Nettles,4,1,3,4,0,16300,-100,16400,0,2023.10.05
160,Loser,Mike Ryan,3,-17,20,2,0,16300,-67600,83900,14797,2023.10.05
161,West Of Tulsa,Wyatt Flores,4,,,2,0,16100,,,371409,2023.10.05
162,Leave You Alone,Kane Brown,5,0,5,5,0,15900,0,15900,314841,2023.10.05
163,Days That End In Why,Morgan Wallen,5,3,2,2,0,15600,14200,1400,1266287,2023.10.05
164,Broadway Girls,Lil Durk Feat. Morgan Wallen,2,0,2,1,0,15300,5500,9800,4918749,2023.10.05
165,Any Given Friday Night,Luke Combs,2,0,2,1,0,15200,0,15200,237991,2023.10.05
166,"Salt, Lime & Tequila",Ryan Griffin,7,4,3,7,0,15000,-11500,26500,72281,2023.10.05
167,Stop Coming Over,Chris Lane,6,-6,12,6,0,14300,-14300,28600,34027,2023.10.05
168,Blackout Betty,Ashley McBryde,6,,,6,0,14300,,,50549,2023.10.05
168,Coldest Beer In Town,Ashley McBryde,6,,,6,0,14300,,,43735,2023.10.05
168,Should Have Known Better,Jessie James Decker,6,,,6,0,14300,,,84971,2023.10.05
168,"'Beer Beer, Truck Truck'",George Birge,6,,,6,0,14300,,,36041,2023.10.05
172,Star Spangled Banner,Marlana Vanhoose,2,,,2,0,14300,,,0,2023.10.05
173,Luke Combs,Tanner Adell,8,3,5,1,0,14200,8800,5400,48441,2023.10.05
174,Love You A Little Bit,Tanner Adell,10,5,5,1,0,14100,7800,6300,86837,2023.10.05
175,Star Spangled Banner,Maren Morris,1,-1,2,1,0,13700,-2200,15900,0,2023.10.05
176,Songs We Used To Sing,Ernest,6,3,3,1,0,13400,6100,7300,88323,2023.10.05
177,Decoration,Jillian Riscoe,6,4,2,1,0,13300,7700,5600,21,2023.10.05
178,Still,Luke Combs,6,-2,8,1,0,13200,-6200,19400,315304,2023.10.05
179,Better Off,Trace Adkins,3,1,2,2,0,12900,-3000,15900,15214,2023.10.05
180,Thank You Lord,Chris Tomlin Feat. Thomas Rhett & Florida Georgia Line,2,,,2,0,12500,,,253811,2023.10.05
180,Goodbye Looks Good On You,Alana Springsteen Feat. Mitchell Tenpenny,2,,,2,0,12500,,,1481838,2023.10.05
182,The Building,Emily Ann Roberts,2,1,1,2,0,12400,7500,4900,37741,2023.10.05
183,From Austin,Zach Bryan,2,0,2,1,0,12200,0,12200,2094710,2023.10.05
184,Runnin' Through That T,Thomas Edwards,1,-1,2,1,0,11700,-13300,25000,8300,2023.10.05
185,Radioland,Ashley McBryde,2,,,2,0,11600,,,7461,2023.10.05
186,Shoulder To Cry On,Alana Springsteen,1,,,1,0,11300,,,22361,2023.10.05
187,Oklahoman Son,Zach Bryan,8,0,8,1,0,11000,-900,11900,2149731,2023.10.05
188,High Time,Kacey Musgraves,5,-1,6,1,0,10900,-5300,16200,37287,2023.10.05
189,Love Is Real,Morgan Evans,4,-2,6,1,0,10600,-6300,16900,58050,2023.10.05
190,First Rodeo,Daves Highway,18,-35,53,18,0,10600,-21000,31600,411,2023.10.05
191,I Hope Heaven,Karissa Ella,18,-55,73,18,0,10600,-32000,42600,0,2023.10.05
192,Don't Think Jesus,Morgan Wallen,5,1,4,2,0,10500,-1200,11700,1219640,2023.10.05
193,A Little Bit Closer,Braxton Keith,2,0,2,1,0,10400,5300,5100,66420,2023.10.05
194,Halfway Up The Mountain,Tribute Quartet,2,0,2,2,0,10200,0,10200,14179,2023.10.05
195,Fear And Friday's,Zach Bryan,11,-20,31,11,0,10000,-23900,33900,3603305,2023.10.05
196,Heart Attack,Boy Named Banjo,3,,,1,0,9900,,,10126,2023.10.05
197,The Devil I Know,Ashley McBryde,1,-8,9,1,0,9800,-24800,34600,71711,2023.10.05
198,Tuggin' On My Heartstrings,Randall King,3,0,3,1,0,9600,-13700,23300,28961,2023.10.05
199,When My Baby's In Boots,Randall King,3,-2,5,1,0,9600,-9000,18600,0,2023.10.05
200,Star Spangled Banner,Mickey Guyton,2,1,1,2,0,9300,6900,2400,0,2023.10.05
1,Watermelon Moonshine,Lainey Wilson,8085,105,7980,144,0,31037300,662600,30374700,7056794,2023.10.12
2,Thinkin' Bout Me,Morgan Wallen,7674,650,7024,143,0,30832100,2732100,28100000,14588279,2023.10.12
3,Try That In A Small Town,Jason Aldean,7386,105,7281,144,0,29383700,669400,28714300,6148885,2023.10.12
4,God Gave Me A Girl,Russell Dickerson,6773,498,6275,144,0,25620000,1749400,23870600,1287746,2023.10.12
5,Fast Car,Luke Combs,5261,-242,5503,144,0,23985500,-753100,24738600,14777529,2023.10.12
6,Stars Like Confetti,Dustin Lynch,6273,436,5837,143,0,23421100,993000,22428100,1325503,2023.10.12
7,Need A Favor,Jelly Roll,4907,-489,5396,143,0,22088500,-1560900,23649400,6915902,2023.10.12
8,Standing Room Only,Tim McGraw,5555,239,5316,144,0,20002800,1256900,18745900,2517084,2023.10.12
9,Can'T Have Mine,Dylan Scott,5350,442,4908,144,0,19848500,1437300,18411200,2936415,2023.10.12
10,Everything I Love,Morgan Wallen,5129,184,4945,143,0,18634400,615600,18018800,3568101,2023.10.12
11,But I Got A Beer In My Hand,Luke Bryan,4559,33,4526,144,0,17384500,314200,17070300,2251994,2023.10.12
12,Save Me,Jelly Roll & Lainey Wilson,3899,908,2991,143,0,15342500,3187000,12155500,8806454,2023.10.12
13,Save Me The Trouble,Dan + Shay,4000,135,3865,144,0,14129000,680000,13449000,2305046,2023.10.12
14,Mind On You,George Birge,3875,116,3759,144,0,13335700,284500,13051200,369493,2023.10.12
15,All I Need Is You,Chris Janson,3698,103,3595,144,0,12308600,428100,11880500,929598,2023.10.12
16,White Horse,Chris Stapleton,3339,161,3178,144,0,11197200,629100,10568100,9138931,2023.10.12
17,If You Go Down (I'M Going Down Too),Kelsea Ballerini,3440,-72,3512,143,0,11129400,22100,11107300,1199729,2023.10.12
18,We Got History,Mitchell Tenpenny,3236,299,2937,143,0,10457800,972200,9485600,1341885,2023.10.12
19,World On Fire,Nate Smith,3004,216,2788,138,0,10423900,1195800,9228100,3229720,2023.10.12
20,Different 'Round Here,Riley Green,2861,31,2830,143,0,9810700,662400,9148300,2252323,2023.10.12
21,23,Chayce Beckham,2801,70,2731,142,0,8680400,430900,8249500,3154014,2023.10.12
22,Creek Will Rise,Conner Smith,2921,150,2771,144,0,8117200,475900,7641300,750522,2023.10.12
23,Light On In The Kitchen,Ashley McBryde,2641,-5,2646,143,0,7217400,-41500,7258900,1111952,2023.10.12
24,Pretty Little Poison,Warren Zeiders,2143,58,2085,136,0,6369800,176600,6193200,4999024,2023.10.12
25,Nobody's Nobody,Brothers Osborne,2188,3,2185,141,0,5854400,126800,5727600,1555446,2023.10.12
26,The Painter,Cody Johnson,1747,194,1553,140,0,5782500,571800,5210700,4448758,2023.10.12
27,Truck Bed,Hardy,1917,126,1791,137,0,5188300,398000,4790300,6514063,2023.10.12
28,I Can Feel It,Kane Brown,1419,198,1221,115,0,5181600,621500,4560100,2586574,2023.10.12
29,Fearless,Jackson Dean,1716,-45,1761,142,0,4959700,28300,4931400,1109433,2023.10.12
30,I Remember Everything,Zach Bryan Feat. Kacey Musgraves,1332,52,1280,89,0,4566200,153100,4413100,24563031,2023.10.12
31,Burn It Down,Parker Mccollum,1502,14,1488,135,0,4366600,133600,4233000,3417678,2023.10.12
32,See You Next Summer,Brian Kelley,1656,-58,1714,140,0,4330000,-300,4330300,601497,2023.10.12
33,Glory Days,Gabby Barrett,1564,38,1526,140,0,3647000,299700,3347300,1707962,2023.10.12
34,Cab In A Solo,Scotty McCreery,1477,55,1422,142,0,3525000,42300,3482700,752526,2023.10.12
35,Tucson Too Late,Jordan Davis,1014,221,793,104,0,3509800,1295300,2214500,1207980,2023.10.12
36,We Don'T Fight Anymore,Carly Pearce,1245,29,1216,138,0,3171400,-30300,3201700,3416785,2023.10.12
37,Mamaw's House,Thomas Rhett,702,227,475,85,0,3072600,494400,2578200,3295634,2023.10.12
38,Back Then Right Now,Tyler Hubbard,1075,58,1017,92,0,3019800,320100,2699700,1228231,2023.10.12
39,Out Of That Truck,Carrie Underwood,1236,-91,1327,126,0,2956600,-294800,3251400,1509370,2023.10.12
40,I'M Not Pretty,Megan Moroney,1060,94,966,108,0,2875300,160500,2714800,2740374,2023.10.12
41,Love You Again,Chase Matthew,827,31,796,63,0,2180900,195200,1985700,2657201,2023.10.12
42,Giving Up On That,Dalton Dover,911,-18,929,96,0,2057400,-27300,2084700,974568,2023.10.12
43,Outskirts,Sam Hunt,804,58,746,92,0,1972200,55300,1916900,2599113,2023.10.12
44,Drive You Out Of My Mind,Kassi Ashton,835,-4,839,106,0,1913900,81500,1832400,477393,2023.10.12
45,Young Love & Saturday Nights,Chris Young,459,124,335,50,0,1599400,282700,1316700,420116,2023.10.12
46,Can't Break Up Now,Old Dominion,532,67,465,108,0,1511000,418500,1092500,2353284,2023.10.12
47,Something's Gonna Kill Me,Corey Kent,643,58,585,69,0,1472600,221400,1251200,2279587,2023.10.12
48,Drinkin' Problems,Dillon Carmichael,789,16,773,91,0,1470600,58700,1411900,104992,2023.10.12
49,Where It Ends,Bailey Zimmerman,342,130,212,39,0,1437700,377000,1060700,2499889,2023.10.12
50,Somebody Else's Whiskey,Frank Ray,736,-22,758,80,0,1314500,-11300,1325800,106110,2023.10.12
51,Spirits And Demons,Michael Ray With Meghan Patrick,597,93,504,73,0,1081100,159500,921600,599480,2023.10.12
52,Marry That Girl,Easton Corbin,552,-3,555,72,0,1073200,30300,1042900,225400,2023.10.12
53,Something Real,Dierks Bentley,503,-10,513,64,0,1065000,-50200,1115200,251748,2023.10.12
54,We Ride,Bryan Martin,439,94,345,44,0,1064100,154100,910000,3146770,2023.10.12
55,In Your Love,Tyler Childers,360,24,336,35,0,951100,54100,897000,5431366,2023.10.12
56,Dance With You,Brett Young,482,-22,504,66,0,942900,-88900,1031800,1506035,2023.10.12
57,Wine Country,Hannah Ellis,452,1,451,57,0,915300,-125300,1040600,79341,2023.10.12
58,Where The Wild Things Are,Luke Combs,188,91,97,31,0,864300,314200,550100,1548711,2023.10.12
59,Good With Me,Walker Hayes,270,0,270,37,0,678800,41300,637500,556335,2023.10.12
60,Brokenhearted,Joe Nichols,364,-16,380,50,0,674400,50800,623600,28350,2023.10.12
61,Without You,Thompson Square,436,-22,458,57,0,647100,-57300,704400,16738,2023.10.12
62,Thicc As Thieves,Lauren Alaina,251,-40,291,43,0,517900,-148600,666500,1049790,2023.10.12
63,She's Somebody's Daughter,Drew Baldridge,298,46,252,48,0,514600,96600,418000,428993,2023.10.12
64,Ain'T Got A Worry,Old Dominion,51,23,28,33,0,401200,144300,256900,402395,2023.10.12
65,'98 Braves,Morgan Wallen,65,6,59,2,0,379100,21400,357700,2782020,2023.10.12
66,I'm In Love,Hailey Whitters,135,101,34,36,0,348000,208400,139600,489501,2023.10.12
67,Find Another Bar,Chris Lane,340,2,338,51,0,345400,-29300,374700,439021,2023.10.12
68,Cancel,Randy Houser,197,49,148,28,0,332600,41200,291400,99753,2023.10.12
68,Cancelled,Randy Houser,197,49,148,28,0,332600,41200,291400,0,2023.10.12
70,Trouble,Josh Ross,308,-2,310,48,0,320800,-14700,335500,1524016,2023.10.12
71,Hey Driver,Zach Bryan Feat. The War and Treaty,58,,,56,0,306300,,,7999362,2023.10.12
72,Make Me Wanna Smoke,Runaway June,177,13,164,24,0,243000,1900,241100,25898,2023.10.12
73,Ain't Missin' You,Dylan Schneider,190,-7,197,28,0,201300,-18400,219700,940314,2023.10.12
74,This Side Of The Dirt,Neon Union,184,0,184,27,0,199100,-1000,200100,53777,2023.10.12
75,Man Made A Bar,Morgan Wallen,39,4,35,3,0,198400,500,197900,3276502,2023.10.12
76,Buy A Bar,Tim Dugger,80,-7,87,12,0,194000,8100,185900,19177,2023.10.12
77,Heart They Didn'T Break,Maddie & Tae,180,33,147,37,0,192200,33800,158400,788317,2023.10.12
78,Who Says You Can'T Have Everything,Brothers Osborne,32,,,32,0,192200,,,519125,2023.10.12
79,How Is She,Cole Swindell,27,1,26,1,0,181700,400,181300,65696,2023.10.12
80,Southern Comfort,Darius Rucker,37,,,37,0,175200,,,223789,2023.10.12
81,Save The Roses,Lee Brice,56,27,29,4,0,170000,97100,72900,679827,2023.10.12
82,Nothing Compares To You,Mickey Guyton Feat. Kane Brown,111,9,102,20,0,155500,6900,148600,922225,2023.10.12
83,I Should Have Married You,Old Dominion,20,,,20,0,123400,,,768838,2023.10.12
84,Love Drunk And Happy,Old Dominion,18,,,18,0,110600,,,215658,2023.10.12
85,Colorado,Florida Georgia Line,18,2,16,2,0,110200,8500,101700,49212,2023.10.12
86,Georgia Girl,Megan Moroney,17,-3,20,1,0,105100,-11400,116500,110012,2023.10.12
87,What's Up,Dolly Parton,47,,,47,0,103100,,,213570,2023.10.12
87,Talking To Milo,Caroline Jones,47,,,47,0,103100,,,2213,2023.10.12
87,Carolina Burns,Carter Faith,47,,,47,0,103100,,,23525,2023.10.12
90,Long Live Cowgirls,Ian Munsick & Cody Johnson,28,27,1,2,0,99100,97500,1600,858040,2023.10.12
91,Rain In The Rearview,Anne Wilson,87,80,7,22,0,94500,75700,18800,410575,2023.10.12
92,Don't Think Jesus,Morgan Wallen,26,21,5,24,0,91500,81000,10500,1178944,2023.10.12
93,Make You Mine,Marynn Taylor,78,-257,335,29,0,89600,-293900,383500,33675,2023.10.12
94,Oklahoma Sooner,Jake Banfield,23,-2,25,1,0,81900,-1000,82900,7770,2023.10.12
95,"Jesus, My Mama, My Therapist",Tiera Kennedy,84,-1,85,15,0,78200,-37400,115600,59944,2023.10.12
96,Honest Man,Allie Colleen,16,,,15,0,77200,,,1825,2023.10.12
97,Some Horses,Old Dominion,19,,,19,0,74100,,,816449,2023.10.12
98,Lovin You Gets In The Way,Ben Gallaher,18,0,18,2,0,65900,4000,61900,13005,2023.10.12
99,With You I Am,Cody Johnson,5,0,5,2,0,60200,-17600,77800,1632130,2023.10.12
100,Oklahoma Smokeshow,Zach Bryan,22,0,22,1,0,58800,3400,55400,5721117,2023.10.12
101,I'll Be Here,Colbie Caillat,22,5,17,3,0,58200,12600,45600,647665,2023.10.12
102,West Of Tulsa,Wyatt Flores,16,12,4,1,0,57400,41300,16100,333625,2023.10.12
103,Tulsa,Elle King,29,-3,32,2,0,54600,-10400,65000,50255,2023.10.12
104,Sarah's Place,Zach Bryan,10,,,1,0,53900,,,6695608,2023.10.12
105,Bad Man,Twinnie,85,28,57,18,0,51800,19400,32400,1011,2023.10.12
106,Sunday Saints,Jordan Davis,10,-5,15,1,0,51200,-40100,91300,43766,2023.10.12
107,Praise The Lord,Breland,8,,,8,0,50900,,,128337,2023.10.12
108,Silverado For Sale,Morgan Wallen,17,,,16,0,43700,,,1421445,2023.10.12
109,Quittin' Time,Morgan Wallen,13,2,11,1,0,43300,8200,35100,989584,2023.10.12
110,Love You Back,Lady A,11,-1,12,1,0,42800,-1000,43800,311961,2023.10.12
111,The Day I Stop Dancin',Jon Pardi,4,3,1,1,0,41500,37000,4500,50750,2023.10.12
112,Think I’m In Love With You,Chris Stapleton,20,14,6,1,0,40200,35300,4900,2662837,2023.10.12
113,Out Of Nowhere,Walker Montgomery,9,1,8,1,0,39300,13800,25500,8470,2023.10.12
114,Heart To Break,Ryan Griffin,43,0,43,3,0,37600,3500,34100,154672,2023.10.12
115,The Star-Spangled Banner,Chris Stapleton,11,5,6,10,0,37200,-900,38100,174130,2023.10.12
116,Gettin' By,Flatland Cavalry,2,,,1,0,36400,,,243709,2023.10.12
117,My Bar,Priscilla Block,9,0,9,3,0,34800,8400,26400,158625,2023.10.12
118,Tea Was A Little Sweeter,Matt Rogers,54,18,36,19,0,34600,10500,24100,2020,2023.10.12
119,Seven Year Ache,Aaron Watson & Jenna Paulette,5,2,3,1,0,33700,14300,19400,0,2023.10.12
120,But A Beer Can,Eric Burgett,56,21,35,18,0,32200,11200,21000,6882,2023.10.12
121,Ain'T About You,Huntergirl,15,-20,35,4,0,32200,-38000,70200,7321,2023.10.12
122,Silverado,Caleb Lee Hutchinson,55,-50,105,18,0,32000,-28700,60700,39428,2023.10.12
123,Back At The Bar,Landon Parker,54,-1,55,18,0,31800,-200,32000,2185,2023.10.12
124,Summer Soundtrack,Craig Campbell,53,21,32,18,0,31600,12100,19500,1458,2023.10.12
125,Summer To Me,Wayland,53,-1,54,18,0,31600,-200,31800,2099,2023.10.12
126,Under A Southern Sky,Ian Flanigan,53,-2,55,18,0,31500,-500,32000,12372,2023.10.12
127,Holy Water,Michael Ray,4,-6,10,2,0,31400,-22200,53600,259511,2023.10.12
128,Fix'N To Break,Bailey Zimmerman,14,-15,29,1,0,31300,-26600,57900,1856902,2023.10.12
129,That's Why We Fight,Ella Langley & Koe Wetzel,15,6,9,1,0,29600,24500,5100,925384,2023.10.12
130,Stop Coming Over,Chris Lane,12,6,6,6,0,28600,14300,14300,33829,2023.10.12
131,When Will I Be Loved,"Ashley McBryde, Caylee Hammack & Pillbox Patti",12,0,12,6,0,28600,0,28600,42529,2023.10.12
132,The Tree,Maren Morris,12,-5,17,1,0,28600,-14300,42900,1206517,2023.10.12
133,Leave You Alone,Kane Brown,6,1,5,6,0,28100,12200,15900,291403,2023.10.12
134,Black Magic,Rachel Lipsky,46,,,18,0,27500,,,106,2023.10.12
135,Still,Luke Combs,12,6,6,1,0,25600,12400,13200,307498,2023.10.12
136,Heart Attack,Boy Named Banjo,17,14,3,1,0,25500,15600,9900,5726,2023.10.12
137,You In A Honky Tonk,Randall King,4,1,3,2,0,24900,20700,4200,426671,2023.10.12
138,Halfway To Hell,Jelly Roll,4,,,1,0,24600,,,1281513,2023.10.12
139,Star Spangled Banner,Mickey Guyton,4,2,2,4,0,23800,14500,9300,0,2023.10.12
140,Sun To Me,Zach Bryan,14,0,14,2,0,23000,2200,20800,4896494,2023.10.12
141,Loud and Heavy,Cody Jinks,8,-4,12,3,0,22200,-1700,23900,1734307,2023.10.12
142,Breakin' In Boots,Matt Stell,7,6,1,5,0,21800,2300,19500,350949,2023.10.12
143,My Baby Does,Drew Parker,3,,,1,0,21700,,,4444,2023.10.12
144,West Texas Wind,NEEDTOBREATHE,10,,,9,0,21600,,,40429,2023.10.12
145,Heart On Ice,Jon Langston,5,-1,6,5,0,21500,-5000,26500,90496,2023.10.12
146,Loser,Mike Ryan,4,1,3,2,0,21400,5100,16300,15920,2023.10.12
147,Ol' Church Hymn,Darius Rucker Feat. Chapel Hart,4,-5,9,4,0,21300,-35300,56600,109817,2023.10.12
148,Gonna Love You,Parmalee,11,3,8,5,0,20700,-21000,41700,189258,2023.10.12
149,Songs We Used To Sing,Ernest,8,2,6,1,0,20600,7200,13400,68596,2023.10.12
150,We Ain't The Only Ones,Randy Rogers & Wade Bowen,2,0,2,2,0,20200,-16200,36400,0,2023.10.12
151,Star Spangled Banner,Abby Anderson,4,-3,7,4,0,20100,-17500,37600,0,2023.10.12
152,The Star-Spangled Banner,Carly Pearce,2,-1,3,2,0,19900,-3100,23000,0,2023.10.12
153,King Of Country Music,Ryan Larkins,2,,,2,0,19800,,,2,2023.10.12
154,How 'Bout Those Chiefs,Blane Howard,4,,,2,0,19200,,,0,2023.10.12
155,Thank God She's A Country Girl,Morgan Evans,3,,,3,0,19000,,,322834,2023.10.12
156,Sara,Darius Rucker,4,,,4,0,18900,,,163709,2023.10.12
157,The Great Divide,Luke Combs & Billy Strings,7,0,7,1,0,18700,0,18700,197186,2023.10.12
158,Ain'T A Train,Cody Jinks,1,0,1,1,0,18200,12100,6100,161483,2023.10.12
159,Love Is Real,Morgan Evans,6,2,4,1,0,18000,7400,10600,56283,2023.10.12
160,House Fire,Tyler Childers,6,0,6,1,0,18000,1200,16800,1129546,2023.10.12
161,Dear Friend,Lamont Landers,8,,,8,0,17900,,,0,2023.10.12
162,Ours,Taylor Swift,3,2,1,3,0,17700,14400,3300,139368,2023.10.12
163,High Time,Kacey Musgraves,6,1,5,1,0,17400,6500,10900,38581,2023.10.12
164,Country Music,Tuten Brothers,5,0,5,1,0,16700,8000,8700,2468,2023.10.12
165,Better Off,Trace Adkins,4,1,3,2,0,16300,3400,12900,14615,2023.10.12
166,Must Be The Whiskey,Cody Jinks,4,,,3,0,16300,,,1513504,2023.10.12
167,She's Gotta Know,Conner Sweet,24,-22,46,12,0,15800,-12500,28300,2054,2023.10.12
168,When It Comes To Loving You,Jon Langston,4,3,1,2,0,15500,7100,8400,101716,2023.10.12
169,Any Given Friday Night,Luke Combs,2,0,2,1,0,15200,0,15200,228737,2023.10.12
170,Only In A Small Town,RaeLynn,6,,,6,0,14300,,,6571,2023.10.12
170,These Days,MacKenzie Porter,6,,,6,0,14300,,,30811,2023.10.12
170,Beautiful Sky,Old Dominion,6,,,6,0,14300,,,316264,2023.10.12
170,A Million Things,Old Dominion,6,,,6,0,14300,,,382997,2023.10.12
170,Stay Drunk,Old Dominion,6,,,6,0,14300,,,406483,2023.10.12
175,Heart Of A Small Town,Tim Dugger,5,2,3,2,0,14000,-4100,18100,12002,2023.10.12
176,The Star Spangled Banner,Locash,1,,,1,0,13700,,,0,2023.10.12
177,Heartfirst,Kelsea Ballerini,3,2,1,1,0,13300,13000,300,428943,2023.10.12
178,National Anthem From Battle At Bristol,Jennifer Nettles,3,-1,4,3,0,12900,-3400,16300,0,2023.10.12
179,One Name,Jeff & Sheri Easter,2,1,1,2,0,12400,12000,400,17093,2023.10.12
180,Think About There,Greater Vision,2,0,2,2,0,12400,6700,5700,17454,2023.10.12
181,Minnets Yta,Opeth,1,,,1,0,12400,,,0,2023.10.12
182,Take It Slow,Conner Smith,5,,,5,0,12200,,,437976,2023.10.12
183,Decoration,Jillian Riscoe,6,0,6,1,0,11900,-1400,13300,27,2023.10.12
184,National Anthem,Pryor & Lee,4,,,4,0,11800,,,0,2023.10.12
185,Oklahoman Son,Zach Bryan,9,1,8,1,0,11700,700,11000,1862534,2023.10.12
186,Hey There Hometown,Abby Leigh Anderson,3,-142,145,1,0,11400,-585000,596400,2888,2023.10.12
187,No Present LIke The Time,Jay Allen,2,,,2,0,10900,,,0,2023.10.12
188,I Hope Heaven,Karissa Ella,19,1,18,18,0,10800,200,10600,0,2023.10.12
189,Daylight Savings,Kidd G,19,-47,66,4,0,10800,-55100,65900,79504,2023.10.12
190,Downtime,Roman Alexander,19,,,18,0,10800,,,33557,2023.10.12
191,Things I Take For Granted,Larry Fleet,1,,,1,0,10600,,,314145,2023.10.12
192,I'M Not For Everyone,Brothers Osborne,1,-2,3,1,0,10100,-7900,18000,493867,2023.10.12
193,Radioland,Ashley McBryde,1,-1,2,1,0,10000,-1600,11600,6897,2023.10.12
194,A Special Place,Danielle Bradbery,1,,,1,0,10000,,,72061,2023.10.12
195,Hang In There Girl,Ashley McBryde,1,,,1,0,9800,,,15148,2023.10.12
196,Giving You Up,Kameron Marlowe,2,-1,3,1,0,9700,-9400,19100,908891,2023.10.12
197,Star Spangled Banner,Demi Lovato,1,,,1,0,9400,,,123,2023.10.12
198,Saltwater Gospel,Eli Young Band & Jimmy Buffett,5,0,5,1,0,9000,1800,7200,118389,2023.10.12
199,On The Boat Again,Jake Owen,7,-3,10,1,0,8800,-26700,35500,125134,2023.10.12
200,Classic,Ernest,5,1,4,1,0,8400,800,7600,38988,2023.10.12
201,Make The Morning Worth The Midnight,Gaither Vocal Band,1,0,1,1,0,8400,0,8400,3778,2023.10.12
201,My Jesus,Anne Wilson,1,0,1,1,0,8400,0,8400,1356880,2023.10.12
203,Broadway Girls,Lil Durk Feat. Morgan Wallen,1,-1,2,1,0,8400,-6900,15300,4838265,2023.10.12
204,Home,Ernie Haase & Signature Sound And The Booth Brothers Feat. Paul Lancaster,1,,,1,0,8400,,,0,2023.10.12
204,Soundtrack To A Small Town Sundown,Tyler Farr,1,,,1,0,8400,,,8706,2023.10.12
204,Dust On The Altar,Mckamey Legacy,1,,,1,0,8400,,,132,2023.10.12
204,Glory,Steeles,1,,,1,0,8400,,,346,2023.10.12
204,Breakthrough,Browns,1,,,1,0,8400,,,15759,2023.10.12
204,I'Ll Fly Away,Reba Mcentire,1,,,1,0,8400,,,8538,2023.10.12
204,Tennessee Fan,Morgan Wallen,1,,,1,0,8400,,,1672331,2023.10.12
204,Country A$$ Shit,Morgan Wallen,1,,,1,0,8400,,,564444,2023.10.12
204,God's Been Good,LeFevre Quartet,1,,,1,0,8400,,,1418,2023.10.12
204,I'Ve Seen What He Can Do,Legacy Five,1,,,1,0,8400,,,7808,2023.10.12
1,Thinkin' Bout Me,Morgan Wallen,8113,439,7674,142,0,32473700,1641600,30832100,14190587,2023.10.19
2,Try That In A Small Town,Jason Aldean,8201,815,7386,144,0,31815800,2432100,29383700,5713604,2023.10.19
3,Watermelon Moonshine,Lainey Wilson,6957,-1128,8085,144,0,27064300,-3973000,31037300,7271413,2023.10.19
4,God Gave Me A Girl,Russell Dickerson,6692,-81,6773,144,0,25638900,18900,25620000,1314384,2023.10.19
5,Stars Like Confetti,Dustin Lynch,6424,151,6273,143,0,24590800,1169700,23421100,1259490,2023.10.19
6,Fast Car,Luke Combs,5184,-77,5261,144,0,23638700,-346800,23985500,14190318,2023.10.19
7,Can'T Have Mine,Dylan Scott,5751,401,5350,144,0,21132300,1283800,19848500,2872793,2023.10.19
8,Standing Room Only,Tim McGraw,5570,15,5555,144,0,19837800,-165000,20002800,2493659,2023.10.19
9,Everything I Love,Morgan Wallen,4996,-133,5129,143,0,18824900,190500,18634400,3526108,2023.10.19
10,Save Me,Jelly Roll & Lainey Wilson,4586,687,3899,144,0,18147500,2805000,15342500,9063740,2023.10.19
11,But I Got A Beer In My Hand,Luke Bryan,4683,124,4559,144,0,17510800,126300,17384500,2316963,2023.10.19
12,Mind On You,George Birge,4167,292,3875,144,0,14811100,1475400,13335700,380555,2023.10.19
13,Save Me The Trouble,Dan + Shay,4120,120,4000,144,0,14704900,575900,14129000,2175023,2023.10.19
14,All I Need Is You,Chris Janson,3653,-45,3698,144,0,12768000,459400,12308600,653116,2023.10.19
15,World On Fire,Nate Smith,3247,243,3004,139,0,11487600,1063700,10423900,3453602,2023.10.19
16,White Horse,Chris Stapleton,3338,-1,3339,144,0,11448600,251400,11197200,9249480,2023.10.19
17,We Got History,Mitchell Tenpenny,3342,106,3236,142,0,11348800,891000,10457800,1235919,2023.10.19
18,If You Go Down (I'M Going Down Too),Kelsea Ballerini,3343,-97,3440,143,0,10617700,-511700,11129400,1138792,2023.10.19
19,Different 'Round Here,Riley Green,2997,136,2861,144,0,10524400,713700,9810700,3700305,2023.10.19
20,23,Chayce Beckham,2857,56,2801,141,0,8936200,255800,8680400,3186255,2023.10.19
21,Creek Will Rise,Conner Smith,2900,-21,2921,144,0,8151300,34100,8117200,734066,2023.10.19
22,Light On In The Kitchen,Ashley McBryde,2756,115,2641,143,0,7421600,204200,7217400,1069296,2023.10.19
23,Pretty Little Poison,Warren Zeiders,2317,174,2143,136,0,6785900,416100,6369800,5540774,2023.10.19
24,The Painter,Cody Johnson,1832,85,1747,139,0,5987200,204700,5782500,5218123,2023.10.19
25,Nobody's Nobody,Brothers Osborne,2146,-42,2188,141,0,5733500,-120900,5854400,1406436,2023.10.19
26,I Can Feel It,Kane Brown,1611,192,1419,126,0,5654000,472400,5181600,2561768,2023.10.19
27,Truck Bed,Hardy,2019,102,1917,135,0,5609100,420800,5188300,6242953,2023.10.19
28,Cowboys And Plowboys,Jon Pardi & Luke Bryan,1101,,,111,0,5168600,,,2005062,2023.10.19
29,Fearless,Jackson Dean,1815,99,1716,141,0,4999400,39700,4959700,1058446,2023.10.19
30,Tucson Too Late,Jordan Davis,1206,192,1014,108,0,4658900,1149100,3509800,1145776,2023.10.19
31,See You Next Summer,Brian Kelley,1757,101,1656,140,0,4306200,-23800,4330000,537138,2023.10.19
32,Burn It Down,Parker Mccollum,1533,31,1502,134,0,4223700,-142900,4366600,3836401,2023.10.19
33,I Remember Everything,Zach Bryan Feat. Kacey Musgraves,1224,-108,1332,85,0,4036100,-530100,4566200,23826683,2023.10.19
34,Mamaw's House,Thomas Rhett,860,158,702,107,0,3666200,593600,3072600,3013769,2023.10.19
35,Glory Days,Gabby Barrett,1490,-74,1564,139,0,3655500,8500,3647000,1689686,2023.10.19
36,Cab In A Solo,Scotty McCreery,1478,1,1477,141,0,3535000,10000,3525000,746360,2023.10.19
37,We Don'T Fight Anymore,Carly Pearce,1259,14,1245,136,0,3162800,-8600,3171400,2878744,2023.10.19
38,I'M Not Pretty,Megan Moroney,1101,41,1060,110,0,3007000,131700,2875300,2331403,2023.10.19
39,Out Of That Truck,Carrie Underwood,1268,32,1236,125,0,2998600,42000,2956600,1847312,2023.10.19
40,Back Then Right Now,Tyler Hubbard,1046,-29,1075,91,0,2943700,-76100,3019800,1197220,2023.10.19
41,Where The Wild Things Are,Luke Combs,582,394,188,80,0,2890300,2026000,864300,1727665,2023.10.19
42,Outskirts,Sam Hunt,863,59,804,93,0,2329900,357700,1972200,2553112,2023.10.19
43,Love You Again,Chase Matthew,801,-26,827,59,0,2089600,-91300,2180900,2511567,2023.10.19
44,Drive You Out Of My Mind,Kassi Ashton,831,-4,835,104,0,1843500,-70400,1913900,454694,2023.10.19
45,Giving Up On That,Dalton Dover,848,-63,911,90,0,1822800,-234600,2057400,987767,2023.10.19
46,Young Love & Saturday Nights,Chris Young,510,51,459,53,0,1676300,76900,1599400,658001,2023.10.19
47,Drinkin' Problems,Dillon Carmichael,783,-6,789,90,0,1540500,69900,1470600,80869,2023.10.19
48,Something's Gonna Kill Me,Corey Kent,656,13,643,70,0,1525400,52800,1472600,2348494,2023.10.19
49,Where It Ends,Bailey Zimmerman,389,47,342,40,0,1435500,-2200,1437700,2493852,2023.10.19
50,We Ride,Bryan Martin,486,47,439,50,0,1223900,159800,1064100,3463785,2023.10.19
51,Can't Break Up Now,Old Dominion,486,-46,532,73,0,1170600,-340400,1511000,1638015,2023.10.19
52,Spirits And Demons,Michael Ray With Meghan Patrick,609,12,597,75,0,1036700,-44400,1081100,571437,2023.10.19
53,In Your Love,Tyler Childers,375,15,360,40,0,1002700,51600,951100,5426072,2023.10.19
54,Marry That Girl,Easton Corbin,521,-31,552,69,0,998700,-74500,1073200,231706,2023.10.19
55,Something Real,Dierks Bentley,477,-26,503,62,0,986800,-78200,1065000,180574,2023.10.19
56,Wine Country,Hannah Ellis,493,41,452,59,0,883800,-31500,915300,77540,2023.10.19
57,Dance With You,Brett Young,458,-24,482,67,0,876600,-66300,942900,1537254,2023.10.19
58,Brokenhearted,Joe Nichols,382,18,364,58,0,655000,-19400,674400,28471,2023.10.19
59,Good With Me,Walker Hayes,258,-12,270,34,0,644500,-34300,678800,670789,2023.10.19
60,I'm In Love,Hailey Whitters,272,137,135,44,0,580300,232300,348000,524032,2023.10.19
61,Thicc As Thieves,Lauren Alaina,270,19,251,44,0,550800,32900,517900,947989,2023.10.19
62,Without You,Thompson Square,370,-66,436,53,0,550500,-96600,647100,17829,2023.10.19
63,She's Somebody's Daughter,Drew Baldridge,353,55,298,48,0,498300,-16300,514600,429369,2023.10.19
64,Bigger Than The Song,Brittney Spencer,105,,,57,0,419100,,,343929,2023.10.19
65,Find Another Bar,Chris Lane,349,9,340,52,0,377600,32200,345400,312207,2023.10.19
66,Cancel,Randy Houser,227,30,197,41,0,316000,-16600,332600,76685,2023.10.19
66,Cancelled,Randy Houser,227,30,197,41,0,316000,-16600,332600,0,2023.10.19
68,Trouble,Josh Ross,308,0,308,48,0,301600,-19200,320800,1647438,2023.10.19
69,Make Me Wanna Smoke,Runaway June,175,-2,177,36,0,239600,-3400,243000,29667,2023.10.19
70,That's Texas,Cody Johnson,16,,,3,0,204400,,,1432682,2023.10.19
71,Ain't Missin' You,Dylan Schneider,175,-15,190,27,0,198900,-2400,201300,1092851,2023.10.19
72,Man Made A Bar,Morgan Wallen,34,-5,39,3,0,194000,-4400,198400,3145827,2023.10.19
73,This Side Of The Dirt,Neon Union,195,11,184,28,0,185200,-13900,199100,44613,2023.10.19
74,Nothing Compares To You,Mickey Guyton Feat. Kane Brown,125,14,111,33,0,176200,20700,155500,931936,2023.10.19
75,Beer For Santa,Jon Pardi,37,,,37,0,175200,,,0,2023.10.19
76,'98 Braves,Morgan Wallen,34,-31,65,3,0,171500,-207600,379100,2747057,2023.10.19
77,Heart They Didn'T Break,Maddie & Tae,175,-5,180,28,0,166700,-25500,192200,970818,2023.10.19
78,Ain'T Got A Worry,Old Dominion,18,-33,51,2,0,152500,-248700,401200,322246,2023.10.19
79,Georgia Girl,Megan Moroney,23,6,17,1,0,151700,46600,105100,100478,2023.10.19
80,How Is She,Cole Swindell,23,-4,27,1,0,140300,-41400,181700,67581,2023.10.19
81,Buy A Bar,Tim Dugger,62,-18,80,10,0,136600,-57400,194000,18124,2023.10.19
82,Rain In The Rearview,Anne Wilson,121,34,87,24,0,123200,28700,94500,380253,2023.10.19
83,Sarah's Place,Zach Bryan,19,9,10,1,0,110100,56200,53900,5815788,2023.10.19
84,Save The Roses,Lee Brice,39,-17,56,3,0,108300,-61700,170000,661999,2023.10.19
85,Long Live Cowgirls,Ian Munsick & Cody Johnson,42,14,28,5,0,108200,9100,99100,864746,2023.10.19
86,Cry Myself To Sleep,Wynonna & Trisha Yearwood,47,,,47,0,103100,,,0,2023.10.19
87,The Boy Who Cried Drunk (The Demo),Meghan Patrick,46,,,46,0,99300,,,22271,2023.10.19
88,Colorado,Florida Georgia Line,15,-3,18,2,0,92900,-17300,110200,47942,2023.10.19
89,Oklahoma Sooner,Jake Banfield,26,3,23,1,0,87600,5700,81900,7198,2023.10.19
90,King Of Country Music,Ryan Larkins,19,17,2,7,0,78900,59100,19800,49252,2023.10.19
91,"Jesus, My Mama, My Therapist",Tiera Kennedy,80,-4,84,15,0,78900,700,78200,55672,2023.10.19
92,With You I Am,Cody Johnson,5,0,5,2,0,76700,16500,60200,1616435,2023.10.19
93,Make You Mine,Marynn Taylor,63,-15,78,27,0,66400,-23200,89600,39812,2023.10.19
94,Tulsa,Elle King,23,-6,29,2,0,63500,8900,54600,47887,2023.10.19
95,The Star-Spangled Banner,Chris Stapleton,13,2,11,13,0,56400,19200,37200,181767,2023.10.19
96,My Bar,Priscilla Block,11,2,9,4,0,53900,19100,34800,153500,2023.10.19
97,Oklahoma Smokeshow,Zach Bryan,21,-1,22,1,0,53500,-5300,58800,5809692,2023.10.19
98,Think I’m In Love With You,Chris Stapleton,25,5,20,1,0,51300,11100,40200,2628408,2023.10.19
99,Sunday Saints,Jordan Davis,10,0,10,1,0,51200,0,51200,43241,2023.10.19
100,I'll Be Here,Colbie Caillat,23,1,22,3,0,50700,-7500,58200,582439,2023.10.19
101,Holy Water,Michael Ray,9,5,4,2,0,50500,19100,31400,246463,2023.10.19
102,Still,Luke Combs,14,2,12,1,0,46000,20400,25600,293709,2023.10.19
103,Quittin' Time,Morgan Wallen,15,2,13,1,0,43700,400,43300,959050,2023.10.19
104,Don'T Let The Old Man In,Toby Keith,8,,,8,0,43100,,,310987,2023.10.19
105,Ain'T About You,Huntergirl,48,33,15,9,0,43000,10800,32200,7099,2023.10.19
106,Heart To Break,Ryan Griffin,45,2,43,4,0,42900,5300,37600,171288,2023.10.19
107,Out Of Nowhere,Walker Montgomery,10,1,9,1,0,42900,3600,39300,8643,2023.10.19
108,Tea Was A Little Sweeter,Matt Rogers,72,18,54,18,0,42400,7800,34600,2008,2023.10.19
109,West Of Tulsa,Wyatt Flores,13,-3,16,1,0,38200,-19200,57400,294788,2023.10.19
110,Star Spangled Banner,Abby Anderson,5,1,4,5,0,36900,16800,20100,2,2023.10.19
111,The Star-Spangled Banner,Carly Pearce,4,2,2,4,0,36200,16300,19900,0,2023.10.19
112,The Tree,Maren Morris,16,4,12,1,0,33300,4700,28600,1130100,2023.10.19
113,Summer Soundtrack,Craig Campbell,56,3,53,18,0,32200,600,31600,1271,2023.10.19
114,Black Magic,Rachel Lipsky,55,9,46,18,0,32000,4500,27500,142,2023.10.19
115,She's Gotta Know,Conner Sweet,54,30,24,18,0,31800,16000,15800,1027,2023.10.19
116,Under A Southern Sky,Ian Flanigan,53,0,53,18,0,31600,100,31500,11498,2023.10.19
117,Heart Attack,Boy Named Banjo,16,-1,17,1,0,29200,3700,25500,5362,2023.10.19
118,Gonna Love You,Parmalee,22,11,11,6,0,28300,7600,20700,193473,2023.10.19
119,Fix'N To Break,Bailey Zimmerman,15,1,14,1,0,28200,-3100,31300,1760776,2023.10.19
120,Country Music,Tuten Brothers,9,4,5,1,0,25700,9000,16700,2127,2023.10.19
121,When Will I Be Loved,"Ashley McBryde, Caylee Hammack & Pillbox Patti",10,-2,12,6,0,23400,-5200,28600,31488,2023.10.19
122,Sunrise Tells The Story,Midland,2,,,1,0,22700,,,161944,2023.10.19
123,Summer To Me,Wayland,36,-17,53,18,0,21200,-10400,31600,1819,2023.10.19
124,That's Why We Fight,Ella Langley & Koe Wetzel,11,-4,15,1,0,21100,-8500,29600,854801,2023.10.19
125,Downtime,Roman Alexander,35,16,19,18,0,21000,10200,10800,27034,2023.10.19
126,If It Wasn't For Trucks,Riley Green,8,5,3,7,0,21000,19700,1300,547152,2023.10.19
127,Back At The Bar,Landon Parker,35,-19,54,18,0,21000,-10800,31800,1596,2023.10.19
128,Silverado,Caleb Lee Hutchinson,35,-20,55,18,0,21000,-11000,32000,22087,2023.10.19
129,But A Beer Can,Eric Burgett,35,-21,56,18,0,21000,-11200,32200,6564,2023.10.19
130,Bad Man,Twinnie,35,-50,85,18,0,21000,-30800,51800,907,2023.10.19
131,Heart Of A Small Town,Tim Dugger,4,-1,5,2,0,20800,6800,14000,10614,2023.10.19
132,Seven Minutes In Heaven,Reba Mcentire,6,5,1,2,0,20700,13100,7600,293780,2023.10.19
133,Love You Back,Lady A,8,-3,11,1,0,18700,-24100,42800,314744,2023.10.19
134,Think About There,Greater Vision,3,1,2,3,0,18600,6200,12400,18524,2023.10.19
135,Two Woman Man,Randall Fowler,32,,,18,0,18600,,,775,2023.10.19
136,Watching My Old Flame,Cody Johnson,1,0,1,1,0,18200,16200,2000,1382011,2023.10.19
137,Work Boots,Cody Johnson,1,,,1,0,18200,,,734471,2023.10.19
137,Rhinestoned,"Randy Rogers ,Wade Bowen",1,,,1,0,18200,,,28075,2023.10.19
139,Dear Friend,Lamont Landers,8,0,8,8,0,17900,0,17900,0,2023.10.19
140,Broadway Girls,Lil Durk Feat. Morgan Wallen,3,2,1,1,0,17300,8900,8400,4561036,2023.10.19
141,The Weight Of The Badge,George Strait,2,,,2,0,16300,,,52045,2023.10.19
142,Any Given Friday Night,Luke Combs,2,0,2,1,0,15200,0,15200,226289,2023.10.19
143,County Roads,Elvie Shane,2,,,1,0,15200,,,110855,2023.10.19
144,Halfway To Hell,Jelly Roll,2,-2,4,1,0,14400,-10200,24600,1472983,2023.10.19
145,"Salt, Lime & Tequila",Ryan Griffin,6,5,1,6,0,14300,13600,700,66598,2023.10.19
146,Polaroid,Keith Urban,6,,,6,0,14300,,,12232,2023.10.19
146,Hungover You,Emily Brooke,6,,,6,0,14300,,,702,2023.10.19
146,Peaked In High School,Priscilla Block,6,,,6,0,14300,,,14436,2023.10.19
146,"'Beer Beer, Truck Truck'",George Birge,6,,,6,0,14300,,,32912,2023.10.19
146,Just Drive,Erin Kinsey,6,,,6,0,14300,,,107661,2023.10.19
146,Both Sides Of The Bed,Old Dominion,6,,,6,0,14300,,,126536,2023.10.19
152,Lovin You Gets In The Way,Ben Gallaher,8,-10,18,2,0,14200,-51700,65900,12387,2023.10.19
153,House Fire,Tyler Childers,7,1,6,1,0,13900,-4100,18000,1113073,2023.10.19
154,Better Off,Trace Adkins,3,-1,4,1,0,12900,-3400,16300,15023,2023.10.19
155,High Time,Kacey Musgraves,6,0,6,1,0,12800,-4600,17400,37317,2023.10.19
156,Daylight Savings,Kidd G,18,-1,19,3,0,12800,2000,10800,65519,2023.10.19
157,Testify,Legacy Five,2,,,2,0,12800,,,4729,2023.10.19
158,Breakin' In Boots,Matt Stell,22,15,7,6,0,12700,-9100,21800,335785,2023.10.19
159,All Things,Sound,2,1,1,2,0,12400,7100,5300,14112,2023.10.19
160,The Star Spangled Banner,Brad Paisley,2,0,2,2,0,12400,6100,6300,0,2023.10.19
161,Heartless,Diplo & Julia Michaels Feat. Morgan Wallen,2,0,2,2,0,12100,5600,6500,5291585,2023.10.19
162,Songs We Used To Sing,Ernest,7,-1,8,1,0,11900,-8700,20600,74808,2023.10.19
163,Don't Go Changing,Kip Moore,6,,,6,0,11800,,,14953,2023.10.19
164,Runnin' Through That T,Thomas Edwards,1,,,1,0,11700,,,6510,2023.10.19
165,God Only Knows,for King & Country,2,1,1,1,0,11600,10300,1300,1033437,2023.10.19
166,Loud and Heavy,Cody Jinks,5,-3,8,1,0,11500,-10700,22200,1642351,2023.10.19
167,Sun To Me,Zach Bryan,10,-4,14,2,0,11500,-11500,23000,4808867,2023.10.19
168,The Great Divide,Luke Combs & Billy Strings,6,-1,7,1,0,11400,-7300,18700,201811,2023.10.19
169,Wild,Carter Faith,8,,,1,0,11400,,,288396,2023.10.19
170,Tuggin' On My Heartstrings,Randall King,3,0,3,1,0,11000,5300,5700,31436,2023.10.19
171,Star Spangled Banner,Demi Lovato,2,1,1,2,0,10900,1500,9400,105,2023.10.19
172,Never Not God,Sound,2,1,1,2,0,10200,4900,5300,16792,2023.10.19
173,Raise The Roof,Christian Beck,5,2,3,1,0,9800,5100,4700,198,2023.10.19
174,Mountain With A View,Kelsea Ballerini,6,2,4,1,0,9800,2900,6900,1098634,2023.10.19
175,Arkansas,Chris Stapleton,6,0,6,1,0,9700,5500,4200,486231,2023.10.19
176,Don't Think Jesus,Morgan Wallen,5,-21,26,2,0,9500,-82000,91500,1121728,2023.10.19
177,Oklahoman Son,Zach Bryan,7,-2,9,1,0,9400,-2300,11700,1727072,2023.10.19
178,I'M Not For Everyone,Brothers Osborne,2,1,1,2,0,9300,-800,10100,495902,2023.10.19
179,National Anthem,Pryor & Lee,3,-1,4,3,0,9300,-2500,11800,0,2023.10.19
180,El Jefe,Shakira & Fuerza Regida,1,,,1,0,9300,,,4485195,2023.10.19
180,Where She Goes,Bad Bunny,1,,,1,0,9300,,,9611498,2023.10.19
182,Hey There Hometown,Abby Leigh Anderson,3,0,3,2,0,9200,-2200,11400,2311,2023.10.19
183,National Anthem From Battle At Bristol,Jennifer Nettles,2,-1,3,2,0,9200,-3700,12900,0,2023.10.19
184,Star Spangled Banner,Maren Morris,1,,,1,0,9000,,,0,2023.10.19
185,In Love With My Problems,Larry Fleet Feat. Jon Pardi,5,0,5,1,0,8800,2300,6500,108460,2023.10.19
186,White House Road,Tyler Childers & The Highwall,3,0,3,2,0,8500,1400,7100,2644751,2023.10.19
187,The Building,Emily Ann Roberts,1,0,1,1,0,8400,900,7500,36411,2023.10.19
187,By Your Grace,Cody Johnson,1,0,1,1,0,8400,900,7500,517085,2023.10.19
189,"The Father, My Son, And The Holy Ghost",Craig Morgan,1,-1,2,1,0,8400,3900,4500,61770,2023.10.19
190,When It Comes To Loving You,Jon Langston,1,-3,4,1,0,8400,-7100,15500,101923,2023.10.19
191,Silverado For Sale,Morgan Wallen,1,-16,17,1,0,8400,-35300,43700,1320273,2023.10.19
192,Gettin' Ready To Breathe,Wes Hampton,1,,,1,0,8400,,,18565,2023.10.19
192,Somebody's Problem,Morgan Wallen,1,,,1,0,8400,,,3068641,2023.10.19
192,Clear Skies,Ernie Haase & Signature Sound,1,,,1,0,8400,,,1547,2023.10.19
192,Calvary's Touch,Perrys,1,,,1,0,8400,,,13100,2023.10.19
196,Dirty Looks,Lainey Wilson,2,1,1,2,0,8200,7300,900,1076497,2023.10.19
197,Star Spangled Banner,P!Nk,1,,,1,0,8200,,,0,2023.10.19
198,Everything Has Your Memory,Wade Bowen,2,1,1,2,0,8100,2000,6100,10402,2023.10.19
199,Love You A Little Bit,Tanner Adell,7,2,5,1,0,7600,4100,3500,85516,2023.10.19
200,Things I Take For Granted,Larry Fleet,1,0,1,1,0,7600,-3000,10600,362148,2023.10.19
201,I Will (When You Do),Avery Anna,1,,,1,0,7600,,,1302363,2023.10.19
201,Excuse The Mess,Ella Langley,1,,,1,0,7600,,,77342,2023.10.19
201,Things I Can’t Control (Feat.,Charlie Worsham,1,,,1,0,7600,,,184439,2023.10.19
1,Thinkin' Bout Me,Morgan Wallen,8147,34,8113,143,0,33002500,528800,32473700,14396765,2023.10.26
2,Try That In A Small Town,Jason Aldean,7886,-315,8201,144,0,30927800,-888000,31815800,5561871,2023.10.26
3,God Gave Me A Girl,Russell Dickerson,7135,443,6692,144,0,27537900,1899000,25638900,1339744,2023.10.26
4,Stars Like Confetti,Dustin Lynch,6324,-100,6424,143,0,25271300,680500,24590800,1427495,2023.10.26
5,Fast Car,Luke Combs,5199,15,5184,144,0,23419500,-219200,23638700,12338172,2023.10.26
6,Can'T Have Mine,Dylan Scott,6169,418,5751,144,0,22279800,1147500,21132300,2903553,2023.10.26
7,Watermelon Moonshine,Lainey Wilson,5409,-1548,6957,144,0,21880600,-5183700,27064300,5412009,2023.10.26
8,Save Me,Jelly Roll & Lainey Wilson,5141,555,4586,144,0,20142000,1994500,18147500,8894723,2023.10.26
9,Everything I Love,Morgan Wallen,5226,230,4996,143,0,20136000,1311100,18824900,3708411,2023.10.26
10,Standing Room Only,Tim McGraw,5502,-68,5570,144,0,20091700,253900,19837800,2159850,2023.10.26
11,But I Got A Beer In My Hand,Luke Bryan,4636,-47,4683,144,0,17048400,-462400,17510800,2185456,2023.10.26
12,Save Me The Trouble,Dan + Shay,4311,191,4120,144,0,15714900,1010000,14704900,2143067,2023.10.26
13,Mind On You,George Birge,4180,13,4167,144,0,15042800,231700,14811100,408932,2023.10.26
14,All I Need Is You,Chris Janson,3753,100,3653,144,0,13040000,272000,12768000,628911,2023.10.26
15,World On Fire,Nate Smith,3407,160,3247,141,0,12419000,931400,11487600,3422060,2023.10.26
16,White Horse,Chris Stapleton,3432,94,3338,144,0,12195200,746600,11448600,9158483,2023.10.26
17,We Got History,Mitchell Tenpenny,3458,116,3342,143,0,12133100,784300,11348800,1217205,2023.10.26
18,Different 'Round Here,Riley Green,3212,215,2997,144,0,11339400,815000,10524400,2664340,2023.10.26
19,If You Go Down (I'M Going Down Too),Kelsea Ballerini,3396,53,3343,144,0,10989500,371800,10617700,1099683,2023.10.26
20,23,Chayce Beckham,2859,2,2857,142,0,9078700,142500,8936200,3354814,2023.10.26
21,Creek Will Rise,Conner Smith,3044,144,2900,144,0,8905200,753900,8151300,862814,2023.10.26
22,Pretty Little Poison,Warren Zeiders,2388,71,2317,137,0,7499300,713400,6785900,8363173,2023.10.26
23,Light On In The Kitchen,Ashley McBryde,2638,-118,2756,144,0,7215500,-206100,7421600,1027231,2023.10.26
24,The Painter,Cody Johnson,1906,74,1832,141,0,6447300,460100,5987200,4907626,2023.10.26
25,I Can Feel It,Kane Brown,1774,163,1611,139,0,6091100,437100,5654000,3590455,2023.10.26
26,Nobody's Nobody,Brothers Osborne,2255,109,2146,141,0,5852200,118700,5733500,1245284,2023.10.26
27,Truck Bed,Hardy,2055,36,2019,139,0,5734000,124900,5609100,6449791,2023.10.26
28,Fearless,Jackson Dean,1822,7,1815,141,0,5146900,147500,4999400,1145791,2023.10.26
29,Where The Wild Things Are,Luke Combs,1109,527,582,101,0,5003300,2113000,2890300,2074887,2023.10.26
30,Tucson Too Late,Jordan Davis,1277,71,1206,133,0,4824000,165100,4658900,1253165,2023.10.26
31,Burn It Down,Parker Mccollum,1591,58,1533,134,0,4767400,543700,4223700,5753960,2023.10.26
32,See You Next Summer,Brian Kelley,1728,-29,1757,140,0,4439800,133600,4306200,579732,2023.10.26
33,Mamaw's House,Thomas Rhett,1012,152,860,113,0,4046600,380400,3666200,3070587,2023.10.26
34,Glory Days,Gabby Barrett,1626,136,1490,140,0,3961500,306000,3655500,1475236,2023.10.26
35,I Remember Everything,Zach Bryan Feat. Kacey Musgraves,1204,-20,1224,93,0,3920800,-115300,4036100,23203542,2023.10.26
36,Cab In A Solo,Scotty McCreery,1507,29,1478,142,0,3560800,25800,3535000,761115,2023.10.26
37,We Don'T Fight Anymore,Carly Pearce,1339,80,1259,138,0,3383500,220700,3162800,2853705,2023.10.26
38,Out Of That Truck,Carrie Underwood,1329,61,1268,128,0,3158400,159800,2998600,1593529,2023.10.26
39,I'M Not Pretty,Megan Moroney,1131,30,1101,110,0,2984600,-22400,3007000,2649102,2023.10.26
40,Back Then Right Now,Tyler Hubbard,1084,38,1046,105,0,2984100,40400,2943700,1548018,2023.10.26
41,Outskirts,Sam Hunt,917,54,863,105,0,2465200,135300,2329900,2134586,2023.10.26
42,Love You Again,Chase Matthew,798,-3,801,57,0,2194700,105100,2089600,2598710,2023.10.26
43,Drive You Out Of My Mind,Kassi Ashton,821,-10,831,107,0,2001600,158100,1843500,429592,2023.10.26
44,Young Love & Saturday Nights,Chris Young,566,56,510,61,0,1998100,321800,1676300,774526,2023.10.26
45,Cowboys And Plowboys,Jon Pardi & Luke Bryan,484,-617,1101,85,0,1837000,-3331600,5168600,1022387,2023.10.26
46,Something's Gonna Kill Me,Corey Kent,685,29,656,67,0,1683200,157800,1525400,2689830,2023.10.26
47,Drinkin' Problems,Dillon Carmichael,821,38,783,93,0,1650300,109800,1540500,85814,2023.10.26
48,Where It Ends,Bailey Zimmerman,411,22,389,44,0,1462100,26600,1435500,2567287,2023.10.26
49,Spirits And Demons,Michael Ray With Meghan Patrick,721,112,609,78,0,1422800,386100,1036700,298838,2023.10.26
50,Can't Break Up Now,Old Dominion,534,48,486,71,0,1340100,169500,1170600,1570661,2023.10.26
51,We Ride,Bryan Martin,494,8,486,50,0,1172100,-51800,1223900,3742480,2023.10.26
52,In Your Love,Tyler Childers,390,15,375,43,0,1027900,25200,1002700,5164037,2023.10.26
53,Marry That Girl,Easton Corbin,531,10,521,69,0,981800,-16900,998700,203188,2023.10.26
54,Dance With You,Brett Young,445,-13,458,65,0,845200,-31400,876600,1563495,2023.10.26
55,Wine Country,Hannah Ellis,453,-40,493,59,0,811400,-72400,883800,72086,2023.10.26
56,Good With Me,Walker Hayes,264,6,258,35,0,612400,-32100,644500,570522,2023.10.26
57,She's Somebody's Daughter,Drew Baldridge,407,54,353,52,0,605000,106700,498300,413497,2023.10.26
58,Thicc As Thieves,Lauren Alaina,276,6,270,40,0,587500,36700,550800,886306,2023.10.26
59,Brokenhearted,Joe Nichols,356,-26,382,51,0,559600,-95400,655000,34185,2023.10.26
60,I'm In Love,Hailey Whitters,305,33,272,49,0,528900,-51400,580300,478356,2023.10.26
61,Without You,Thompson Square,298,-72,370,44,0,500300,-50200,550500,26518,2023.10.26
62,Find Another Bar,Chris Lane,397,48,349,70,0,415600,38000,377600,449754,2023.10.26
63,Cancel,Randy Houser,251,24,227,33,0,391800,75800,316000,67180,2023.10.26
63,Cancelled,Randy Houser,251,24,227,33,0,391800,75800,316000,0,2023.10.26
65,That's Texas,Cody Johnson,35,19,16,3,0,330200,125800,204400,718578,2023.10.26
66,Trouble,Josh Ross,297,-11,308,48,0,328000,26400,301600,1756819,2023.10.26
67,Breakin' In Boots,Matt Stell,74,52,22,60,0,311200,298500,12700,218470,2023.10.26
68,Make Me Wanna Smoke,Runaway June,169,-6,175,27,0,254200,14600,239600,36735,2023.10.26
69,Ain't Missin' You,Dylan Schneider,183,8,175,26,0,242000,43100,198900,969381,2023.10.26
70,Heart They Didn'T Break,Maddie & Tae,191,16,175,31,0,241800,75100,166700,822062,2023.10.26
71,How Is She,Cole Swindell,28,5,23,1,0,203400,63100,140300,63158,2023.10.26
72,Long Live Cowgirls,Ian Munsick & Cody Johnson,83,41,42,20,0,195400,87200,108200,838064,2023.10.26
73,Man Made A Bar,Morgan Wallen,33,-1,34,2,0,194600,600,194000,3137410,2023.10.26
74,This Side Of The Dirt,Neon Union,187,-8,195,29,0,165200,-20000,185200,45050,2023.10.26
75,Georgia Girl,Megan Moroney,24,1,23,1,0,157800,6100,151700,98226,2023.10.26
76,Ain'T Got A Worry,Old Dominion,17,-1,18,1,0,152500,0,152500,279920,2023.10.26
77,Ain'T About You,Huntergirl,142,94,48,29,0,138300,95300,43000,8947,2023.10.26
78,Buy A Bar,Tim Dugger,58,-4,62,9,0,136400,-200,136600,18162,2023.10.26
79,King Of Country Music,Ryan Larkins,35,16,19,7,0,119000,40100,78900,53051,2023.10.26
80,Nothing Compares To You,Mickey Guyton Feat. Kane Brown,101,-24,125,21,0,119000,-57200,176200,919593,2023.10.26
81,Sarah's Place,Zach Bryan,18,-1,19,1,0,118700,8600,110100,5274677,2023.10.26
82,Meant For Me,Colbie Caillat,48,,,47,0,111300,,,176167,2023.10.26
83,Rain In The Rearview,Anne Wilson,115,-6,121,23,0,105800,-17400,123200,376994,2023.10.26
84,Probably Shouldn'T,Anna Vaus,47,,,47,0,103100,,,1543,2023.10.26
84,Sad In The Summer,Diplo & Lily Rose,47,,,47,0,103100,,,114848,2023.10.26
86,Sunday Saints,Jordan Davis,19,9,10,1,0,97300,46100,51200,37238,2023.10.26
87,Colorado,Florida Georgia Line,15,0,15,2,0,94400,1500,92900,48264,2023.10.26
88,"Jesus, My Mama, My Therapist",Tiera Kennedy,81,1,80,17,0,80900,2000,78900,46837,2023.10.26
89,With You I Am,Cody Johnson,8,3,5,3,0,79300,2600,76700,1594186,2023.10.26
90,Gonna Love You,Parmalee,61,39,22,11,0,77600,49300,28300,174149,2023.10.26
91,Oklahoma Sooner,Jake Banfield,20,-6,26,1,0,73700,-13900,87600,6572,2023.10.26
92,Make You Mine,Marynn Taylor,66,3,63,25,0,68900,2500,66400,34085,2023.10.26
93,Try Jesus,Elle King,9,,,9,0,57200,,,25411,2023.10.26
94,Tulsa,Elle King,19,-4,23,1,0,55300,-8200,63500,46820,2023.10.26
95,Think I’m In Love With You,Chris Stapleton,25,0,25,1,0,53600,2300,51300,2589100,2023.10.26
96,The Star-Spangled Banner,Chris Stapleton,11,-2,13,10,0,53000,-3400,56400,166478,2023.10.26
97,I'll Be Here,Colbie Caillat,22,-1,23,1,0,48700,-2000,50700,583022,2023.10.26
98,Still,Luke Combs,16,2,14,1,0,45600,-400,46000,276166,2023.10.26
99,Out Of Nowhere,Walker Montgomery,11,1,10,1,0,44800,1900,42900,8776,2023.10.26
100,Holy Water,Michael Ray,10,1,9,2,0,44700,-5800,50500,244533,2023.10.26
101,Don'T Let The Old Man In,Toby Keith,18,10,8,6,0,39900,-3200,43100,263316,2023.10.26
102,Save The Roses,Lee Brice,25,-14,39,2,0,35000,-73300,108300,637589,2023.10.26
103,Give Me A Sunrise,Braxton Keith,4,3,1,1,0,33100,32500,600,25946,2023.10.26
104,Cowboy Forever,Carter Faith,18,15,3,1,0,32600,25100,7500,29485,2023.10.26
105,Silverado,Caleb Lee Hutchinson,51,16,35,18,0,32300,11300,21000,19828,2023.10.26
106,Heart To Break,Ryan Griffin,34,-11,45,3,0,32300,-10600,42900,136079,2023.10.26
107,Summer Soundtrack,Craig Campbell,50,-6,56,18,0,32000,-200,32200,1310,2023.10.26
108,Two Woman Man,Randall Fowler,52,20,32,18,0,31300,12700,18600,592,2023.10.26
109,Heart Attack,Boy Named Banjo,16,0,16,1,0,29200,0,29200,5288,2023.10.26
110,Star Spangled Banner,Abby Anderson,4,-1,5,4,0,28700,-8200,36900,0,2023.10.26
111,Quittin' Time,Morgan Wallen,8,-7,15,1,0,28700,-15000,43700,942253,2023.10.26
112,My Bar,Priscilla Block,8,-3,11,4,0,28300,-25600,53900,151694,2023.10.26
113,Fix'N To Break,Bailey Zimmerman,14,-1,15,1,0,27900,-300,28200,1769571,2023.10.26
114,Outlaws And Mustangs,Cody Jinks,4,,,4,0,27500,,,628317,2023.10.26
115,Record High,Randall King,2,0,2,2,0,24300,17600,6700,28796,2023.10.26
116,Have A Good Time,Darius Rucker,5,,,5,0,23800,,,421530,2023.10.26
117,Tea Was A Little Sweeter,Matt Rogers,34,-38,72,19,0,23600,-18800,42400,2085,2023.10.26
118,Seven Minutes In Heaven,Reba Mcentire,13,7,6,1,0,23400,2700,20700,222048,2023.10.26
119,When My Baby's In Boots,Randall King,2,0,2,1,0,22700,20100,2600,0,2023.10.26
120,She's Gotta Know,Conner Sweet,37,-17,54,18,0,22700,-9100,31800,776,2023.10.26
121,Days That End In Why,Morgan Wallen,24,19,5,20,0,22400,16000,6400,1207745,2023.10.26
122,West Of Tulsa,Wyatt Flores,7,-6,13,1,0,22300,-15900,38200,272955,2023.10.26
123,The Great Divide,Luke Combs & Billy Strings,8,2,6,1,0,22200,10800,11400,205504,2023.10.26
124,Under This Ole Hat,Sawyer Brown,4,,,4,0,22100,,,32650,2023.10.26
125,Back At The Bar,Landon Parker,36,1,35,18,0,21100,100,21000,1202,2023.10.26
126,Under A Southern Sky,Ian Flanigan,34,-19,53,18,0,20800,-10800,31600,11657,2023.10.26
127,But A Beer Can,Eric Burgett,34,-1,35,18,0,20700,-300,21000,10425,2023.10.26
128,Black Magic,Rachel Lipsky,33,-22,55,17,0,20600,-11400,32000,323,2023.10.26
129,A Little Bit Closer,Braxton Keith,3,2,1,1,0,19400,18800,600,58937,2023.10.26
130,Work Boots,Cody Johnson,3,2,1,1,0,19400,1200,18200,570535,2023.10.26
131,Other Side Of The Radio,Mike Ryan,3,1,2,1,0,19400,14300,5100,88078,2023.10.26
132,Tough Crowd,Jason Aldean,6,,,6,0,19300,,,677442,2023.10.26
132,Never Mine,Craig Campbell,6,,,6,0,19300,,,6505,2023.10.26
134,House Fire,Tyler Childers,7,0,7,1,0,19200,5300,13900,1123536,2023.10.26
135,Broadway Girls,Lil Durk Feat. Morgan Wallen,3,0,3,1,0,18800,1500,17300,4484914,2023.10.26
136,Tuggin' On My Heartstrings,Randall King,2,-1,3,1,0,18800,7800,11000,30136,2023.10.26
137,We Ain't The Only Ones,Randy Rogers & Wade Bowen,1,,,1,0,18200,,,0,2023.10.26
138,Cowgirls,Morgan Wallen,4,1,3,3,0,18000,12200,5800,5815805,2023.10.26
139,Tennessee Fan,Morgan Wallen,3,,,1,0,17900,,,1635106,2023.10.26
140,Songs We Used To Sing,Ernest,6,-1,7,1,0,16800,4900,11900,67434,2023.10.26
141,Sun To Me,Zach Bryan,12,2,10,2,0,16500,5000,11500,4919446,2023.10.26
142,Hungover You,Emily Brooke,7,1,6,6,0,16400,2100,14300,763,2023.10.26
143,Giving You Up,Kameron Marlowe,2,1,1,1,0,15900,8400,7500,900508,2023.10.26
144,All Things,Sound,3,1,2,2,0,15500,3100,12400,15125,2023.10.26
145,Don't Think Jesus,Morgan Wallen,5,0,5,3,0,15500,6000,9500,1125323,2023.10.26
146,Any Given Friday Night,Luke Combs,2,0,2,1,0,15200,0,15200,204826,2023.10.26
147,Honky Tonk Heartbreaker,Dustin Lynch,3,,,1,0,15000,,,145022,2023.10.26
148,Wild Ones,Jessie Murph & Jelly Roll,9,,,1,0,14800,,,9005415,2023.10.26
149,That's Why We Fight,Ella Langley & Koe Wetzel,10,-1,11,1,0,14500,-6600,21100,829790,2023.10.26
150,Son Of The Dirty South,Brantley Gilbert Feat. Jelly Roll,2,,,1,0,14400,,,1228523,2023.10.26
151,Wild as You,Cody Johnson,2,1,1,2,0,14300,12300,2000,1405211,2023.10.26
152,Whiskey Drink,Jason Aldean,6,,,6,0,14300,,,1192710,2023.10.26
153,Wild,Carter Faith,13,5,8,1,0,14000,2600,11400,375653,2023.10.26
154,Drinkin' It Wrong,Adam Doleac,6,,,6,0,13800,,,10614,2023.10.26
155,Star Spangled Banner,Maren Morris,1,0,1,1,0,13700,4700,9000,0,2023.10.26
156,Daylight Savings,Kidd G,22,4,18,3,0,13300,500,12800,82112,2023.10.26
157,Luke Combs,Tanner Adell,7,-1,8,1,0,13100,8400,4700,38628,2023.10.26
158,When It Comes To Loving You,Jon Langston,3,2,1,1,0,12900,4500,8400,102310,2023.10.26
159,Heart Of A Small Town,Tim Dugger,3,-1,4,1,0,12900,-7900,20800,11349,2023.10.26
160,Halfway Up The Mountain,Tribute Quartet,2,1,1,2,0,12800,7500,5300,15698,2023.10.26
161,Country Music,Tuten Brothers,6,-3,9,1,0,12800,-12900,25700,1943,2023.10.26
162,National Anthem From Battle At Bristol,Jennifer Nettles,3,1,2,3,0,12600,3400,9200,0,2023.10.26
163,Love You A Little Bit,Tanner Adell,8,1,7,1,0,12600,5000,7600,82951,2023.10.26
164,Summer To Me,Wayland,18,-18,36,17,0,12500,-8700,21200,1768,2023.10.26
165,Bad Man,Twinnie,19,-16,35,18,0,12200,-8800,21000,1235,2023.10.26
166,Heartless,Diplo & Julia Michaels Feat. Morgan Wallen,5,3,2,2,0,12000,-100,12100,5329222,2023.10.26
167,Hey There Hometown,Abby Leigh Anderson,3,0,3,1,0,12000,2800,9200,2090,2023.10.26
168,'98 Braves,Morgan Wallen,2,-32,34,1,0,11900,-159600,171500,2721295,2023.10.26
169,Runnin' Through That T,Thomas Edwards,1,0,1,1,0,11700,0,11700,5222,2023.10.26
170,Loud and Heavy,Cody Jinks,4,-1,5,1,0,11500,0,11500,1639543,2023.10.26
171,High Time,Kacey Musgraves,4,-2,6,1,0,11200,-1600,12800,35849,2023.10.26
172,Downtime,Roman Alexander,19,-16,35,18,0,10800,-10200,21000,26880,2023.10.26
173,Memory To Drown,Bryan Martin,6,3,3,1,0,10700,8000,2700,801260,2023.10.26
174,Record High,Dylan Marlowe,9,6,3,1,0,10600,7300,3300,294879,2023.10.26
175,Good Tequila,Faren Rachels,1,0,1,1,0,10600,7500,3100,3313,2023.10.26
176,Things I Take For Granted,Larry Fleet,1,0,1,1,0,10600,3000,7600,310795,2023.10.26
177,Cheerful Island Theme (Loop),Mark McEwen,1,,,1,0,10600,,,0,2023.10.26
178,Ok Cowboy,Catie Offerman,2,,,1,0,10300,,,93914,2023.10.26
179,Think About There,Greater Vision,2,-1,3,2,0,10200,-8400,18600,18867,2023.10.26
180,Came The Closest,Sam Hunt,2,,,2,0,9800,,,2196331,2023.10.26
181,Better Off,Trace Adkins,2,-1,3,1,0,9700,-3200,12900,14879,2023.10.26
182,Truck I Grew Up In,Craig Campbell,15,,,15,0,9500,,,615,2023.10.26
182,Roll On,Craig Campbell,15,,,15,0,9500,,,687,2023.10.26
184,Star Spangled Banner,Demi Lovato,1,-1,2,1,0,9400,-1500,10900,96,2023.10.26
185,Oklahoma Smokeshow,Zach Bryan,10,-11,21,1,0,9100,-44400,53500,5924027,2023.10.26
186,That's What I Love About Sunday,Craig Morgan & Gary Levox,1,,,1,0,9100,,,87636,2023.10.26
187,Whiskey Go 'Round,George Birge & Raelynn,2,1,1,2,0,9000,4000,5000,129557,2023.10.26
188,Saltwater Gospel,Eli Young Band & Jimmy Buffett,5,1,4,1,0,9000,3500,5500,104237,2023.10.26
189,Heartfirst,Kelsea Ballerini,2,,,1,0,9000,,,383280,2023.10.26
190,F-150,Robyn Ottolini,1,,,1,0,8700,,,90374,2023.10.26
191,"The Father, My Son, And The Holy Ghost",Craig Morgan,1,0,1,1,0,8400,0,8400,58503,2023.10.26
192,NO ONE LIKE GOD,Zane & Donna King,1,,,1,0,8400,,,49,2023.10.26
192,His Name Is Jesus (Live),Cody Johnson,1,,,1,0,8400,,,45194,2023.10.26
192,Mama's Rocking Chair,Ivan Parker,1,,,1,0,8400,,,401,2023.10.26
192,Start With Well Done,Greater Vision,1,,,1,0,8400,,,7435,2023.10.26
196,Raise The Bar,Craig Morgan & Luke Combs,1,,,1,0,8100,,,1024159,2023.10.26
196,Burden Bearer,Doyle Lawson & Quicksilver,1,,,1,0,8100,,,2213,2023.10.26
198,Bigger Than The Song,Brittney Spencer,1,-104,105,1,0,7700,-411400,419100,339822,2023.10.26
199,Thank God She's A Country Girl,Morgan Evans,1,,,1,0,7700,,,152318,2023.10.26
200,On The Boat Again,Jake Owen,7,1,6,1,0,7600,2200,5400,117685,2023.10.26
201,Country Girl,Kylie Morgan,1,0,1,1,0,7600,3900,3700,85790,2023.10.26
202,Humble And Kind (Nunca Te Olvides De Amar),Tim McGraw,2,0,2,1,0,7600,2000,5600,635,2023.10.26
203,Oklahoman Son,Zach Bryan,7,0,7,1,0,7600,-1800,9400,1554641,2023.10.26
204,I'M Not For Everyone,Brothers Osborne,1,-1,2,1,0,7600,-1700,9300,508570,2023.10.26
205,How It Looks From Here,Conner Smith,1,,,1,0,7600,,,179697,2023.10.26
1,Thinkin' Bout Me,Morgan Wallen,8313,217,8096,142,0,34980300,2161500,32818800,12946533,2023.11.02
2,God Gave Me A Girl,Russell Dickerson,8003,903,7100,143,0,33080500,5688600,27391900,1388560,2023.11.02
3,Try That In A Small Town,Jason Aldean,6362,-1488,7850,141,0,27367700,-3445200,30812900,4969972,2023.11.02
4,Stars Like Confetti,Dustin Lynch,6616,306,6310,142,0,27214400,2024700,25189700,1280991,2023.11.02
5,Can'T Have Mine,Dylan Scott,6457,351,6106,143,0,25301800,3169000,22132800,2833852,2023.11.02
6,Save Me,Jelly Roll & Lainey Wilson,5859,765,5094,143,0,24071200,4053100,20018100,8714485,2023.11.02
7,Fast Car,Luke Combs,4737,-424,5161,143,0,23361100,27500,23333600,11702990,2023.11.02
8,Standing Room Only,Tim McGraw,5669,178,5491,143,0,22053000,2049300,20003700,2027873,2023.11.02
9,Everything I Love,Morgan Wallen,5223,18,5205,142,0,20568100,542800,20025300,4243385,2023.11.02
10,But I Got A Beer In My Hand,Luke Bryan,4661,40,4621,143,0,18345900,1373100,16972800,2133307,2023.11.02
11,Mind On You,George Birge,4502,330,4172,143,0,17981600,2974600,15007000,414354,2023.11.02
12,Save Me The Trouble,Dan + Shay,4554,265,4289,143,0,17420900,1788100,15632800,2211797,2023.11.02
13,World On Fire,Nate Smith,3928,543,3385,142,0,15503400,3166300,12337100,3657495,2023.11.02
14,All I Need Is You,Chris Janson,3903,160,3743,143,0,14196400,1193200,13003200,614477,2023.11.02
15,We Got History,Mitchell Tenpenny,3543,96,3447,142,0,13085700,981700,12104000,1163519,2023.11.02
16,White Horse,Chris Stapleton,3462,63,3399,143,0,12919500,856400,12063100,8917241,2023.11.02
17,Different 'Round Here,Riley Green,3192,30,3162,143,0,12642600,1444100,11198500,2473838,2023.11.02
18,If You Go Down (I'M Going Down Too),Kelsea Ballerini,3402,3,3399,143,0,11742500,786200,10956300,1001448,2023.11.02
19,23,Chayce Beckham,3015,163,2852,141,0,9957000,895800,9061200,3347359,2023.11.02
20,Pretty Little Poison,Warren Zeiders,2624,240,2384,138,0,9460500,1976200,7484300,7778009,2023.11.02
21,Creek Will Rise,Conner Smith,3039,13,3026,143,0,9372500,522700,8849800,741055,2023.11.02
22,Light On In The Kitchen,Ashley McBryde,2761,154,2607,143,0,7853900,753800,7100100,973921,2023.11.02
23,The Painter,Cody Johnson,2112,234,1878,142,0,7158800,801900,6356900,5247700,2023.11.02
24,Where The Wild Things Are,Luke Combs,1554,448,1106,132,0,6961400,1973300,4988100,1940208,2023.11.02
25,Truck Bed,Hardy,2191,135,2056,139,0,6859300,1133700,5725600,6390061,2023.11.02
26,I Can Feel It,Kane Brown,1837,81,1756,139,0,6733500,726400,6007100,3108989,2023.11.02
27,Nobody's Nobody,Brothers Osborne,2188,-66,2254,142,0,6297400,456800,5840600,1195063,2023.11.02
28,Burn It Down,Parker Mccollum,1799,224,1575,135,0,5777500,1045900,4731600,5401105,2023.11.02
29,Fearless,Jackson Dean,1904,68,1836,140,0,5664800,521000,5143800,977568,2023.11.02
30,Tucson Too Late,Jordan Davis,1405,143,1262,133,0,5660100,880900,4779200,1339032,2023.11.02
31,See You Next Summer,Brian Kelley,1723,3,1720,139,0,4626800,219300,4407500,615412,2023.11.02
32,I Remember Everything,Zach Bryan Feat. Kacey Musgraves,1289,115,1174,119,0,4581100,710000,3871100,21445661,2023.11.02
33,Mamaw's House,Thomas Rhett,1093,107,986,123,0,4451700,488800,3962900,2565388,2023.11.02
34,We Don'T Fight Anymore,Carly Pearce,1328,-3,1331,137,0,4011400,666800,3344600,4368318,2023.11.02
35,Glory Days,Gabby Barrett,1569,-43,1612,139,0,3961700,9900,3951800,1462771,2023.11.02
36,Cab In A Solo,Scotty McCreery,1561,96,1465,141,0,3814300,382700,3431600,735986,2023.11.02
37,I'M Not Pretty,Megan Moroney,1141,22,1119,114,0,3430100,450100,2980000,2308581,2023.11.02
38,Out Of That Truck,Carrie Underwood,1331,-7,1338,129,0,3310100,144900,3165200,1477435,2023.11.02
39,Back Then Right Now,Tyler Hubbard,1172,91,1081,105,0,3243600,263200,2980400,1377128,2023.11.02
40,Outskirts,Sam Hunt,1003,97,906,122,0,2731800,298800,2433000,1960105,2023.11.02
41,Love You Again,Chase Matthew,889,81,808,75,0,2678800,479500,2199300,2523535,2023.11.02
42,Drive You Out Of My Mind,Kassi Ashton,894,61,833,105,0,2343900,338900,2005000,399859,2023.11.02
43,Cowboys And Plowboys,Jon Pardi & Luke Bryan,607,121,486,82,0,2225100,388100,1837000,860426,2023.11.02
44,Young Love & Saturday Nights,Chris Young,634,62,572,67,0,2121400,123000,1998400,704081,2023.11.02
45,Drinkin' Problems,Dillon Carmichael,874,38,836,92,0,1919900,265100,1654800,80648,2023.11.02
46,Where It Ends,Bailey Zimmerman,547,130,417,59,0,1844300,382200,1462100,2619110,2023.11.02
47,Something's Gonna Kill Me,Corey Kent,708,15,693,72,0,1804400,117000,1687400,2383963,2023.11.02
48,Spirits And Demons,Michael Ray With Meghan Patrick,773,46,727,81,0,1752100,329200,1422900,299391,2023.11.02
49,Can't Break Up Now,Old Dominion,595,62,533,78,0,1523600,186500,1337100,1774918,2023.11.02
50,We Ride,Bryan Martin,558,58,500,55,0,1455000,282800,1172200,3528163,2023.11.02
51,In Your Love,Tyler Childers,426,49,377,48,0,1079200,100700,978500,4848393,2023.11.02
52,Wine Country,Hannah Ellis,532,63,469,60,0,959400,144500,814900,67229,2023.11.02
53,Dance With You,Brett Young,478,27,451,66,0,917300,72000,845300,1090295,2023.11.02
54,Thicc As Thieves,Lauren Alaina,326,44,282,54,0,717000,129400,587600,834701,2023.11.02
55,I'm In Love,Hailey Whitters,306,0,306,51,0,633800,105400,528400,704964,2023.11.02
56,Brokenhearted,Joe Nichols,428,73,355,51,0,627300,70700,556600,28024,2023.11.02
57,Find Another Bar,Chris Lane,411,10,401,58,0,571800,156300,415500,224643,2023.11.02
58,Good With Me,Walker Hayes,227,-44,271,36,0,525500,-87200,612700,528648,2023.11.02
59,She's Somebody's Daughter,Drew Baldridge,338,-58,396,50,0,520400,-80000,600400,399777,2023.11.02
60,Cancelled,Randy Houser,270,23,247,35,0,442600,62100,380500,0,2023.11.02
60,Cancel,Randy Houser,270,23,247,35,0,442600,62100,380500,48840,2023.11.02
62,Long Live Cowgirls,Ian Munsick & Cody Johnson,169,82,87,32,0,418700,223000,195700,787004,2023.11.02
63,Without You,Thompson Square,209,-88,297,34,0,416400,-82900,499300,23666,2023.11.02
64,Trouble,Josh Ross,316,22,294,50,0,378500,53200,325300,2103770,2023.11.02
65,Ain'T About You,Huntergirl,274,130,144,43,0,357300,218900,138400,8258,2023.11.02
66,Now And Then,Beatles,57,,,48,0,344500,,,3125862,2023.11.02
67,Heart They Didn'T Break,Maddie & Tae,246,48,198,33,0,316900,74800,242100,839071,2023.11.02
68,Things I Can’t Control (Feat.,Charlie Worsham,57,56,1,56,0,301600,300200,1400,87776,2023.11.02
69,Don'T Let The Old Man In,Toby Keith,132,114,18,46,0,276400,236500,39900,220251,2023.11.02
70,Ain'T Got A Worry,Old Dominion,24,7,17,1,0,274000,121500,152500,258139,2023.11.02
71,That's Texas,Cody Johnson,28,-7,35,2,0,273400,-56800,330200,659027,2023.11.02
72,Make Me Wanna Smoke,Runaway June,200,24,176,28,0,269900,15600,254300,27897,2023.11.02
73,Gonna Love You,Parmalee,178,117,61,40,0,267600,190000,77600,169694,2023.11.02
74,Man Made A Bar,Morgan Wallen,33,0,33,2,0,253900,59300,194600,2859205,2023.11.02
75,Ain't Missin' You,Dylan Schneider,198,9,189,27,0,231200,-10900,242100,883758,2023.11.02
76,This Side Of The Dirt,Neon Union,222,28,194,32,0,228100,62600,165500,39072,2023.11.02
77,Rain In The Rearview,Anne Wilson,154,35,119,29,0,211300,105500,105800,339173,2023.11.02
78,How Is She,Cole Swindell,30,2,28,1,0,209300,5900,203400,57872,2023.11.02
79,Nothing Compares To You,Mickey Guyton Feat. Kane Brown,113,7,106,19,0,189500,70400,119100,854887,2023.11.02
80,Buy A Bar,Tim Dugger,56,-2,58,7,0,163000,26600,136400,16101,2023.11.02
81,Georgia Girl,Megan Moroney,21,-3,24,1,0,135900,-21900,157800,87066,2023.11.02
82,Sarah's Place,Zach Bryan,16,-2,18,1,0,129600,10900,118700,4831579,2023.11.02
83,Oklahoma Sooner,Jake Banfield,36,16,20,1,0,122300,48600,73700,5502,2023.11.02
84,Texas Hold 'Em.,Nicolle Galyon,49,48,1,48,0,108500,107100,1400,72265,2023.11.02
85,Karma On The Rocks,Hannah Ellis,47,46,1,47,0,102300,100900,1400,74167,2023.11.02
86,Colorado,Florida Georgia Line,18,3,15,2,0,100600,6200,94400,44608,2023.11.02
87,Country Girl,Kylie Morgan,46,45,1,46,0,99000,91400,7600,67862,2023.11.02
88,Sunday Saints,Jordan Davis,17,-2,19,1,0,93500,-3800,97300,30609,2023.11.02
89,Love You Back,Lady A,17,8,9,2,0,83600,76500,7100,314968,2023.11.02
90,With You I Am,Cody Johnson,6,-2,8,3,0,78400,-900,79300,1525252,2023.11.02
91,The Tree,Maren Morris,29,28,1,1,0,75700,74700,1000,681658,2023.11.02
92,King Of Country Music,Ryan Larkins,31,-4,35,7,0,73300,-45700,119000,57167,2023.11.02
93,Outlaws And Mustangs,Cody Jinks,6,2,4,3,0,69400,41900,27500,245362,2023.11.02
94,The Star-Spangled Banner,Chris Stapleton,12,1,11,11,0,66400,13400,53000,134929,2023.11.02
95,My Bar,Priscilla Block,13,6,7,4,0,65300,37000,28300,140443,2023.11.02
96,Question The Universe,Teddy Robb,28,17,11,14,0,58400,50900,7500,3086,2023.11.02
97,Think I’m In Love With You,Chris Stapleton,25,0,25,1,0,56400,2800,53600,2368155,2023.11.02
98,Death Row,Thomas Rhett Feat. Tyler Hubbard & Russell Dickerson,9,,,9,0,55400,,,50404,2023.11.02
99,Holy Water,Michael Ray,6,-4,10,2,0,53100,8400,44700,225660,2023.11.02
100,Make You Mine,Marynn Taylor,41,-22,63,23,0,51300,-17400,68700,32242,2023.11.02
101,"Jesus, My Mama, My Therapist",Tiera Kennedy,95,8,87,17,0,50000,-31000,81000,41859,2023.11.02
102,But A Beer Can,Eric Burgett,67,35,32,17,0,47300,26800,20500,9237,2023.11.02
103,Tulsa,Elle King,14,-5,19,1,0,42600,-12700,55300,43307,2023.11.02
104,Still,Luke Combs,12,-4,16,1,0,39300,-6300,45600,257016,2023.11.02
105,Halfway To Hell,Jelly Roll,5,4,1,2,0,39100,31900,7200,1685857,2023.11.02
106,Stop Coming Over,Chris Lane,12,,,6,0,38600,,,31599,2023.11.02
106,Just Drive,Erin Kinsey,12,,,6,0,38600,,,95464,2023.11.02
108,Breakin' In Boots,Matt Stell,22,-52,74,6,0,37200,-274000,311200,337445,2023.11.02
109,Wild as You,Cody Johnson,2,0,2,1,0,36200,21900,14300,1299533,2023.11.02
110,I'll Be Here,Colbie Caillat,16,-6,22,1,0,36200,-12500,48700,528237,2023.11.02
111,Under A Southern Sky,Ian Flanigan,52,20,32,17,0,35900,15300,20600,9886,2023.11.02
112,Tea Was A Little Sweeter,Matt Rogers,51,19,32,17,0,35700,12300,23400,2137,2023.11.02
113,Seven Year Ache,Aaron Watson & Jenna Paulette,3,2,1,1,0,35600,35000,600,0,2023.11.02
114,Loser,Mike Ryan,3,,,1,0,35600,,,15242,2023.11.02
115,Hoops,Alison Nichols,50,35,15,17,0,35400,25300,10100,9564,2023.11.02
116,Black Magic,Rachel Lipsky,50,19,31,17,0,35300,14900,20400,296,2023.11.02
117,West Of Tulsa,Wyatt Flores,10,3,7,2,0,35200,12900,22300,242713,2023.11.02
118,Out Of Nowhere,Walker Montgomery,9,-2,11,1,0,34500,-10300,44800,7856,2023.11.02
119,Cowgirls,Morgan Wallen,13,9,4,4,0,33700,15700,18000,5539271,2023.11.02
120,Leave You Alone,Kane Brown,11,,,6,0,32100,,,273475,2023.11.02
121,Fix'N To Break,Bailey Zimmerman,16,2,14,1,0,31800,3900,27900,1624693,2023.11.02
122,A Love Song,Lady A,7,,,2,0,30700,,,508894,2023.11.02
123,Star Spangled Banner,Abby Anderson,5,1,4,4,0,27400,-1300,28700,2,2023.11.02
124,Save The Roses,Lee Brice,20,-5,25,2,0,25300,-9700,35000,595477,2023.11.02
125,Summer To Me,Wayland,37,20,17,18,0,24900,12500,12400,2038,2023.11.02
126,Silverado,Caleb Lee Hutchinson,35,-13,48,17,0,24100,-8000,32100,30238,2023.11.02
127,Quittin' Time,Morgan Wallen,6,-2,8,1,0,23900,-4800,28700,868720,2023.11.02
128,Back At The Bar,Landon Parker,34,0,34,17,0,23800,2900,20900,888,2023.11.02
129,Summer Soundtrack,Craig Campbell,34,-13,47,17,0,23800,-8000,31800,1252,2023.11.02
130,Bad Man,Twinnie,33,15,18,17,0,23400,11200,12200,1282,2023.11.02
131,Two Woman Man,Randall Fowler,33,-16,49,17,0,23400,-7600,31000,484,2023.11.02
132,Downtime,Roman Alexander,32,14,18,17,0,23100,12400,10700,27360,2023.11.02
133,She's Gotta Know,Conner Sweet,32,-3,35,17,0,23100,500,22600,695,2023.11.02
134,Heart Attack,Boy Named Banjo,13,-3,16,1,0,22900,-6300,29200,4737,2023.11.02
135,The Star Spangled Banner,Locash,1,,,1,0,22300,,,0,2023.11.02
136,Wild Ones,Jessie Murph & Jelly Roll,11,2,9,1,0,22200,7400,14800,10112970,2023.11.02
137,Rhinestoned,"Randy Rogers ,Wade Bowen",2,1,1,1,0,22200,21600,600,25791,2023.11.02
138,When It Comes To Loving You,Jon Langston,3,0,3,2,0,22000,9100,12900,96850,2023.11.02
139,Beer For Santa,Jon Pardi,10,,,9,0,21500,,,108069,2023.11.02
140,Cowboy Forever,Carter Faith,13,-5,18,1,0,21100,-11500,32600,27284,2023.11.02
141,The Great Divide,Luke Combs & Billy Strings,7,-1,8,1,0,20800,-1400,22200,180461,2023.11.02
142,When My Baby's In Boots,Randall King,3,1,2,2,0,20400,-2300,22700,0,2023.11.02
143,Quarter Life Crisis,Kylie Morgan,4,,,4,0,20300,,,6956,2023.11.02
144,wAnt me back,Lindsay Ell,6,,,6,0,19300,,,28451,2023.11.02
144,Let Your Boys Be Country,Jason Aldean,6,,,6,0,19300,,,1141719,2023.11.02
144,Bits & Pieces,Walker County,6,,,6,0,19300,,,2837,2023.11.02
144,Big Wheels,Russell Dickerson,6,,,6,0,19300,,,137463,2023.11.02
144,Polaroid,Keith Urban,6,,,6,0,19300,,,11227,2023.11.02
144,For What It's Worth,Breland,6,,,6,0,19300,,,584557,2023.11.02
144,My Last Broken Heart,Jesse Labelle,6,,,6,0,19300,,,53,2023.11.02
151,Boys Back Home,Dylan Marlowe,3,,,2,0,19200,,,2409283,2023.11.02
152,Giving You Up,Kameron Marlowe,3,1,2,1,0,18500,2600,15900,870411,2023.11.02
153,Wild,Carter Faith,13,0,13,1,0,18500,4500,14000,251487,2023.11.02
154,Chevrolet,Dustin Lynch,4,3,1,1,0,18400,18200,200,0,2023.11.02
155,The Ending,Jake Owen,4,,,1,0,18400,,,3902,2023.11.02
156,Ain't It Baby (Live at Billy Bob's Texas),Josh Ward,2,1,1,1,0,18300,17700,600,887,2023.11.02
157,Young Man's Blues,Parker Mccollum,2,0,2,1,0,18300,17100,1200,426507,2023.11.02
158,Sun To Me,Zach Bryan,11,-1,12,2,0,17700,1200,16500,4524149,2023.11.02
159,We Ain't The Only Ones,Randy Rogers & Wade Bowen,1,0,1,1,0,17300,-900,18200,0,2023.11.02
160,Boots On A Dance Floor,Jon Wolfe,1,,,1,0,17300,,,68528,2023.11.02
160,Hurricane,Parker Mccollum,1,,,1,0,17300,,,71421,2023.11.02
162,The Star-Spangled Banner,Carly Pearce,1,0,1,1,0,17000,10900,6100,0,2023.11.02
163,Seven Minutes In Heaven,Reba Mcentire,9,-4,13,1,0,17000,-6400,23400,218267,2023.11.02
164,Record High,Randall King,4,2,2,2,0,16700,-7600,24300,28530,2023.11.02
165,Marlboros & Avon,McBride & The Ride,4,,,4,0,16500,,,802,2023.11.02
166,The Weight Of The Badge,George Strait,1,,,1,0,16400,,,48544,2023.11.02
167,Gas Station Flowers,Zandi Holup,5,1,4,1,0,16000,7900,8100,119655,2023.11.02
168,Better Off,Trace Adkins,4,2,2,1,0,15900,6200,9700,14031,2023.11.02
169,Heart To Break,Ryan Griffin,27,-7,34,2,0,15500,-16800,32300,126147,2023.11.02
170,Star Spangled Banner,Mickey Guyton,2,1,1,2,0,15400,13000,2400,0,2023.11.02
171,I'M Not For Everyone,Brothers Osborne,2,1,1,2,0,15400,7800,7600,466341,2023.11.02
172,Broadway Girls,Lil Durk Feat. Morgan Wallen,4,1,3,1,0,15300,-3500,18800,4197965,2023.11.02
173,Country Music,Tuten Brothers,7,1,6,1,0,15100,2300,12800,1635,2023.11.02
174,On The Boat Again,Jake Owen,8,1,7,1,0,14900,7300,7600,101154,2023.11.02
175,No Yesterday,Jeremy McComb,6,-1,7,1,0,14800,14700,100,374,2023.11.02
176,House Fire,Tyler Childers,5,-2,7,1,0,14700,-4500,19200,999894,2023.11.02
177,That's Why We Fight,Ella Langley & Koe Wetzel,9,-1,10,1,0,13700,-800,14500,746012,2023.11.02
178,National Anthem From Battle At Bristol,Jennifer Nettles,2,0,2,2,0,13500,4000,9500,0,2023.11.02
179,Scars In Heaven,Nelons,2,,,2,0,13400,,,1496,2023.11.02
180,Luke Combs,Tanner Adell,7,0,7,1,0,12800,-300,13100,43717,2023.11.02
181,Hey There Hometown,Abby Leigh Anderson,3,0,3,1,0,12700,700,12000,1721,2023.11.02
182,Bad Luck,Zach Top,2,,,1,0,12500,,,110631,2023.11.02
183,BELLS,Rachelle Garniez,1,,,1,0,12300,,,0,2023.11.02
184,Memory To Drown,Bryan Martin,6,0,6,1,0,12100,1400,10700,734692,2023.11.02
185,Ok Cowboy,Catie Offerman,2,0,2,1,0,11500,1200,10300,53561,2023.11.02
186,Love It All Goodbye,Eric Burgett,16,,,15,0,11500,,,9364,2023.11.02
187,Watching My Old Flame,Cody Johnson,2,1,1,1,0,11400,10800,600,1072013,2023.11.02
188,Soundtrack To A Small Town Sundown,Tyler Farr,2,1,1,1,0,11200,9900,1300,7545,2023.11.02
189,You'Re Gonna Love Me,Tim Dugger,2,0,2,1,0,11200,8600,2600,6964,2023.11.02
190,Heart Of A Small Town,Tim Dugger,2,-1,3,1,0,11200,-1700,12900,10308,2023.11.02
191,Different Us 2.15.23,Erin Kinsey,1,,,1,0,10900,,,93130,2023.11.02
192,Crazy People,Randy Rogers Band,2,,,1,0,10800,,,13704,2023.11.02
193,Star Spangled Banner,Demi Lovato,2,1,1,2,0,10600,1200,9400,133,2023.11.02
194,Star Spangled Banner,Maren Morris,1,0,1,1,0,10600,-3100,13700,0,2023.11.02
195,Corn,Blake Shelton,2,,,1,0,10600,,,9212,2023.11.02
196,No Present LIke The Time,Jay Allen,9,7,2,1,0,10100,9500,600,0,2023.11.02
197,Oklahoma Smokeshow,Zach Bryan,12,2,10,1,0,10100,1000,9100,5407187,2023.11.02
198,Loud and Heavy,Cody Jinks,5,1,4,1,0,10000,-1500,11500,1571067,2023.11.02
199,The Finger,Bryce Leatherwood,1,,,1,0,10000,,,45168,2023.11.02
200,Decoration,Jillian Riscoe,5,1,4,1,0,9800,6600,3200,5,2023.11.02
1,Thinkin' Bout Me,Morgan Wallen,8000,-313,8313,142,0,34664800,-315500,34980300,14036295,2023.11.09
2,Stars Like Confetti,Dustin Lynch,7476,860,6616,142,0,30957600,3743200,27214400,720345,2023.11.09
3,God Gave Me A Girl,Russell Dickerson,6925,-1078,8003,143,0,27855800,-5224700,33080500,1198734,2023.11.09
4,Save Me,Jelly Roll & Lainey Wilson,6590,731,5859,143,0,26874400,2803200,24071200,9014746,2023.11.09
5,Can'T Have Mine,Dylan Scott,6668,211,6457,143,0,26531000,1229200,25301800,2926400,2023.11.09
6,Try That In A Small Town,Jason Aldean,5029,-1333,6362,135,0,23169300,-4198400,27367700,5280654,2023.11.09
7,Standing Room Only,Tim McGraw,5824,155,5669,143,0,22134000,81000,22053000,2175775,2023.11.09
8,Everything I Love,Morgan Wallen,5248,25,5223,142,0,20193200,-374900,20568100,3867275,2023.11.09
9,But I Got A Beer In My Hand,Luke Bryan,4920,259,4661,143,0,19077800,731900,18345900,2027905,2023.11.09
10,Mind On You,George Birge,4723,221,4502,143,0,18980900,999300,17981600,458521,2023.11.09
11,Save Me The Trouble,Dan + Shay,4727,173,4554,143,0,18167600,746700,17420900,2309282,2023.11.09
12,World On Fire,Nate Smith,4338,410,3928,142,0,17374300,1870900,15503400,6071127,2023.11.09
13,All I Need Is You,Chris Janson,3899,-4,3903,142,0,14431800,235400,14196400,625016,2023.11.09
14,Different 'Round Here,Riley Green,3626,434,3192,143,0,13839900,1197300,12642600,2401993,2023.11.09
15,White Horse,Chris Stapleton,3648,186,3462,143,0,13688600,769100,12919500,9559228,2023.11.09
16,We Got History,Mitchell Tenpenny,3589,46,3543,142,0,13474500,388800,13085700,1261681,2023.11.09
17,If You Go Down (I'M Going Down Too),Kelsea Ballerini,3570,168,3402,143,0,11720700,-21800,11742500,1736290,2023.11.09
18,Creek Will Rise,Conner Smith,3178,139,3039,143,0,9984900,612400,9372500,806874,2023.11.09
19,Pretty Little Poison,Warren Zeiders,2758,134,2624,138,0,9856400,395900,9460500,8267924,2023.11.09
20,23,Chayce Beckham,2949,-66,3015,141,0,9723700,-233300,9957000,3208601,2023.11.09
21,Where The Wild Things Are,Luke Combs,2041,487,1554,133,0,8555200,1593800,6961400,2466867,2023.11.09
22,The Painter,Cody Johnson,2395,283,2112,142,0,8266400,1107600,7158800,6616236,2023.11.09
23,Light On In The Kitchen,Ashley McBryde,2600,-161,2761,143,0,7537800,-316100,7853900,1132052,2023.11.09
24,I Can Feel It,Kane Brown,2039,202,1837,140,0,7215900,482400,6733500,2990131,2023.11.09
25,Truck Bed,Hardy,2281,90,2191,139,0,7099700,240400,6859300,6471380,2023.11.09
26,Rodeo Man,Garth Brooks & Ronnie Dunn,1442,,,123,0,6587000,,,1063875,2023.11.09
27,Burn It Down,Parker Mccollum,1902,103,1799,136,0,6269600,492100,5777500,5702466,2023.11.09
28,Fearless,Jackson Dean,1980,76,1904,140,0,6268500,603700,5664800,931681,2023.11.09
29,Nobody's Nobody,Brothers Osborne,2088,-100,2188,140,0,6267600,-29800,6297400,1181096,2023.11.09
30,Tucson Too Late,Jordan Davis,1407,2,1405,135,0,5057200,-602900,5660100,1603269,2023.11.09
31,Mamaw's House,Thomas Rhett,1164,71,1093,125,0,4705600,253900,4451700,3352267,2023.11.09
32,See You Next Summer,Brian Kelley,1738,15,1723,139,0,4649600,22800,4626800,625018,2023.11.09
33,We Don'T Fight Anymore,Carly Pearce,1486,158,1328,138,0,4636200,624800,4011400,4379259,2023.11.09
34,Glory Days,Gabby Barrett,1712,143,1569,139,0,4479900,518200,3961700,1446684,2023.11.09
35,Cab In A Solo,Scotty McCreery,1579,18,1561,141,0,4058000,243700,3814300,766941,2023.11.09
36,I Remember Everything,Zach Bryan Feat. Kacey Musgraves,1191,-98,1289,125,0,4030800,-550300,4581100,22559967,2023.11.09
37,Out Of That Truck,Carrie Underwood,1401,70,1331,129,0,3560100,250000,3310100,1712283,2023.11.09
38,I'M Not Pretty,Megan Moroney,1208,67,1141,115,0,3431000,900,3430100,2503167,2023.11.09
39,Back Then Right Now,Tyler Hubbard,1158,-14,1172,106,0,3196400,-47200,3243600,1458336,2023.11.09
40,Outskirts,Sam Hunt,1051,48,1003,123,0,2875900,144100,2731800,1860267,2023.11.09
41,Love You Again,Chase Matthew,965,76,889,77,0,2744400,65600,2678800,2509799,2023.11.09
42,Young Love & Saturday Nights,Chris Young,653,19,634,62,0,2299700,178300,2121400,728562,2023.11.09
43,Drive You Out Of My Mind,Kassi Ashton,858,-36,894,104,0,2136200,-207700,2343900,256021,2023.11.09
44,Cowboys And Plowboys,Jon Pardi & Luke Bryan,631,24,607,78,0,2070600,-154500,2225100,964948,2023.11.09
45,Drinkin' Problems,Dillon Carmichael,847,-27,874,92,0,1902500,-17400,1919900,80019,2023.11.09
46,Something's Gonna Kill Me,Corey Kent,745,37,708,71,0,1896100,91700,1804400,2532876,2023.11.09
47,Spirits And Demons,Michael Ray With Meghan Patrick,793,20,773,84,0,1832800,80700,1752100,311844,2023.11.09
48,Where It Ends,Bailey Zimmerman,562,15,547,57,0,1705000,-139300,1844300,2751189,2023.11.09
49,We Ride,Bryan Martin,588,30,558,60,0,1686300,231300,1455000,3683114,2023.11.09
50,Can't Break Up Now,Old Dominion,697,102,595,110,0,1681200,157600,1523600,1902733,2023.11.09
51,Dance With You,Brett Young,577,99,478,78,0,1141800,224500,917300,1132636,2023.11.09
52,In Your Love,Tyler Childers,450,24,426,59,0,1116000,36800,1079200,4320901,2023.11.09
53,Wine Country,Hannah Ellis,557,25,532,70,0,1097900,138500,959400,51413,2023.11.09
54,Pickup Man,"HIXTAPE Feat. Post Malone, Joe Diffie",182,,,93,0,826200,,,0,2023.11.09
55,Thicc As Thieves,Lauren Alaina,321,-5,326,45,0,752200,35200,717000,913091,2023.11.09
56,I'm In Love,Hailey Whitters,335,29,306,57,0,710300,76500,633800,714843,2023.11.09
57,Brokenhearted,Joe Nichols,414,-14,428,53,0,693200,65900,627300,9842,2023.11.09
58,Find Another Bar,Chris Lane,417,6,411,57,0,637000,65200,571800,217091,2023.11.09
59,Man Made A Bar,Morgan Wallen,134,101,33,67,0,626200,372300,253900,3140622,2023.11.09
60,Gonna Love You,Parmalee,360,182,178,58,0,616300,348700,267600,177564,2023.11.09
61,She's Somebody's Daughter,Drew Baldridge,318,-20,338,40,0,538800,18400,520400,445010,2023.11.09
62,Long Live Cowgirls,Ian Munsick & Cody Johnson,222,53,169,38,0,531900,113200,418700,895833,2023.11.09
63,Don'T Let The Old Man In,Toby Keith,291,159,132,57,0,439500,163100,276400,223607,2023.11.09
64,Cancelled,Randy Houser,258,-12,270,36,0,416700,-25900,442600,0,2023.11.09
64,Cancel,Randy Houser,258,-12,270,36,0,416700,-25900,442600,50712,2023.11.09
66,Make Me Wanna Smoke,Runaway June,234,34,200,30,0,395900,126000,269900,21713,2023.11.09
67,Ain'T About You,Huntergirl,310,36,274,49,0,394100,36800,357300,20228,2023.11.09
68,Tough Crowd,Jason Aldean,94,,,49,0,384000,,,1175740,2023.11.09
69,Let Your Boys Be Country,Jason Aldean,94,88,6,48,0,378400,359100,19300,2578854,2023.11.09
70,Love You Back,Lady A,81,64,17,24,0,371600,288000,83600,260107,2023.11.09
71,That's Texas,Cody Johnson,32,4,28,3,0,361800,88400,273400,1591067,2023.11.09
72,Heart They Didn'T Break,Maddie & Tae,247,1,246,47,0,360400,43500,316900,919553,2023.11.09
73,Trouble,Josh Ross,291,-25,316,48,0,344400,-34100,378500,1885860,2023.11.09
74,This Side Of The Dirt,Neon Union,244,22,222,42,0,333600,105500,228100,38366,2023.11.09
75,Without You,Thompson Square,120,-89,209,21,0,328500,-87900,416400,7025,2023.11.09
76,John Deere Green,"HIXTAPE Feat. HARDY, Morgan Wallen, Joe Diffie",108,,,73,0,303100,,,0,2023.11.09
77,Beer For Santa,Jon Pardi,57,47,10,56,0,301600,280100,21500,35813,2023.11.09
78,King Of Country Music,Ryan Larkins,58,27,31,7,0,299800,226500,73300,63821,2023.11.09
79,True Story,Jon Brennan,57,,,56,0,298200,,,183,2023.11.09
80,Ain'T Got A Worry,Old Dominion,25,1,24,1,0,292600,18600,274000,276903,2023.11.09
81,Knew You'D Come Around,Jason Aldean,44,,,44,0,287500,,,953719,2023.11.09
82,Buy A Bar,Tim Dugger,50,-6,56,5,0,245600,82600,163000,16406,2023.11.09
83,Whiskey Drink,Jason Aldean,39,,,39,0,235400,,,1995656,2023.11.09
84,Ain't Missin' You,Dylan Schneider,202,4,198,27,0,226300,-4900,231200,905877,2023.11.09
85,Wildflowers And Wild Horses,Lainey Wilson,100,,,61,0,208800,,,461743,2023.11.09
86,Rain In The Rearview,Anne Wilson,160,6,154,29,0,198200,-13100,211300,358713,2023.11.09
87,Nothing Compares To You,Mickey Guyton Feat. Kane Brown,99,-14,113,18,0,192500,3000,189500,862194,2023.11.09
88,How Is She,Cole Swindell,26,-4,30,1,0,170300,-39000,209300,57054,2023.11.09
89,Whiskey Bent,Cody Johnson,26,,,23,0,160200,,,2840936,2023.11.09
90,Sarah's Place,Zach Bryan,16,0,16,1,0,128700,-900,129600,5029778,2023.11.09
91,Oklahoma Sooner,Jake Banfield,39,3,36,2,0,126600,4300,122300,5404,2023.11.09
92,Whose Rearview,Jason Aldean,15,,,14,0,116900,,,2690574,2023.11.09
93,Dirt Cheap,Cody Johnson,22,,,22,0,114800,,,3851782,2023.11.09
94,Ok Cowboy,Catie Offerman,50,48,2,49,0,113500,102000,11500,52225,2023.11.09
95,Georgia Girl,Megan Moroney,17,-4,21,1,0,113200,-22700,135900,95075,2023.11.09
96,Sunday Saints,Jordan Davis,17,0,17,1,0,108700,15200,93500,31554,2023.11.09
97,Fine County Line,Lauren Watkins,49,48,1,48,0,108500,107100,1400,9478,2023.11.09
98,Take A Broken Heart,Madeline Merlo,47,,,47,0,102300,,,30281,2023.11.09
99,With You I Am,Cody Johnson,7,1,6,2,0,99200,20800,78400,1580707,2023.11.09
100,Leave Me Again,Kelsea Ballerini,48,,,48,0,95800,,,264236,2023.11.09
100,That's How Love Is Made,The War And Treaty,48,,,48,0,95800,,,41550,2023.11.09
100,Love Can Build A Bridge,"Jelly Roll, K. Michelle & The Fisk Jubilee Singers",48,,,48,0,95800,,,133489,2023.11.09
100,Pirates & Parrots/Margaritaville,Zac Brown Band Feat. Alan Jackson,48,,,48,0,95800,,,0,2023.11.09
104,Colorado,Florida Georgia Line,17,-1,18,2,0,90500,-10100,100600,45178,2023.11.09
105,Work Boots,Cody Johnson,9,7,2,2,0,89000,83100,5900,1824491,2023.11.09
106,The Tree,Maren Morris,33,4,29,1,0,81700,6000,75700,628917,2023.11.09
107,Long Live Country Music,Cody Johnson,26,,,23,0,69800,,,1673448,2023.11.09
108,Think I’m In Love With You,Chris Stapleton,22,-3,25,7,0,65800,9400,56400,2582678,2023.11.09
109,People In The Back,Cody Johnson,24,,,23,0,62400,,,1468422,2023.11.09
110,Outlaws And Mustangs,Cody Jinks,7,1,6,2,0,61600,-7800,69400,221868,2023.11.09
111,Make You Mine,Marynn Taylor,58,17,41,23,0,60600,9300,51300,34923,2023.11.09
112,Neon Baby,Annie Bosko,43,,,11,0,59700,,,37305,2023.11.09
113,"Jesus, My Mama, My Therapist",Tiera Kennedy,98,3,95,19,0,59600,9600,50000,64906,2023.11.09
114,Days That End In Why,Morgan Wallen,24,19,5,16,0,56500,48400,8100,1117789,2023.11.09
115,When Will I Be Loved,"Ashley McBryde, Caylee Hammack & Pillbox Patti",12,,,10,0,55800,,,29492,2023.11.09
116,That's What I Love About Sunday,Craig Morgan & Gary Levox,9,,,9,0,55300,,,22988,2023.11.09
116,All Dogs Go To Hell,Chase Rice,9,,,9,0,55300,,,18895,2023.11.09
118,Watching My Old Flame,Cody Johnson,5,3,2,3,0,52900,41500,11400,2522663,2023.11.09
119,Lift Me Up,Darius Rucker,8,,,8,0,48600,,,32333,2023.11.09
120,Leave You Alone,Kane Brown,10,-1,11,6,0,47100,15000,32100,359445,2023.11.09
121,Jesus Loves You,Cody Johnson,5,,,3,0,46700,,,1808893,2023.11.09
122,Star Spangled Banner,Abby Anderson,8,3,5,6,0,45100,17700,27400,0,2023.11.09
123,Out Of Nowhere,Walker Montgomery,11,2,9,1,0,44900,10400,34500,8121,2023.11.09
124,My Bar,Priscilla Block,6,-7,13,3,0,42200,-23100,65300,141931,2023.11.09
125,Don't Think Jesus,Morgan Wallen,9,3,6,3,0,41700,33400,8300,1054397,2023.11.09
126,Holy Water,Michael Ray,6,0,6,2,0,41000,-12100,53100,255788,2023.11.09
127,Half a Song,Cody Johnson,5,1,4,1,0,40900,31600,9300,321327,2023.11.09
128,The Star-Spangled Banner,Chris Stapleton,10,-2,12,10,0,40900,-25500,66400,127349,2023.11.09
129,Country Music Made Me Do It,Carly Pearce,6,,,5,0,40600,,,49564,2023.11.09
130,Just Drive,Erin Kinsey,12,0,12,6,0,38600,0,38600,98931,2023.11.09
131,Hoops,Alison Nichols,56,6,50,17,0,38500,3100,35400,8918,2023.11.09
132,I'll Be Here,Colbie Caillat,18,2,16,1,0,38100,1900,36200,525497,2023.11.09
133,She,Jelly Roll,6,,,5,0,36500,,,1451420,2023.11.09
133,The Lost,Jelly Roll,6,,,5,0,36500,,,559063,2023.11.09
133,Kill A Man,Jelly Roll,6,,,5,0,36500,,,326920,2023.11.09
136,She's Gotta Know,Conner Sweet,51,19,32,17,0,35700,12600,23100,715,2023.11.09
137,Silverado,Caleb Lee Hutchinson,51,16,35,17,0,35700,11600,24100,17581,2023.11.09
138,Black Magic,Rachel Lipsky,51,1,50,17,0,35700,400,35300,274,2023.11.09
139,Two Woman Man,Randall Fowler,49,16,33,17,0,35400,12000,23400,477,2023.11.09
140,Broadway Girls,Lil Durk Feat. Morgan Wallen,7,3,4,1,0,33500,18200,15300,4282307,2023.11.09
141,Stop Coming Over,Chris Lane,11,-1,12,6,0,33000,-5600,38600,31253,2023.11.09
142,Still,Luke Combs,12,0,12,1,0,31700,-7600,39300,264448,2023.11.09
143,Double Down,Cody Johnson,4,,,2,0,30800,,,1685014,2023.11.09
144,Leather,Cody Johnson,4,,,3,0,30300,,,3455616,2023.11.09
145,Tulsa,Elle King,13,-1,14,1,0,29700,-12900,42600,46578,2023.11.09
146,Heart Attack,Boy Named Banjo,18,5,13,1,0,28500,5600,22900,4079,2023.11.09
147,Star Spangled Banner,Mickey Guyton,3,1,2,3,0,27000,11600,15400,0,2023.11.09
148,Better Off,Trace Adkins,3,-1,4,1,0,26000,10100,15900,14372,2023.11.09
149,Your Place,Ashley Cooke,9,,,8,0,25900,,,506318,2023.11.09
150,Save The Roses,Lee Brice,18,-2,20,1,0,25200,-100,25300,627039,2023.11.09
151,Question The Universe,Teddy Robb,31,3,28,19,0,25000,-33400,58400,2781,2023.11.09
152,West Of Tulsa,Wyatt Flores,11,1,10,2,0,25000,-10200,35200,245549,2023.11.09
153,Halfway To Hell,Jelly Roll,5,0,5,1,0,24100,-15000,39100,1762368,2023.11.09
154,Breakin' In Boots,Matt Stell,23,1,22,7,0,23900,-13300,37200,326073,2023.11.09
155,Summer Soundtrack,Craig Campbell,34,0,34,17,0,23800,0,23800,1188,2023.11.09
156,But A Beer Can,Eric Burgett,34,-33,67,17,0,23800,-23500,47300,10466,2023.11.09
157,A Love Song,Lady A,6,-1,7,2,0,23000,-7700,30700,139254,2023.11.09
158,Under A Southern Sky,Ian Flanigan,32,-20,52,17,0,22700,-13200,35900,10835,2023.11.09
159,Star Spangled Banner,Maren Morris,1,0,1,1,0,22300,11700,10600,0,2023.11.09
160,The Star Spangled Banner,Locash,1,0,1,1,0,22300,0,22300,0,2023.11.09
161,Back At The Bar,Landon Parker,32,-2,34,17,0,22300,-1500,23800,878,2023.11.09
162,Sun To Me,Zach Bryan,16,5,11,2,0,21600,3900,17700,4613820,2023.11.09
163,Let's Stay Together,Lamont Landers,10,,,9,0,21500,,,0,2023.11.09
164,Heart To Break,Ryan Griffin,28,1,27,2,0,20600,5100,15500,114822,2023.11.09
165,Seven Minutes In Heaven,Reba Mcentire,4,-5,9,4,0,20300,3300,17000,165662,2023.11.09
166,Die Runnin',Mike Ryan,2,1,1,2,0,19700,17300,2400,35467,2023.11.09
167,Atta Girl,Lainey Wilson,6,,,6,0,19300,,,357808,2023.11.09
167,Should Have Known Better,Jessie James Decker,6,,,6,0,19300,,,68538,2023.11.09
167,You Can'T Always Get What You,Lainey Wilson,6,,,6,0,19300,,,28194,2023.11.09
170,Runnin' Through That T,Thomas Edwards,2,,,1,0,19100,,,3693,2023.11.09
171,Heartless,Diplo & Julia Michaels Feat. Morgan Wallen,3,2,1,3,0,19000,15200,3800,5157534,2023.11.09
172,Tea Was A Little Sweeter,Matt Rogers,28,-23,51,17,0,19000,-16700,35700,2238,2023.11.09
173,Baby Do,Randall King,2,1,1,1,0,18300,17300,1000,21892,2023.11.09
174,Loser,Mike Ryan,2,-1,3,1,0,18300,-17300,35600,16935,2023.11.09
175,A Little Bit Closer,Braxton Keith,2,,,1,0,18300,,,58385,2023.11.09
176,She's A Bad Mama Jama,Lamont Landers,8,,,8,0,17400,,,0,2023.11.09
177,I Can'T Breathe,Parker Mccollum,1,0,1,1,0,17300,16300,1000,1157697,2023.11.09
178,The Day I Stop Dancin',Jon Pardi,1,0,1,1,0,17300,12400,4900,47324,2023.11.09
179,Lucky,Megan Moroney,1,0,1,1,0,17300,12300,5000,191392,2023.11.09
180,Boots On A Dance Floor,Jon Wolfe,1,0,1,1,0,17300,0,17300,72229,2023.11.09
180,We Ain't The Only Ones,Randy Rogers & Wade Bowen,1,0,1,1,0,17300,0,17300,0,2023.11.09
182,Welcome To The Show,Cody Johnson,1,,,1,0,17300,,,508478,2023.11.09
182,Another On The Way,Megan Moroney,1,,,1,0,17300,,,68813,2023.11.09
184,Hungover In A Hotel,Jason Aldean,5,,,5,0,17200,,,770426,2023.11.09
185,Codigo,George Strait,1,,,1,0,16400,,,28896,2023.11.09
186,Quittin' Time,Morgan Wallen,7,1,6,1,0,16100,-7800,23900,895501,2023.11.09
187,Wild Ones,Jessie Murph & Jelly Roll,11,0,11,1,0,16000,-6200,22200,11210149,2023.11.09
188,Cowgirls,Morgan Wallen,5,-8,13,4,0,15500,-18200,33700,5676681,2023.11.09
189,Wild,Carter Faith,10,-3,13,1,0,15400,-3100,18500,387994,2023.11.09
190,I'Ve Seen Me Do It,Joe Peters,3,2,1,1,0,15100,13100,2000,406,2023.11.09
191,Cowboy Forever,Carter Faith,10,-3,13,1,0,14900,-6200,21100,29214,2023.11.09
192,'98 Braves,Morgan Wallen,2,1,1,1,0,14800,7300,7500,2366838,2023.11.09
193,Fix'N To Break,Bailey Zimmerman,8,-8,16,1,0,14800,-17000,31800,1319656,2023.11.09
194,Country Music,Tuten Brothers,5,-2,7,1,0,14700,-400,15100,1635,2023.11.09
195,Take Her Home,Kenny Chesney,5,,,5,0,14500,,,1709,2023.11.09
196,Memory To Drown,Bryan Martin,9,3,6,1,0,14100,2000,12100,795886,2023.11.09
197,These Days,MacKenzie Porter,5,,,5,0,13700,,,28899,2023.11.09
198,Million Little Bandaids,Caroline Jones,6,5,1,3,0,13600,6400,7200,30578,2023.11.09
199,Nobody Like Jesus,LeFevre Quartet,2,,,2,0,13600,,,7918,2023.11.09
200,Any Given Friday Night,Luke Combs,2,1,1,1,0,13400,6700,6700,198054,2023.11.09
201,Jesus' Fault,Zach Williams Feat. Walker Hayes,1,,,1,0,13400,,,112249,2023.11.09
1,Thinkin' Bout Me,Morgan Wallen,7357,-643,8000,142,0,32109700,-2555100,34664800,13614443,2023.11.16
2,Standing Room Only,Tim McGraw,7870,2046,5824,143,0,31544400,9410400,22134000,2100909,2023.11.16
3,Save Me,Jelly Roll & Lainey Wilson,7037,447,6590,143,0,29109300,2234900,26874400,9256467,2023.11.16
4,Can'T Have Mine,Dylan Scott,6874,206,6668,143,0,27933900,1402900,26531000,2901023,2023.11.16
5,Stars Like Confetti,Dustin Lynch,6210,-1266,7476,142,0,26828200,-4129400,30957600,757000,2023.11.16
6,Everything I Love,Morgan Wallen,5555,307,5248,142,0,21409200,1216000,20193200,3895408,2023.11.16
7,Mind On You,George Birge,4991,268,4723,143,0,19950400,969500,18980900,462907,2023.11.16
8,Save Me The Trouble,Dan + Shay,4923,196,4727,143,0,19193400,1025800,18167600,2342806,2023.11.16
9,World On Fire,Nate Smith,4679,341,4338,143,0,19025900,1651600,17374300,6107793,2023.11.16
10,But I Got A Beer In My Hand,Luke Bryan,4958,38,4920,143,0,18814000,-263800,19077800,2045590,2023.11.16
11,White Horse,Chris Stapleton,3829,181,3648,143,0,14970900,1282300,13688600,12450423,2023.11.16
12,All I Need Is You,Chris Janson,4025,126,3899,143,0,14718600,286800,14431800,613137,2023.11.16
13,Different 'Round Here,Riley Green,3854,228,3626,143,0,14646100,806200,13839900,2667338,2023.11.16
14,We Got History,Mitchell Tenpenny,3568,-21,3589,142,0,13540000,65500,13474500,1175740,2023.11.16
15,Pretty Little Poison,Warren Zeiders,2930,172,2758,138,0,10917600,1061200,9856400,8093213,2023.11.16
16,Take Her Home,Kenny Chesney,1946,1941,5,137,0,10044600,10030100,14500,2089457,2023.11.16
17,Creek Will Rise,Conner Smith,3199,21,3178,143,0,10008800,23900,9984900,811787,2023.11.16
18,23,Chayce Beckham,2938,-11,2949,141,0,9891900,168200,9723700,3299572,2023.11.16
19,Where The Wild Things Are,Luke Combs,2405,364,2041,139,0,9637500,1082300,8555200,2947233,2023.11.16
20,The Painter,Cody Johnson,2520,125,2395,142,0,9193100,926700,8266400,6228748,2023.11.16
21,I Can Feel It,Kane Brown,2370,331,2039,142,0,8642700,1426800,7215900,3190365,2023.11.16
22,Truck Bed,Hardy,2393,112,2281,140,0,7933800,834100,7099700,6573316,2023.11.16
23,Fearless,Jackson Dean,2112,132,1980,140,0,6560800,292300,6268500,925008,2023.11.16
24,Burn It Down,Parker Mccollum,1908,6,1902,136,0,6370500,100900,6269600,5486410,2023.11.16
25,Nobody's Nobody,Brothers Osborne,2053,-35,2088,138,0,6132400,-135200,6267600,1250524,2023.11.16
26,Mamaw's House,Thomas Rhett,1349,185,1164,131,0,5077700,372100,4705600,2761187,2023.11.16
27,Tucson Too Late,Jordan Davis,1417,10,1407,137,0,4950600,-106600,5057200,1526883,2023.11.16
28,See You Next Summer,Brian Kelley,1720,-18,1738,139,0,4609500,-40100,4649600,582345,2023.11.16
29,We Don'T Fight Anymore,Carly Pearce,1534,48,1486,137,0,4571300,-64900,4636200,4684423,2023.11.16
30,Glory Days,Gabby Barrett,1705,-7,1712,139,0,4173000,-306900,4479900,1543818,2023.11.16
31,Cab In A Solo,Scotty McCreery,1520,-59,1579,141,0,4116900,58900,4058000,672621,2023.11.16
32,I Remember Everything,Zach Bryan Feat. Kacey Musgraves,1167,-24,1191,97,0,3856400,-174400,4030800,22315648,2023.11.16
33,I'M Not Pretty,Megan Moroney,1271,63,1208,119,0,3709300,278300,3431000,2617006,2023.11.16
34,Out Of That Truck,Carrie Underwood,1350,-51,1401,131,0,3543100,-17000,3560100,1836423,2023.11.16
35,Back Then Right Now,Tyler Hubbard,1195,37,1158,105,0,3333900,137500,3196400,1566184,2023.11.16
36,Outskirts,Sam Hunt,1028,-23,1051,122,0,2849500,-26400,2875900,1864124,2023.11.16
37,Love You Again,Chase Matthew,1001,36,965,84,0,2824500,80100,2744400,2132309,2023.11.16
38,Young Love & Saturday Nights,Chris Young,682,29,653,65,0,2488300,188600,2299700,705877,2023.11.16
39,Cowboys And Plowboys,Jon Pardi Feat. Luke Bryan,640,9,631,77,0,2186700,116100,2070600,830123,2023.11.16
40,Spirits And Demons,Michael Ray With Meghan Patrick,800,7,793,82,0,2012100,179300,1832800,303975,2023.11.16
41,This Is My Dirt,Justin Moore,455,,,53,0,2010800,,,326,2023.11.16
42,Drinkin' Problems,Dillon Carmichael,890,43,847,96,0,1989900,87400,1902500,78633,2023.11.16
43,Where It Ends,Bailey Zimmerman,615,53,562,60,0,1944200,239200,1705000,3032980,2023.11.16
44,Something's Gonna Kill Me,Corey Kent,698,-47,745,72,0,1902200,6100,1896100,2471309,2023.11.16
45,Can't Break Up Now,Old Dominion,691,-6,697,81,0,1856300,175100,1681200,2011152,2023.11.16
46,Man Made A Bar,Morgan Wallen,336,202,134,60,0,1801200,1175000,626200,4206631,2023.11.16
47,We Ride,Bryan Martin,568,-20,588,58,0,1750700,64400,1686300,3635208,2023.11.16
48,Pickup Man (Feat. Post Malone),Hixtape & Joe Diffie,278,96,182,84,0,1650500,824300,826200,3609534,2023.11.16
49,Rodeo Man,Garth Brooks & Ronnie Dunn,583,-859,1442,85,0,1400800,-5186200,6587000,1746880,2023.11.16
50,Dance With You,Brett Young,565,-12,577,74,0,1075700,-66100,1141800,1131038,2023.11.16
51,In Your Love,Tyler Childers,477,27,450,54,0,1014800,-101200,1116000,4465523,2023.11.16
52,Wine Country,Hannah Ellis,554,-3,557,70,0,929400,-168500,1097900,46342,2023.11.16
53,Wildflowers And Wild Horses,Lainey Wilson,294,194,100,62,0,892600,683800,208800,2150723,2023.11.16
54,Gonna Love You,Parmalee,425,65,360,51,0,871400,255100,616300,176922,2023.11.16
55,Thicc As Thieves,Lauren Alaina,313,-8,321,56,0,775300,23100,752200,958570,2023.11.16
56,Brokenhearted,Joe Nichols,427,13,414,55,0,765200,72000,693200,10694,2023.11.16
57,Find Another Bar,Chris Lane,412,-5,417,55,0,653400,16400,637000,261738,2023.11.16
58,I'm In Love,Hailey Whitters,308,-27,335,52,0,592700,-117600,710300,609690,2023.11.16
59,She's Somebody's Daughter,Drew Baldridge,310,-8,318,45,0,542000,3200,538800,422074,2023.11.16
60,Long Live Cowgirls,Ian Munsick & Cody Johnson,233,11,222,44,0,539000,7100,531900,876878,2023.11.16
61,Don'T Let The Old Man In,Toby Keith,354,63,291,64,0,513700,74200,439500,209131,2023.11.16
62,Make Me Wanna Smoke,Runaway June,254,20,234,31,0,465400,69500,395900,12137,2023.11.16
63,Cancel,Randy Houser,297,39,258,37,0,437800,21100,416700,50356,2023.11.16
63,Cancelled,Randy Houser,297,39,258,37,0,437800,21100,416700,0,2023.11.16
65,Wonder Woman,Tenille Arts,104,103,1,55,0,405000,394100,10900,96197,2023.11.16
66,Love You Back,Lady A,93,12,81,19,0,377700,6100,371600,263398,2023.11.16
67,Ain'T About You,Huntergirl,321,11,310,49,0,374700,-19400,394100,21877,2023.11.16
68,Trouble,Josh Ross,285,-6,291,46,0,340800,-3600,344400,1973859,2023.11.16
69,Without You,Thompson Square,64,-56,120,10,0,283500,-45000,328500,6431,2023.11.16
70,Ain'T Got A Worry,Old Dominion,25,0,25,1,0,280300,-12300,292600,264428,2023.11.16
71,Heart They Didn'T Break,Maddie & Tae,220,-27,247,33,0,280300,-80100,360400,867836,2023.11.16
72,This Side Of The Dirt,Neon Union,232,-12,244,35,0,249800,-83800,333600,33089,2023.11.16
73,King Of Country Music,Ryan Larkins,62,4,58,10,0,230000,-69800,299800,54666,2023.11.16
74,Ain't Missin' You,Dylan Schneider,196,-6,202,26,0,225000,-1300,226300,929099,2023.11.16
75,Rain In The Rearview,Anne Wilson,161,1,160,28,0,220600,22400,198200,358929,2023.11.16
76,Buy A Bar,Tim Dugger,48,-2,50,5,0,207100,-38500,245600,14924,2023.11.16
77,Nothing Compares To You,Mickey Guyton Feat. Kane Brown,112,13,99,17,0,196400,3900,192500,806406,2023.11.16
78,"Take Me Home, Country Roads",Blanco Brown,37,,,37,0,169500,,,19855,2023.11.16
79,John Deere Green,"HIXTAPE Feat. HARDY, Morgan Wallen, Joe Diffie",24,-84,108,12,0,168000,-135100,303100,0,2023.11.16
80,How Is She,Cole Swindell,21,-5,26,1,0,147800,-22500,170300,55371,2023.11.16
81,Georgia Girl,Megan Moroney,21,4,17,1,0,121900,8700,113200,93434,2023.11.16
82,Sarah's Place,Zach Bryan,16,0,16,1,0,116900,-11800,128700,4693387,2023.11.16
83,Loud and Heavy,Cody Jinks,42,37,5,37,0,109700,99200,10500,1555709,2023.11.16
84,Underestimate Me,Maggie Rose,49,,,48,0,108500,,,6743,2023.11.16
85,God's Hometown,Kimberly Perry,47,,,47,0,102300,,,73710,2023.11.16
86,Colorado,Florida Georgia Line,17,0,17,2,0,97200,6700,90500,44606,2023.11.16
87,Oklahoma Sooner,Jake Banfield,33,-6,39,1,0,95700,-30900,126600,5263,2023.11.16
88,Mama He's Crazy,Lainey Wilson & Dolly Parton,12,,,12,0,92100,,,307468,2023.11.16
89,The Star-Spangled Banner,Chris Stapleton,14,4,10,13,0,83300,42400,40900,124666,2023.11.16
90,Sunday Saints,Jordan Davis,16,-1,17,1,0,80900,-27800,108700,30117,2023.11.16
91,With You I Am,Cody Johnson,5,-2,7,3,0,74600,-24600,99200,1679017,2023.11.16
92,Stop Coming Over,Chris Lane,23,12,11,6,0,71600,38600,33000,30401,2023.11.16
93,My Bar,Priscilla Block,7,1,6,2,0,67900,25700,42200,150043,2023.11.16
94,Broadway Girls,Lil Durk Feat. Morgan Wallen,17,10,7,1,0,64300,30800,33500,4259986,2023.11.16
95,The Tree,Maren Morris,29,-4,33,1,0,64200,-17500,81700,572702,2023.11.16
96,Holy Water,Michael Ray,10,4,6,3,0,63400,22400,41000,243443,2023.11.16
97,No Present LIke The Time,Jay Allen,54,26,28,11,0,56600,44400,12200,0,2023.11.16
98,Make You Mine,Marynn Taylor,44,-14,58,23,0,55300,-5300,60600,32017,2023.11.16
99,I'll Be Here,Colbie Caillat,25,7,18,1,0,53200,15100,38100,460483,2023.11.16
100,Tulsa,Elle King,16,3,13,1,0,52800,23100,29700,45888,2023.11.16
101,Silverado For Sale,Morgan Wallen,16,,,15,0,51400,,,1281933,2023.11.16
102,That's Texas,Cody Johnson,6,-26,32,3,0,50500,-311300,361800,928860,2023.11.16
103,'98 Braves,Morgan Wallen,6,4,2,3,0,46300,31500,14800,2380790,2023.11.16
104,The Star-Spangled Banner,Carly Pearce,4,0,4,4,0,46200,38000,8200,0,2023.11.16
105,Dancing Away With My Heart,Dillon Carmichael,3,,,1,0,44300,,,31004,2023.11.16
106,Country Girls (Just Wanna Have Fun),Mackenzie Carpenter,12,,,11,0,43300,,,54182,2023.11.16
107,Neon Baby,Annie Bosko,51,8,43,11,0,42800,-16900,59700,41708,2023.11.16
108,Outlaws And Mustangs,Cody Jinks,11,4,7,4,0,42300,-19300,61600,191001,2023.11.16
109,"Jesus, My Mama, My Therapist",Tiera Kennedy,77,-21,98,17,0,40800,-18800,59600,20154,2023.11.16
110,Just Drive,Erin Kinsey,13,1,12,6,0,37200,-1400,38600,95791,2023.11.16
111,Breakin' In Boots,Matt Stell,31,8,23,6,0,35600,11700,23900,333679,2023.11.16
112,Still,Luke Combs,12,0,12,1,0,34000,2300,31700,257673,2023.11.16
113,Let Your Boys Be Country,Jason Aldean,6,-88,94,3,0,33500,-344900,378400,2141200,2023.11.16
114,West Of Tulsa,Wyatt Flores,12,1,11,2,0,31400,6400,25000,254464,2023.11.16
115,Halfway To Hell,Jelly Roll,6,1,5,1,0,29700,5600,24100,1851870,2023.11.16
116,Days That End In Why,Morgan Wallen,9,-15,24,2,0,29600,-26900,56500,1153311,2023.11.16
117,Young Man's Blues,Parker Mccollum,4,3,1,3,0,29100,28100,1000,461198,2023.11.16
118,Save The Roses,Lee Brice,18,0,18,2,0,29000,3800,25200,622219,2023.11.16
119,Memory To Drown,Bryan Martin,11,2,9,1,0,28700,14600,14100,865110,2023.11.16
120,Heart Attack,Boy Named Banjo,15,-3,18,1,0,28300,-200,28500,3959,2023.11.16
121,Cowgirls,Morgan Wallen,8,3,5,4,0,28200,12700,15500,5814077,2023.11.16
122,Star Spangled Banner,Abby Anderson,4,-4,8,4,0,27700,-17400,45100,0,2023.11.16
123,Hoops,Alison Nichols,34,-22,56,18,0,26800,-11700,38500,8040,2023.11.16
124,Summer To Me,Wayland,35,,,18,0,26100,,,977,2023.11.16
125,Ok Cowboy,Catie Offerman,7,-43,50,2,0,25400,-88100,113500,48086,2023.11.16
126,Must Be The Whiskey,Cody Jinks,8,3,5,1,0,24300,14800,9500,1536202,2023.11.16
127,Out Of Nowhere,Walker Montgomery,9,-2,11,1,0,24300,-20600,44900,7993,2023.11.16
128,I Wrote The Book,Morgan Wallen,3,,,1,0,24200,,,3616315,2023.11.16
129,A Love Song,Lady A,8,2,6,1,0,24100,1100,23000,117611,2023.11.16
130,Downtime,Roman Alexander,34,17,17,17,0,23800,11900,11900,22249,2023.11.16
131,Under A Southern Sky,Ian Flanigan,34,2,32,17,0,23800,1100,22700,8249,2023.11.16
132,But A Beer Can,Eric Burgett,34,0,34,17,0,23800,0,23800,5677,2023.11.16
133,Black Magic,Rachel Lipsky,34,-17,51,17,0,23800,-11900,35700,144,2023.11.16
133,She's Gotta Know,Conner Sweet,34,-17,51,17,0,23800,-11900,35700,471,2023.11.16
135,Other Side Of The Radio,Mike Ryan,3,1,2,1,0,23200,17300,5900,87599,2023.11.16
136,Me To Me,Morgan Wallen,3,,,1,0,23100,,,958974,2023.11.16
137,Two Woman Man,Randall Fowler,32,-17,49,16,0,23000,-12400,35400,416,2023.11.16
138,Silverado,Caleb Lee Hutchinson,32,-19,51,16,0,23000,-12700,35700,15206,2023.11.16
139,Tea Was A Little Sweeter,Matt Rogers,33,5,28,17,0,22300,3300,19000,2227,2023.11.16
140,Give Me A Sunrise,Braxton Keith,2,1,1,1,0,22200,21200,1000,23715,2023.11.16
141,Work Boots,Cody Johnson,2,-7,9,1,0,22200,-66800,89000,1102725,2023.11.16
142,Cowboy Forever,Carter Faith,12,2,10,1,0,20400,5500,14900,30667,2023.11.16
143,Quittin' Time,Morgan Wallen,8,1,7,1,0,19600,3500,16100,896268,2023.11.16
144,Hungover You,Emily Brooke,6,,,6,0,19300,,,804,2023.11.16
144,Most Nights,Kat & Alex,6,,,6,0,19300,,,1977,2023.11.16
144,Footprints On The Moon,Gabby Barrett,6,,,6,0,19300,,,67419,2023.11.16
144,I Will Always Love You,Gabby Barrett,6,,,6,0,19300,,,10867,2023.11.16
144,Cowboy Back,Gabby Barrett,6,,,6,0,19300,,,184079,2023.11.16
149,Still A Soldier,Trace Adkins,5,,,5,0,19200,,,59782,2023.11.16
150,Ain't That Some,Morgan Wallen,3,,,2,0,19000,,,3821835,2023.11.16
151,Sun To Me,Zach Bryan,9,-7,16,2,0,18800,-2800,21600,4589771,2023.11.16
152,Stranger In My House,Ronnie Milsap,3,-2,5,2,0,18600,-4600,23200,138149,2023.11.16
153,Happy Hour,Morgan Wallen,3,2,1,2,0,18200,12100,6100,348544,2023.11.16
154,Wild Ones,Jessie Murph & Jelly Roll,10,-1,11,1,0,18000,2000,16000,11462531,2023.11.16
155,Million Little Bandaids,Caroline Jones,28,22,6,10,0,17600,4000,13600,21039,2023.11.16
156,We Ain't The Only Ones,Randy Rogers & Wade Bowen,1,0,1,1,0,17300,0,17300,0,2023.11.16
157,Leather,Cody Johnson,1,-3,4,1,0,17300,-13000,30300,2107376,2023.11.16
158,Little Rain,Morgan Wallen,1,,,1,0,17300,,,507990,2023.11.16
158,Strong Enough,Jonas Brothers,2,,,1,0,17300,,,39,2023.11.16
160,Heart Of A Small Town,Tim Dugger,2,0,2,1,0,16800,7800,9000,8804,2023.11.16
161,The Great Divide,Luke Combs & Billy Strings,7,1,6,1,0,16100,5400,10700,197680,2023.11.16
162,Day In The 90's,Jon Langston,4,2,2,4,0,15700,6500,9200,35455,2023.11.16
163,Quarter Life Crisis,Kylie Morgan,4,,,4,0,15700,,,5048,2023.11.16
163,Girls Night Out,"Reba McEntire, Carly Pearce, Jennifer Nettles, Gabby Barrett",4,,,4,0,15700,,,29975,2023.11.16
165,High Time,Kacey Musgraves,5,2,3,1,0,15600,9800,5800,34078,2023.11.16
166,Dirt Cheap,Cody Johnson,3,-19,22,3,0,15400,-99400,114800,4073275,2023.11.16
167,Think About There,Greater Vision,3,1,2,3,0,15300,7300,8000,17757,2023.11.16
168,Hits me,Lindsay Ell,6,,,6,0,15000,,,1332,2023.11.16
169,3 Tequila Floor,Josiah Siska,3,,,1,0,14700,,,7428,2023.11.16
170,Stretchy Pants,Carrie Underwood,7,,,3,0,14300,,,66337,2023.11.16
171,No Yesterday,Jeremy McComb,6,-1,7,1,0,14200,2100,12100,282,2023.11.16
172,That's Why We Fight,Ella Langley & Koe Wetzel,8,-2,10,1,0,14000,5800,8200,590028,2023.11.16
173,Wild,Carter Faith,9,-1,10,1,0,13700,-1700,15400,323354,2023.11.16
174,Any Given Friday Night,Luke Combs,2,0,2,1,0,13400,0,13400,212720,2023.11.16
175,Smell Like Smoke,Lainey Wilson,2,,,1,0,13400,,,558273,2023.11.16
176,On The Boat Again,Jake Owen,7,0,7,1,0,13300,1600,11700,93230,2023.11.16
177,Those Boots (Deddy's Song),Lainey Wilson,4,,,4,0,13200,,,169670,2023.11.16
177,Old Glory,Jerrod Niemann,4,,,4,0,13200,,,9028,2023.11.16
177,My Last Rodeo,Riley Green,4,,,4,0,13200,,,320622,2023.11.16
180,House Fire,Tyler Childers,5,1,4,1,0,12800,3000,9800,1083907,2023.11.16
181,Giving You Up,Kameron Marlowe,2,1,1,1,0,12500,9500,3000,948613,2023.11.16
182,Country Music,Tuten Brothers,6,1,5,1,0,12100,-2600,14700,1565,2023.11.16
183,Back At The Bar,Landon Parker,17,-15,32,17,0,11900,-10400,22300,866,2023.11.16
184,Summer Soundtrack,Craig Campbell,17,-17,34,17,0,11900,-11900,23800,1154,2023.11.16
185,The Weight Of The Badge,George Strait,1,,,1,0,11600,,,49454,2023.11.16
186,He Grew The Tree,Guardians Quartet,2,1,1,2,0,11400,7300,4100,4723,2023.11.16
187,Here Comes Jesus,Jeff & Sheri Easter,2,0,2,2,0,11400,0,11400,8854,2023.11.16
188,When It Comes To Loving You,Jon Langston,2,-1,3,1,0,11200,-800,12000,96836,2023.11.16
189,Baby Do,Randall King,3,1,2,1,0,10800,-7500,18300,21585,2023.11.16
190,Record High,Randall King,2,0,2,1,0,10800,4400,6400,27796,2023.11.16
191,Star Spangled Banner,Maren Morris,1,0,1,1,0,10600,-11700,22300,0,2023.11.16
192,Heart To Break,Ryan Griffin,25,-3,28,2,0,10500,-10100,20600,192646,2023.11.16
193,Hey Jack,Priscilla Block,2,,,2,0,10400,,,0,2023.11.16
194,Me + All Your Reasons,Morgan Wallen,1,,,1,0,10400,,,1337243,2023.11.16
195,The Star Spangled Banner,Brad Paisley,3,1,2,3,0,10300,4400,5900,0,2023.11.16
196,Leave Me Again,Kelsea Ballerini,1,-47,48,1,0,10000,-85800,95800,356394,2023.11.16
197,Leave Her Wild,Tyler Rich,1,,,1,0,9700,,,125313,2023.11.16
197,Joe,Luke Combs,1,,,1,0,9700,,,520201,2023.11.16
199,Classic,Ernest,7,-2,9,1,0,9600,-300,9900,32210,2023.11.16
200,Gettin' Ready To Breathe,Wes Hampton,1,0,1,1,0,9500,2200,7300,22618,2023.11.16
200,Do It For You,Jason Crabb,1,0,1,1,0,9500,2200,7300,5002,2023.11.16
200,Make The Morning Worth The Midnight,Gaither Vocal Band,1,0,1,1,0,9500,2200,7300,3767,2023.11.16
203,Soundtrack To A Small Town Sundown,Tyler Farr,1,-1,2,1,0,9500,-1400,10900,8500,2023.11.16
204,Mountain With A View,Kelsea Ballerini,7,-2,9,1,0,9500,-1800,11300,1093453,2023.11.16
205,Wake Up,Ernie Haase & Signature Sound,1,,,1,0,9500,,,2050,2023.11.16
205,There Is A God,Reba Mcentire,1,,,1,0,9500,,,2370,2023.11.16
1,Can'T Have Mine,Dylan Scott,7985,1111,6874,143,0,32523500,4589600,27933900,2925883,2023.11.23
2,Save Me,Jelly Roll & Lainey Wilson,7625,588,7037,143,0,32256700,3147400,29109300,9057459,2023.11.23
3,Thinkin' Bout Me,Morgan Wallen,6961,-396,7357,142,0,31040900,-1068800,32109700,14066460,2023.11.23
4,World On Fire,Nate Smith,5617,938,4679,143,0,23000400,3974500,19025900,6019953,2023.11.23
5,Everything I Love,Morgan Wallen,5626,71,5555,142,0,22302700,893500,21409200,3746988,2023.11.23
6,Save Me The Trouble,Dan + Shay,5745,822,4923,143,0,21987400,2794000,19193400,2055710,2023.11.23
7,Mind On You,George Birge,5618,627,4991,143,0,21563800,1613400,19950400,471643,2023.11.23
8,But I Got A Beer In My Hand,Luke Bryan,5175,217,4958,143,0,19665300,851300,18814000,2079000,2023.11.23
9,Standing Room Only,Tim McGraw,4187,-3683,7870,143,0,17878300,-13666100,31544400,2097605,2023.11.23
10,White Horse,Chris Stapleton,4338,509,3829,143,0,17372200,2401300,14970900,10390287,2023.11.23
11,Different 'Round Here,Riley Green,4016,162,3854,143,0,15649400,1003300,14646100,2893227,2023.11.23
12,All I Need Is You,Chris Janson,4120,95,4025,143,0,15525900,807300,14718600,554614,2023.11.23
13,We Got History,Mitchell Tenpenny,3794,226,3568,142,0,14048000,508000,13540000,1365522,2023.11.23
14,Pretty Little Poison,Warren Zeiders,3353,423,2930,139,0,12253300,1335700,10917600,8626613,2023.11.23
15,I Can Feel It,Kane Brown,3258,888,2370,142,0,12126200,3483500,8642700,2985879,2023.11.23
16,Where The Wild Things Are,Luke Combs,2936,531,2405,139,0,12031700,2394200,9637500,4275379,2023.11.23
17,Creek Will Rise,Conner Smith,3402,203,3199,143,0,11356700,1347900,10008800,839761,2023.11.23
18,The Painter,Cody Johnson,2850,330,2520,142,0,10702300,1509200,9193100,5812946,2023.11.23
19,23,Chayce Beckham,3175,237,2938,142,0,10682100,790200,9891900,3136832,2023.11.23
20,Truck Bed,Hardy,2795,402,2393,140,0,9516200,1582400,7933800,7470794,2023.11.23
21,Burn It Down,Parker Mccollum,2167,259,1908,136,0,7115600,745100,6370500,5732900,2023.11.23
22,Fearless,Jackson Dean,2112,0,2112,140,0,6661400,100600,6560800,830616,2023.11.23
23,Nobody's Nobody,Brothers Osborne,2125,72,2053,139,0,6323500,191100,6132400,1101271,2023.11.23
24,Mamaw's House,Thomas Rhett,1546,197,1349,131,0,5969200,891500,5077700,2543941,2023.11.23
25,Tucson Too Late,Jordan Davis,1592,175,1417,138,0,5340300,389700,4950600,1327131,2023.11.23
26,We Don'T Fight Anymore,Carly Pearce,1830,296,1534,140,0,5074400,503100,4571300,4432785,2023.11.23
27,I Remember Everything,Zach Bryan Feat. Kacey Musgraves,1399,232,1167,128,0,4856600,1000200,3856400,23262875,2023.11.23
28,Glory Days,Gabby Barrett,1928,223,1705,139,0,4719300,546300,4173000,1896351,2023.11.23
29,Cab In A Solo,Scotty McCreery,1750,230,1520,142,0,4704300,587400,4116900,695219,2023.11.23
30,I'M Not Pretty,Megan Moroney,1445,174,1271,135,0,4613600,904300,3709300,2418587,2023.11.23
31,See You Next Summer,Brian Kelley,1750,30,1720,139,0,4496700,-112800,4609500,669598,2023.11.23
32,Out Of That Truck,Carrie Underwood,1471,121,1350,131,0,4013800,470700,3543100,1500304,2023.11.23
33,Take Her Home,Kenny Chesney,1088,-858,1946,110,0,3843400,-6201200,10044600,804218,2023.11.23
34,Back Then Right Now,Tyler Hubbard,1391,196,1195,132,0,3585400,251500,3333900,1232460,2023.11.23
35,This Is My Dirt,Justin Moore,704,249,455,78,0,3250000,1239200,2010800,1007186,2023.11.23
36,Love You Again,Chase Matthew,1130,129,1001,111,0,3150600,326100,2824500,1947461,2023.11.23
37,Man Made A Bar,Morgan Wallen,731,395,336,82,0,3080400,1279200,1801200,4580458,2023.11.23
38,Outskirts,Sam Hunt,1112,84,1028,126,0,3052100,202600,2849500,1766781,2023.11.23
39,Young Love & Saturday Nights,Chris Young,706,24,682,64,0,2735900,247600,2488300,733732,2023.11.23
40,Wildflowers And Wild Horses,Lainey Wilson,814,520,294,88,0,2651200,1758600,892600,2607485,2023.11.23
41,Cowboys And Plowboys,Jon Pardi Feat. Luke Bryan,660,20,640,77,0,2278500,91800,2186700,671476,2023.11.23
42,Can't Break Up Now,Old Dominion,801,110,691,99,0,2162700,306400,1856300,1920578,2023.11.23
43,Drinkin' Problems,Dillon Carmichael,950,60,890,93,0,2146200,156300,1989900,69270,2023.11.23
44,Spirits And Demons,Michael Ray With Meghan Patrick,824,24,800,82,0,2119900,107800,2012100,217171,2023.11.23
45,Where It Ends,Bailey Zimmerman,683,68,615,95,0,2102500,158300,1944200,3066308,2023.11.23
46,We Ride,Bryan Martin,645,77,568,58,0,1955200,204500,1750700,3491072,2023.11.23
47,Rodeo Man,Garth Brooks & Ronnie Dunn,773,190,583,100,0,1953600,552800,1400800,1486262,2023.11.23
48,Something's Gonna Kill Me,Corey Kent,746,48,698,70,0,1932000,29800,1902200,2340989,2023.11.23
49,Pickup Man (Feat. Post Malone),Hixtape & Joe Diffie,332,54,278,46,0,1861300,210800,1650500,1701381,2023.11.23
50,Gonna Love You,Parmalee,579,154,425,56,0,1331300,459900,871400,207348,2023.11.23
51,Dance With You,Brett Young,644,79,565,83,0,1151600,75900,1075700,1055293,2023.11.23
52,In Your Love,Tyler Childers,514,37,477,55,0,1112200,97400,1014800,3989496,2023.11.23
53,Brokenhearted,Joe Nichols,460,33,427,57,0,860700,95500,765200,9245,2023.11.23
54,Wine Country,Hannah Ellis,507,-47,554,68,0,751200,-178200,929400,46763,2023.11.23
55,Find Another Bar,Chris Lane,430,18,412,56,0,739000,85600,653400,193104,2023.11.23
56,I'm In Love,Hailey Whitters,341,33,308,62,0,693000,100300,592700,596573,2023.11.23
57,Thicc As Thieves,Lauren Alaina,315,2,313,45,0,617100,-158200,775300,1067376,2023.11.23
58,She's Somebody's Daughter,Drew Baldridge,324,14,310,46,0,510000,-32000,542000,416148,2023.11.23
59,Love You Back,Lady A,152,59,93,20,0,484800,107100,377700,224444,2023.11.23
60,Long Live Cowgirls,Ian Munsick & Cody Johnson,234,1,233,33,0,484700,-54300,539000,1207751,2023.11.23
61,Make Me Wanna Smoke,Runaway June,248,-6,254,32,0,435600,-29800,465400,10013,2023.11.23
62,Cancel,Randy Houser,288,-9,297,39,0,425600,-12200,437800,45414,2023.11.23
62,Cancelled,Randy Houser,288,-9,297,39,0,425600,-12200,437800,0,2023.11.23
64,Ain'T About You,Huntergirl,357,36,321,49,0,421800,47100,374700,26604,2023.11.23
65,Don'T Let The Old Man In,Toby Keith,336,-18,354,66,0,400800,-112900,513700,207323,2023.11.23
66,Underestimate Me,Maggie Rose,103,54,49,56,0,399100,290600,108500,5473,2023.11.23
67,Trouble,Josh Ross,247,-38,285,43,0,339700,-1100,340800,1805897,2023.11.23
68,This Side Of The Dirt,Neon Union,264,32,232,35,0,311600,61800,249800,27338,2023.11.23
69,Don't Let Me Cross Over,Dolly Parton,74,,,37,0,266900,,,266,2023.11.23
70,Closer,Chainsmokers Feat. Halsey,52,,,29,0,250700,,,3111028,2023.11.23
71,My Blue Tears,Dolly Parton,70,,,37,0,250200,,,3000,2023.11.23
71,My Blue Tears,Dolly Parton,70,,,37,0,250200,,,149060,2023.11.23
73,Without You,Thompson Square,67,3,64,10,0,247200,-36300,283500,6217,2023.11.23
74,King Of Country Music,Ryan Larkins,99,37,62,15,0,240600,10600,230000,47260,2023.11.23
75,Wrecking Ball,Dolly Parton Feat. Miley Cyrus,52,,,37,0,233500,,,562081,2023.11.23
76,Rain In The Rearview,Anne Wilson,187,26,161,32,0,228300,7700,220600,328578,2023.11.23
77,Ain't Missin' You,Dylan Schneider,202,6,196,26,0,213700,-11300,225000,961414,2023.11.23
78,Heart They Didn'T Break,Maddie & Tae,224,4,220,34,0,203300,-77000,280300,1152695,2023.11.23
79,Let Your Boys Be Country,Jason Aldean,78,72,6,13,0,200000,166500,33500,2520230,2023.11.23
80,Amazed,Frontmen,47,,,46,0,191000,,,0,2023.11.23
81,The Bluest Eyes In Texas,Frontmen,45,,,45,0,185800,,,0,2023.11.23
82,Buy A Bar,Tim Dugger,39,-9,48,3,0,182000,-25100,207100,14021,2023.11.23
83,Nothing Compares To You,Mickey Guyton Feat. Kane Brown,99,-13,112,16,0,181700,-14700,196400,550850,2023.11.23
84,God Blessed Texas,Frontmen,37,35,2,37,0,169500,163200,6300,0,2023.11.23
85,Laying Low In Mexico,Frontmen,37,,,37,0,169500,,,0,2023.11.23
86,Ain'T Got A Worry,Old Dominion,19,-6,25,1,0,165700,-114600,280300,212610,2023.11.23
87,Left Their Mark,Frontmen,36,,,36,0,164600,,,2101,2023.11.23
88,How Is She,Cole Swindell,20,-1,21,1,0,130200,-17600,147800,50530,2023.11.23
89,Neon Baby,Annie Bosko,79,28,51,28,0,122300,79500,42800,30449,2023.11.23
90,Sarah's Place,Zach Bryan,15,-1,16,1,0,116100,-800,116900,4293469,2023.11.23
91,Heartless,Diplo & Julia Michaels Feat. Morgan Wallen,20,17,3,15,0,114300,108700,5600,5543855,2023.11.23
92,Every Breath You Take,Dolly Parton,31,,,21,0,111500,,,499928,2023.11.23
93,Country Girl,Kylie Morgan,49,,,48,0,108500,,,42712,2023.11.23
93,Neon Tears,Camille Parker,49,,,48,0,108500,,,2226,2023.11.23
95,Colorado,Florida Georgia Line,17,0,17,2,0,101200,4000,97200,42116,2023.11.23
96,Oklahoma Sooner,Jake Banfield,30,-3,33,1,0,100700,5000,95700,5148,2023.11.23
97,Let It Be,Dolly Parton,37,,,37,0,97400,,,253456,2023.11.23
98,Stretchy Pants,Carrie Underwood,19,12,7,8,0,95200,80900,14300,253670,2023.11.23
99,The Tree,Maren Morris,31,2,29,1,0,87900,23700,64200,531911,2023.11.23
100,Sunday Saints,Jordan Davis,14,-2,16,1,0,79700,-1200,80900,27676,2023.11.23
101,Seven Minutes In Heaven,Reba Mcentire,13,,,13,0,71000,,,125839,2023.11.23
102,The Star-Spangled Banner,Chris Stapleton,11,-3,14,10,0,60300,-23000,83300,107926,2023.11.23
103,Million Little Bandaids,Caroline Jones,72,44,28,17,0,59300,41700,17600,22948,2023.11.23
104,Cowgirls,Morgan Wallen,10,2,8,4,0,59100,30900,28200,5839417,2023.11.23
105,That's What I Love About Sunday,Craig Morgan & Gary Levox,9,8,1,9,0,55400,53200,2200,19184,2023.11.23
106,With You I Am,Cody Johnson,3,-2,5,1,0,52000,-22600,74600,1534815,2023.11.23
107,The Christmas Song,Maddie & Tae,8,,,7,0,51900,,,71555,2023.11.23
108,Beer For Santa,Jon Pardi,7,5,2,7,0,51500,47600,3900,72105,2023.11.23
109,Hurry Up Christmas,Huntergirl,7,,,7,0,51500,,,83313,2023.11.23
109,Falalala Falling,Tigirlily Gold,7,,,7,0,51500,,,68885,2023.11.23
109,Winter Wonderland,Jon Pardi,7,,,7,0,51500,,,15183,2023.11.23
112,Cover Me Up,Morgan Wallen,4,0,4,3,0,50400,45200,5200,4027957,2023.11.23
113,Mama He's Crazy,Lainey Wilson & Dolly Parton,16,4,12,16,0,50100,-42000,92100,245622,2023.11.23
114,Tulsa,Elle King,15,-1,16,1,0,49900,-2900,52800,42386,2023.11.23
115,Make You Mine,Marynn Taylor,18,-26,44,6,0,49300,-6000,55300,26733,2023.11.23
116,Dancing Away With My Heart,Dillon Carmichael,3,0,3,1,0,48500,4200,44300,30500,2023.11.23
117,No Present LIke The Time,Jay Allen,60,6,54,11,0,47600,-9000,56600,0,2023.11.23
118,Feel Like The Holidays,Scotty McCreery,9,,,8,0,46600,,,119908,2023.11.23
119,Holy Water,Michael Ray,9,-1,10,4,0,46000,-17400,63400,244528,2023.11.23
120,I'll Be Here,Colbie Caillat,21,-4,25,1,0,42600,-10600,53200,384966,2023.11.23
121,400 Horsepower Sleigh,Jon Pardi,8,,,7,0,42100,,,99011,2023.11.23
122,My Bar,Priscilla Block,5,-2,7,1,0,40600,-27300,67900,139772,2023.11.23
123,Fake Names,Priscilla Block,13,,,1,0,40300,,,96359,2023.11.23
124,Must Be The Whiskey,Cody Jinks,11,3,8,3,0,39500,15200,24300,1372365,2023.11.23
125,Stop Coming Over,Chris Lane,11,-12,23,6,0,37700,-33900,71600,29142,2023.11.23
126,Outlaws And Mustangs,Cody Jinks,9,-2,11,3,0,37500,-4800,42300,175473,2023.11.23
127,Tennessee Drinkin',William Beckmann,13,7,6,1,0,37000,33000,4000,44448,2023.11.23
128,We Ain't The Only Ones,Randy Rogers & Wade Bowen,3,2,1,2,0,37000,19700,17300,0,2023.11.23
129,Star Spangled Banner,Abby Anderson,7,3,4,5,0,35800,8100,27700,0,2023.11.23
130,Summer Soundtrack,Craig Campbell,51,34,17,17,0,35700,23800,11900,1177,2023.11.23
131,Hey Jack,Priscilla Block,9,7,2,2,0,35600,25200,10400,0,2023.11.23
132,Two Woman Man,Randall Fowler,50,18,32,17,0,35300,12300,23000,536,2023.11.23
133,City Don'T,Billy Currington,12,,,12,0,35300,,,46330,2023.11.23
134,Little Rain,Morgan Wallen,2,1,1,1,0,34600,17300,17300,493137,2023.11.23
135,Out Of Nowhere,Walker Montgomery,8,-1,9,1,0,34100,9800,24300,7402,2023.11.23
136,Breakin' In Boots,Matt Stell,24,-7,31,6,0,33900,-1700,35600,441758,2023.11.23
137,Gobble Gobble,Matthew West,9,7,2,3,0,32400,26100,6300,1259762,2023.11.23
138,What I'M Thankful For,Garth Brooks,4,,,2,0,31900,,,105831,2023.11.23
139,Your Place,Ashley Cooke,7,,,7,0,30500,,,475578,2023.11.23
140,John Deere Green,"HIXTAPE Feat. HARDY, Morgan Wallen, Joe Diffie",4,-20,24,2,0,29300,-138700,168000,0,2023.11.23
141,Way Back When,Wayland,28,,,18,0,27900,,,10859,2023.11.23
142,Any Given Friday Night,Luke Combs,4,2,2,1,0,26800,13400,13400,196232,2023.11.23
143,Halfway To Hell,Jelly Roll,6,0,6,3,0,26100,-3600,29700,1575585,2023.11.23
144,Heart Attack,Boy Named Banjo,17,2,15,1,0,25200,-3100,28300,5020,2023.11.23
145,Still,Luke Combs,10,-2,12,1,0,25200,-8800,34000,246520,2023.11.23
146,Arkansas,Chris Stapleton,7,1,6,2,0,25100,17300,7800,440544,2023.11.23
147,That's Texas,Cody Johnson,7,1,6,3,0,24900,-25600,50500,678977,2023.11.23
148,When Will I Be Loved,"Ashley McBryde, Caylee Hammack & Pillbox Patti",7,,,6,0,24900,,,28944,2023.11.23
149,The Great Divide,Luke Combs & Billy Strings,6,-1,7,1,0,24800,8700,16100,221525,2023.11.23
150,Wild as You,Cody Johnson,2,1,1,2,0,24100,23100,1000,1398900,2023.11.23
151,Black Magic,Rachel Lipsky,34,0,34,17,0,23800,0,23800,229,2023.11.23
152,Save The Roses,Lee Brice,17,-1,18,1,0,23800,-5200,29000,592737,2023.11.23
153,The Star-Spangled Banner,Carly Pearce,2,-2,4,2,0,23700,-22500,46200,0,2023.11.23
154,Silverado,Caleb Lee Hutchinson,33,1,32,17,0,23400,400,23000,22556,2023.11.23
155,But A Beer Can,Eric Burgett,33,-1,34,17,0,23400,-400,23800,4949,2023.11.23
156,National Anthem From Battle At Bristol,Jennifer Nettles,4,3,1,4,0,23200,14900,8300,0,2023.11.23
157,Tea Was A Little Sweeter,Matt Rogers,32,-1,33,16,0,23000,700,22300,2242,2023.11.23
158,"Jesus, My Mama, My Therapist",Tiera Kennedy,55,-22,77,12,0,22400,-18400,40800,23599,2023.11.23
159,It's Beginning To Look A Lot Like Christmas,Maddie & Tae,3,,,1,0,22100,,,145451,2023.11.23
160,Ok Cowboy,Catie Offerman,9,2,7,3,0,21800,-3600,25400,34345,2023.11.23
161,I Just Killed A Man,Catie Offerman,8,4,4,8,0,21300,17300,4000,18278,2023.11.23
162,Quittin' Time,Morgan Wallen,5,-3,8,1,0,20400,800,19600,1155468,2023.11.23
163,Broadway Girls,Lil Durk Feat. Morgan Wallen,5,-12,17,1,0,20400,-43900,64300,4043886,2023.11.23
164,Young Man's Blues,Parker Mccollum,2,-2,4,2,0,19700,-9400,29100,427380,2023.11.23
165,I Will Always Love You,Gabby Barrett,6,0,6,6,0,19300,0,19300,10594,2023.11.23
166,Just Drive,Erin Kinsey,6,-7,13,6,0,19300,-17900,37200,95502,2023.11.23
167,Stay Drunk,Old Dominion,6,,,6,0,19300,,,82021,2023.11.23
168,Giving You Up,Kameron Marlowe,2,0,2,1,0,18700,6200,12500,899285,2023.11.23
169,That's Why We Fight,Ella Langley & Koe Wetzel,12,4,8,1,0,18000,4000,14000,535073,2023.11.23
170,Memory To Drown,Bryan Martin,7,-4,11,1,0,17900,-10800,28700,786530,2023.11.23
171,Rhinestoned,"Randy Rogers ,Wade Bowen",1,0,1,1,0,17300,16300,1000,23270,2023.11.23
171,Watching My Old Flame,Cody Johnson,1,0,1,1,0,17300,16300,1000,1299459,2023.11.23
171,Messed Around,Huser Brother Band,1,0,1,1,0,17300,16300,1000,1709,2023.11.23
174,Boots On A Dance Floor,Jon Wolfe,1,0,1,1,0,17300,12400,4900,65212,2023.11.23
175,Leather,Cody Johnson,1,0,1,1,0,17300,0,17300,1577012,2023.11.23
176,Love You A Little Bit,Tanner Adell,9,3,6,1,0,17100,8400,8700,76222,2023.11.23
177,Who Says You Can'T Have Everything,Brothers Osborne,8,,,7,0,15800,,,318213,2023.11.23
178,House Fire,Tyler Childers,7,2,5,1,0,15600,2800,12800,1054129,2023.11.23
179,Wild Ones,Jessie Murph & Jelly Roll,6,-4,10,1,0,15500,-2500,18000,11267199,2023.11.23
180,Star Spangled Banner,Mickey Guyton,2,0,2,2,0,15400,9300,6100,0,2023.11.23
181,Hoops,Alison Nichols,17,-17,34,17,0,15300,-11500,26800,9295,2023.11.23
182,Peaked In High School,Priscilla Block,6,,,6,0,15000,,,13302,2023.11.23
183,Loud and Heavy,Cody Jinks,5,-37,42,1,0,14700,-95000,109700,1434839,2023.11.23
184,'98 Braves,Morgan Wallen,2,-4,6,2,0,14600,-31700,46300,2424626,2023.11.23
185,Heart To Break,Ryan Griffin,26,1,25,2,0,14500,4000,10500,106011,2023.11.23
186,When It Comes To Loving You,Jon Langston,3,1,2,2,0,14500,3300,11200,89138,2023.11.23
187,High Time,Kacey Musgraves,8,3,5,1,0,14400,-1200,15600,34859,2023.11.23
188,He Grew The Tree,Guardians Quartet,2,0,2,2,0,13600,2200,11400,3591,2023.11.23
189,Wild,Carter Faith,9,0,9,1,0,13000,-700,13700,297176,2023.11.23
190,To Be A Man,Dax,2,,,1,0,13000,,,0,2023.11.23
191,Sun To Me,Zach Bryan,10,1,9,2,0,12900,-5900,18800,4482743,2023.11.23
192,All I Want For Christmas Is You,Jon Pardi,2,,,1,0,12900,,,20087,2023.11.23
193,Oklahoma Smokeshow,Zach Bryan,9,3,6,1,0,12400,8200,4200,5407670,2023.11.23
194,Red Kingdom,Tech N9ne,3,,,1,0,12400,,,256639,2023.11.23
195,Luke Combs,Tanner Adell,6,0,6,1,0,12300,6300,6000,38277,2023.11.23
196,The Sound of Silence,Disturbed,1,,,1,0,12200,,,2131666,2023.11.23
196,No Sad Songs,Niko Moon,1,,,1,0,12200,,,115969,2023.11.23
198,She's Gotta Know,Conner Sweet,17,-17,34,17,0,11900,-11900,23800,432,2023.11.23
199,Bad Man,Twinnie,17,,,17,0,11900,,,1086,2023.11.23
200,West Of Tulsa,Wyatt Flores,9,-3,12,2,0,11800,-19600,31400,403450,2023.11.23
1,Save Me,Jelly Roll & Lainey Wilson,8477,900,7577,142,0,34577500,2689000,31888500,7160937,2023.11.30
2,Can'T Have Mine,Dylan Scott,7279,-666,7945,142,0,29827900,-2400500,32228400,2679005,2023.11.30
3,Thinkin' Bout Me,Morgan Wallen,6568,-343,6911,141,0,29430000,-1234500,30664500,12217080,2023.11.30
4,World On Fire,Nate Smith,6118,511,5607,142,0,25308700,2355100,22953600,5073916,2023.11.30
5,Everything I Love,Morgan Wallen,5958,375,5583,142,0,23715700,1713900,22001800,3360658,2023.11.30
6,Save Me The Trouble,Dan + Shay,5888,185,5703,142,0,23195400,1496700,21698700,1544359,2023.11.30
7,Mind On You,George Birge,5887,278,5609,142,0,23033000,1511700,21521300,444176,2023.11.30
8,But I Got A Beer In My Hand,Luke Bryan,5150,23,5127,142,0,19881500,589600,19291900,1795987,2023.11.30
9,White Horse,Chris Stapleton,4560,271,4289,142,0,18341000,1347800,16993200,8164791,2023.11.30
10,Different 'Round Here,Riley Green,4247,241,4006,142,0,16961400,1373900,15587500,2284746,2023.11.30
11,All I Need Is You,Chris Janson,4115,41,4074,142,0,15708600,544500,15164100,524029,2023.11.30
12,We Got History,Mitchell Tenpenny,3899,140,3759,141,0,14936300,1148100,13788200,1129626,2023.11.30
13,I Can Feel It,Kane Brown,3480,256,3224,142,0,13536000,1675300,11860700,2407607,2023.11.30
14,Where The Wild Things Are,Luke Combs,3283,398,2885,142,0,13292900,1646200,11646700,3618196,2023.11.30
15,Pretty Little Poison,Warren Zeiders,3567,224,3343,139,0,13168400,987200,12181200,7367536,2023.11.30
16,The Painter,Cody Johnson,3078,238,2840,141,0,11810300,1181400,10628900,5074330,2023.11.30
17,Creek Will Rise,Conner Smith,3426,60,3366,142,0,11160300,57300,11103000,791703,2023.11.30
18,23,Chayce Beckham,3244,104,3140,141,0,10791100,378800,10412300,2770794,2023.11.30
19,Truck Bed,Hardy,2973,214,2759,139,0,9632800,382600,9250200,6559944,2023.11.30
20,Burn It Down,Parker Mccollum,2435,267,2168,138,0,8209700,1094100,7115600,4956712,2023.11.30
21,Fearless,Jackson Dean,2119,18,2101,139,0,6896500,291300,6605200,825152,2023.11.30
22,Nobody's Nobody,Brothers Osborne,2181,66,2115,138,0,6613700,358100,6255600,936135,2023.11.30
23,Mamaw's House,Thomas Rhett,1744,198,1546,132,0,6398600,429400,5969200,2202844,2023.11.30
24,Tucson Too Late,Jordan Davis,1598,16,1582,137,0,5503100,224700,5278400,1397334,2023.11.30
25,We Don'T Fight Anymore,Carly Pearce,1873,53,1820,139,0,5401100,400300,5000800,3620921,2023.11.30
26,Glory Days,Gabby Barrett,2005,114,1891,138,0,4921200,467400,4453800,1277413,2023.11.30
27,I Remember Everything,Zach Bryan Feat. Kacey Musgraves,1457,95,1362,128,0,4822400,231900,4590500,19759324,2023.11.30
28,Cab In A Solo,Scotty McCreery,1705,-7,1712,141,0,4612100,176600,4435500,641085,2023.11.30
29,See You Next Summer,Brian Kelley,1826,86,1740,138,0,4590100,152500,4437600,486326,2023.11.30
30,Take Her Home,Kenny Chesney,1372,296,1076,125,0,4529600,764900,3764700,599501,2023.11.30
31,Out Of That Truck,Carrie Underwood,1487,27,1460,129,0,4387000,420600,3966400,1315303,2023.11.30
32,I'M Not Pretty,Megan Moroney,1560,153,1407,133,0,4131400,-217600,4349000,2412634,2023.11.30
33,Back Then Right Now,Tyler Hubbard,1605,225,1380,132,0,3969200,430600,3538600,1096717,2023.11.30
34,Man Made A Bar,Morgan Wallen,935,204,731,104,0,3741600,661200,3080400,4145556,2023.11.30
35,Love You Again,Chase Matthew,1249,126,1123,118,0,3393300,288300,3105000,1843350,2023.11.30
36,Wildflowers And Wild Horses,Lainey Wilson,933,129,804,97,0,3212600,622700,2589900,2333032,2023.11.30
37,Outskirts,Sam Hunt,1170,71,1099,123,0,3211700,238400,2973300,1444806,2023.11.30
38,Young Love & Saturday Nights,Chris Young,743,48,695,64,0,2718400,17600,2700800,480443,2023.11.30
39,Drinkin' Problems,Dillon Carmichael,1004,54,950,93,0,2603500,457300,2146200,62115,2023.11.30
40,Rodeo Man,Garth Brooks & Ronnie Dunn,846,73,773,113,0,2222300,268700,1953600,1169437,2023.11.30
41,Spirits And Demons,Michael Ray With Meghan Patrick,895,71,824,82,0,2176600,56700,2119900,187630,2023.11.30
42,Can't Break Up Now,Old Dominion,882,92,790,99,0,2143500,43500,2100000,1444075,2023.11.30
43,Something's Gonna Kill Me,Corey Kent,775,38,737,71,0,2117600,238000,1879600,1993962,2023.11.30
44,Cowboys And Plowboys,Jon Pardi Feat. Luke Bryan,644,18,626,76,0,2048800,7600,2041200,596172,2023.11.30
45,We Ride,Bryan Martin,692,47,645,61,0,1967200,12000,1955200,3262665,2023.11.30
46,Where It Ends,Bailey Zimmerman,672,32,640,101,0,1851600,41100,1810500,2687624,2023.11.30
47,Pickup Man (Feat. Post Malone),Hixtape & Joe Diffie,330,-2,332,32,0,1719500,-141800,1861300,1121549,2023.11.30
48,Gonna Love You,Parmalee,667,88,579,62,0,1545000,213700,1331300,181140,2023.11.30
49,Dance With You,Brett Young,664,30,634,80,0,1126700,43000,1083700,918144,2023.11.30
50,In Your Love,Tyler Childers,514,0,514,54,0,1081900,-30300,1112200,3398626,2023.11.30
51,Find Another Bar,Chris Lane,461,31,430,57,0,893600,154600,739000,215906,2023.11.30
52,This Is My Dirt,Justin Moore,383,-321,704,78,0,772200,-2477800,3250000,541402,2023.11.30
53,I'm In Love,Hailey Whitters,333,-8,341,53,0,750000,57000,693000,571484,2023.11.30
54,Brokenhearted,Joe Nichols,461,1,460,57,0,749400,-111300,860700,8352,2023.11.30
55,Wine Country,Hannah Ellis,508,1,507,69,0,732200,-19000,751200,41661,2023.11.30
56,Thicc As Thieves,Lauren Alaina,310,-5,315,44,0,688600,71500,617100,773542,2023.11.30
57,Let Your Boys Be Country,Jason Aldean,248,170,78,56,0,678100,478100,200000,1445964,2023.11.30
58,Don'T Let The Old Man In,Toby Keith,406,70,336,79,0,645900,245100,400800,157081,2023.11.30
59,Long Live Cowgirls,Ian Munsick & Cody Johnson,268,34,234,35,0,615200,130500,484700,1076043,2023.11.30
60,Make Me Wanna Smoke,Runaway June,293,45,248,41,0,615100,179500,435600,9101,2023.11.30
61,She's Somebody's Daughter,Drew Baldridge,368,46,322,49,0,610500,126700,483800,375476,2023.11.30
62,Love You Back,Lady A,169,17,152,21,0,601300,116500,484800,227015,2023.11.30
63,King Of Country Music,Ryan Larkins,175,76,99,35,0,577000,336400,240600,38959,2023.11.30
64,Ain'T About You,Huntergirl,362,5,357,49,0,458600,36800,421800,17489,2023.11.30
65,Cancelled,Randy Houser,293,5,288,40,0,434900,9300,425600,0,2023.11.30
65,Cancel,Randy Houser,293,5,288,40,0,434900,9300,425600,39397,2023.11.30
67,Trouble,Josh Ross,251,4,247,41,0,365200,25500,339700,1573153,2023.11.30
68,This Side Of The Dirt,Neon Union,266,2,264,37,0,343200,31600,311600,26156,2023.11.30
69,"Take Me Home, Country Roads",Blanco Brown,57,,,55,0,308800,,,13635,2023.11.30
70,Without You,Thompson Square,48,-19,67,9,0,249300,2100,247200,5518,2023.11.30
71,Ain't Missin' You,Dylan Schneider,208,6,202,25,0,243900,30200,213700,743900,2023.11.30
72,Rain In The Rearview,Anne Wilson,177,-10,187,32,0,242900,14600,228300,289357,2023.11.30
73,Heart They Didn'T Break,Maddie & Tae,211,-5,216,32,0,198900,20700,178200,746178,2023.11.30
74,Buy A Bar,Tim Dugger,42,3,39,5,0,184900,2900,182000,11402,2023.11.30
75,How Is She,Cole Swindell,28,8,20,1,0,182600,52400,130200,46512,2023.11.30
76,Nothing Compares To You,Mickey Guyton Feat. Kane Brown,89,-10,99,14,0,162300,-19400,181700,415230,2023.11.30
77,Sarah's Place,Zach Bryan,17,2,15,1,0,124500,8400,116100,3834108,2023.11.30
78,All I Want For Christmas Is You,Jon Pardi,21,19,2,6,0,124200,111300,12900,28863,2023.11.30
79,Room,Gray Robinson,49,,,48,0,114400,,,4131,2023.11.30
80,Too Much And Not Enough,Hannah Ellis,50,,,49,0,109900,,,37335,2023.11.30
81,Grow Apart,Emma White,47,46,1,47,0,102300,91400,10900,3609,2023.11.30
82,Feel Like The Holidays,Scotty McCreery,19,10,9,11,0,99000,52400,46600,259777,2023.11.30
83,Ain'T Got A Worry,Old Dominion,15,-4,19,1,0,94200,-71500,165700,174058,2023.11.30
84,What I Have,Kelsea Ballerini,16,,,15,0,91200,,,120022,2023.11.30
85,Colorado,Florida Georgia Line,16,-1,17,2,0,90200,-11000,101200,38042,2023.11.30
86,Sunday Saints,Jordan Davis,18,4,14,1,0,87400,7700,79700,26469,2023.11.30
87,Oklahoma Sooner,Jake Banfield,28,-2,30,1,0,84600,-16100,100700,5180,2023.11.30
88,The Tree,Maren Morris,31,0,31,1,0,81200,-6700,87900,434943,2023.11.30
89,Holy Water,Michael Ray,11,2,9,4,0,79800,33800,46000,221474,2023.11.30
90,Stomp,Ben Gallaher,16,,,15,0,75800,,,50414,2023.11.30
91,The Star-Spangled Banner,Chris Stapleton,14,3,11,13,0,75000,14700,60300,83101,2023.11.30
92,Work Boots,Cody Johnson,5,4,1,2,0,73800,68900,4900,633287,2023.11.30
93,Blue Christmas,Elvis Presley & Kane Brown,14,,,5,0,72800,,,387946,2023.11.30
94,With You I Am,Cody Johnson,5,2,3,2,0,72100,20100,52000,1418661,2023.11.30
95,Million Little Bandaids,Caroline Jones,95,23,72,18,0,69700,10400,59300,27189,2023.11.30
96,Chevrolet,Dustin Lynch,14,12,2,10,0,69200,63000,6200,0,2023.11.30
97,Fake Names,Priscilla Block,19,6,13,2,0,67600,27300,40300,82385,2023.11.30
98,It's Beginning To Look A Lot Like Christmas,Maddie & Tae,7,4,3,1,0,63500,41400,22100,255490,2023.11.30
99,My Bar,Priscilla Block,11,6,5,5,0,56700,16100,40600,125274,2023.11.30
100,Breakin' In Boots,Matt Stell,33,9,24,6,0,56100,22200,33900,503095,2023.11.30
101,What Christmas Means To Me,Old Dominion,6,5,1,1,0,55900,45800,10100,1,2023.11.30
102,That's What I Love About Sunday,Craig Morgan & Gary Levox,9,0,9,9,0,55400,0,55400,15130,2023.11.30
103,Beer For Santa,Jon Pardi,6,-1,7,6,0,50700,-800,51500,138167,2023.11.30
104,Tulsa,Elle King,15,0,15,1,0,49100,-800,49900,36759,2023.11.30
105,Neon Baby,Annie Bosko,88,9,79,17,0,48800,-73500,122300,29275,2023.11.30
106,No Present LIke The Time,Jay Allen,67,7,60,11,0,47600,0,47600,0,2023.11.30
107,Keith Whitley,Morgan Wallen,15,,,15,0,47300,,,767398,2023.11.30
108,Stop Coming Over,Chris Lane,13,2,11,6,0,44200,6500,37700,25519,2023.11.30
109,Santa Looked A Lot Like Daddy,Jon Pardi,5,,,3,0,41100,,,185525,2023.11.30
110,I'll Be Here,Colbie Caillat,16,-5,21,1,0,40000,-2600,42600,321123,2023.11.30
111,Must Be The Whiskey,Cody Jinks,10,-1,11,2,0,36000,-3500,39500,1239879,2023.11.30
112,Silverado,Caleb Lee Hutchinson,51,18,33,17,0,35700,12300,23400,17683,2023.11.30
113,Summer Soundtrack,Craig Campbell,50,-1,51,17,0,34200,-1500,35700,867,2023.11.30
114,Your Place,Ashley Cooke,12,5,7,8,0,32400,1900,30500,406866,2023.11.30
115,Santa Baby,Trisha Yearwood,8,7,1,3,0,32300,31500,800,5301,2023.11.30
116,Broadway Girls,Lil Durk Feat. Morgan Wallen,5,0,5,1,0,32300,11900,20400,3565082,2023.11.30
117,Young Man,Greylan James,4,,,1,0,31100,,,91665,2023.11.30
118,Ok Cowboy,Catie Offerman,11,2,9,3,0,30000,8200,21800,26994,2023.11.30
119,Heart Attack,Boy Named Banjo,17,0,17,1,0,29900,4700,25200,5034,2023.11.30
120,Way Back When,Wayland,37,9,28,13,0,28700,800,27900,11954,2023.11.30
121,Love Can Build A Bridge,"Jelly Roll, K. Michelle & The Fisk Jubilee Singers",7,,,7,0,28400,,,82995,2023.11.30
122,Out Of Nowhere,Walker Montgomery,9,1,8,1,0,27500,-6600,34100,6905,2023.11.30
123,Hoops,Alison Nichols,35,17,18,18,0,27200,11900,15300,8686,2023.11.30
124,Stranger In My House,Ronnie Milsap,3,-2,5,1,0,25800,-2300,28100,119573,2023.11.30
125,Hey Jack,Priscilla Block,7,-2,9,1,0,25800,-9800,35600,0,2023.11.30
126,Still,Luke Combs,10,0,10,1,0,25600,400,25200,227892,2023.11.30
127,Boys Back Home,Dylan Marlowe Feat. Dylan Scott,8,7,1,3,0,25300,18100,7200,1618087,2023.11.30
128,'98 Braves,Morgan Wallen,3,1,2,2,0,25200,10600,14600,2264577,2023.11.30
129,Save The Roses,Lee Brice,18,1,17,1,0,25200,1400,23800,500015,2023.11.30
130,Leave You Alone,Kane Brown,5,,,5,0,24900,,,326764,2023.11.30
131,Feliz Navidad,Frank Ray,7,,,4,0,24200,,,50686,2023.11.30
132,Star Spangled Banner,Abby Anderson,3,-4,7,3,0,23900,-11900,35800,0,2023.11.30
133,Bad Man,Twinnie,34,17,17,17,0,23800,11900,11900,969,2023.11.30
133,She's Gotta Know,Conner Sweet,34,17,17,17,0,23800,11900,11900,317,2023.11.30
135,Black Magic,Rachel Lipsky,34,0,34,17,0,23800,0,23800,225,2023.11.30
136,Two Woman Man,Randall Fowler,34,-16,50,17,0,23800,-11500,35300,425,2023.11.30
137,Star Spangled Banner,Maren Morris,1,0,1,1,0,22300,21700,600,0,2023.11.30
138,Cowgirls,Morgan Wallen,9,-1,10,2,0,22000,-37100,59100,5398215,2023.11.30
139,Hurry Up Christmas,Huntergirl,4,-3,7,4,0,21900,-29600,51500,131761,2023.11.30
140,Almost Home,Craig Morgan And Jelly Roll,7,,,7,0,21500,,,294098,2023.11.30
141,The Great Divide,Luke Combs & Billy Strings,7,1,6,1,0,20800,-4000,24800,202697,2023.11.30
142,Make You Mine,Marynn Taylor,7,-11,18,6,0,20600,-28700,49300,25196,2023.11.30
143,I Need You,Frontmen,4,3,1,4,0,20300,10300,10000,14761,2023.11.30
144,Falalala Falling,Tigirlily Gold,3,-4,7,3,0,20300,-31200,51500,174308,2023.11.30
145,400 Horsepower Sleigh,Jon Pardi,3,-5,8,3,0,20300,-21800,42100,194674,2023.11.30
146,The Christmas Song,Maddie & Tae,3,-5,8,3,0,20300,-31600,51900,141234,2023.11.30
147,I'M Not For Everyone,Brothers Osborne,4,3,1,3,0,19900,19400,500,419822,2023.11.30
148,Just Drive,Erin Kinsey,6,0,6,6,0,19300,0,19300,85693,2023.11.30
149,Hungover You,Emily Brooke,6,,,6,0,19300,,,663,2023.11.30
150,Winter Wonderland,Jon Pardi,3,-4,7,3,0,19200,-32300,51500,20961,2023.11.30
151,Oklahoma Smokeshow,Zach Bryan,11,2,9,1,0,19100,6700,12400,4985426,2023.11.30
152,Please Come Home For Christmas,Jon Pardi,3,,,3,0,19000,,,109451,2023.11.30
153,Memory To Drown,Bryan Martin,11,4,7,1,0,18800,900,17900,746595,2023.11.30
154,Heartless,Diplo & Julia Michaels Feat. Morgan Wallen,4,-16,20,2,0,17600,-96700,114300,4924404,2023.11.30
155,That's Why We Fight,Ella Langley & Koe Wetzel,10,-2,12,1,0,17500,-500,18000,474406,2023.11.30
156,My Baby Does,Drew Parker,1,0,1,1,0,17300,12400,4900,2849,2023.11.30
157,"Mirror, Mirror",Randall King,1,,,1,0,17300,,,143895,2023.11.30
157,Sunrise Tells The Story,Midland,1,,,1,0,17300,,,120346,2023.11.30
157,A Little Bit Closer,Braxton Keith,1,,,1,0,17300,,,58325,2023.11.30
160,"Jesus, My Mama, My Therapist",Tiera Kennedy,34,-21,55,9,0,17200,-5200,22400,11405,2023.11.30
161,Young Man's Blues,Parker Mccollum,1,-1,2,1,0,17000,-2700,19700,394791,2023.11.30
162,Blue Christmas,Lane Johnson & Jason Kelce,2,,,1,0,17000,,,134129,2023.11.30
163,Codigo,George Strait,1,,,1,0,16400,,,35204,2023.11.30
164,Kiss That Girl Goodbye,Aaron Watson,3,2,1,2,0,16200,10800,5400,12193,2023.11.30
165,For The Both Of Us,Dan + Shay,6,,,6,0,15000,,,118816,2023.11.30
166,Heart Of A Small Town,Tim Dugger,4,2,2,2,0,14800,3600,11200,8643,2023.11.30
167,Runnin' Outta Love,Tim McGraw,2,,,2,0,14600,,,1597349,2023.11.30
168,"Salt, Lime & Tequila",Ryan Griffin,4,,,1,0,14400,,,45007,2023.11.30
169,Quittin' Time,Morgan Wallen,5,0,5,1,0,13800,-6600,20400,1088913,2023.11.30
170,Life With You,Kelsey Hart,2,1,1,1,0,13600,6400,7200,891821,2023.11.30
171,Great God Almighty,Sound,2,,,2,0,13600,,,510,2023.11.30
172,Cowboy Forever,Carter Faith,9,-1,10,1,0,13000,2200,10800,26326,2023.11.30
173,West Of Tulsa,Wyatt Flores,10,1,9,2,0,12800,1000,11800,302666,2023.11.30
174,Outlaws And Mustangs,Cody Jinks,9,0,9,2,0,12800,-24700,37500,136622,2023.11.30
175,John Deere Green,"HIXTAPE Feat. HARDY, Morgan Wallen, Joe Diffie",2,-2,4,1,0,12700,-16600,29300,0,2023.11.30
176,To Be A Man,Dax,2,0,2,1,0,12000,-1000,13000,0,2023.11.30
177,Better Off,Trace Adkins,3,1,2,2,0,11900,700,11200,12463,2023.11.30
178,Downtime,Roman Alexander,17,1,16,17,0,11900,400,11500,16456,2023.11.30
178,Under A Southern Sky,Ian Flanigan,17,1,16,17,0,11900,400,11500,5187,2023.11.30
180,Tea Was A Little Sweeter,Matt Rogers,17,-15,32,17,0,11900,-11100,23000,1731,2023.11.30
181,But A Beer Can,Eric Burgett,17,-16,33,17,0,11900,-11500,23400,4165,2023.11.30
182,Back At The Bar,Landon Parker,17,,,17,0,11900,,,1429,2023.11.30
183,That Ain'T Country,Aaron Lewis,7,5,2,1,0,11400,10500,900,94487,2023.11.30
184,No Yesterday,Jeremy McComb,6,-1,7,1,0,11200,3800,7400,403,2023.11.30
185,Sun To Me,Zach Bryan,7,-3,10,2,0,11200,-1700,12900,4222659,2023.11.30
186,Things I Take For Granted,Larry Fleet,1,,,1,0,11200,,,527422,2023.11.30
186,"The Father, My Son, And The Holy Ghost",Craig Morgan,2,,,1,0,11200,,,43691,2023.11.30
188,Hawaii,Old Dominion,2,,,2,0,11000,,,68902,2023.11.30
189,Dirt Cheap,Cody Johnson,3,,,2,0,10900,,,3066506,2023.11.30
190,Runnin' Through That T,Thomas Edwards,1,0,1,1,0,10800,0,10800,2548,2023.11.30
191,Heart To Break,Ryan Griffin,23,-3,26,2,0,10000,-4500,14500,99682,2023.11.30
192,High Time,Kacey Musgraves,5,-3,8,1,0,10000,-4400,14400,32160,2023.11.30
193,Watching My Old Flame,Cody Johnson,2,1,1,2,0,9800,-7500,17300,1071499,2023.11.30
194,Days That End In Why,Morgan Wallen,5,-2,7,2,0,9800,1700,8100,1203910,2023.11.30
195,Love You A Little Bit,Tanner Adell,7,-2,9,1,0,9800,-7300,17100,79008,2023.11.30
196,House Fire,Tyler Childers,4,-3,7,1,0,9800,-5800,15600,919180,2023.11.30
197,Love Carried The Cross,Endless Highway,1,0,1,1,0,9500,0,9500,16403,2023.11.30
197,Because He Lives,Carrie Underwood,1,0,1,1,0,9500,0,9500,35273,2023.11.30
197,Sheltered In The Arms Of God,Hillary Scott & The Scott Family,1,0,1,1,0,9500,0,9500,3129,2023.11.30
200,He Grew The Tree,Guardians Quartet,1,-1,2,1,0,9500,-4100,13600,2457,2023.11.30
201,Dangerous,Morgan Wallen,2,,,2,0,9500,,,1263467,2023.11.30
1,Save Me,Jelly Roll & Lainey Wilson,7771,-706,8477,142,0,32570900,-2006600,34577500,7955135,2023.12.07
2,World On Fire,Nate Smith,6796,678,6118,142,0,27226500,1917800,25308700,5290685,2023.12.07
3,Thinkin' Bout Me,Morgan Wallen,5840,-728,6568,139,0,26638700,-2791300,29430000,13308160,2023.12.07
4,But I Got A Beer In My Hand,Luke Bryan,6637,1487,5150,142,0,24984300,5102800,19881500,1409374,2023.12.07
5,Mind On You,George Birge,6352,465,5887,142,0,24579200,1546200,23033000,528859,2023.12.07
6,Everything I Love,Morgan Wallen,6092,134,5958,142,0,24111100,395400,23715700,3524448,2023.12.07
7,Save Me The Trouble,Dan + Shay,6180,292,5888,142,0,23921900,726500,23195400,1584713,2023.12.07
8,Can'T Have Mine,Dylan Scott,4961,-2318,7279,138,0,22483300,-7344600,29827900,2438784,2023.12.07
9,White Horse,Chris Stapleton,4871,311,4560,142,0,19134900,793900,18341000,8484120,2023.12.07
10,Different 'Round Here,Riley Green,4468,221,4247,142,0,17580000,618600,16961400,2191027,2023.12.07
11,All I Need Is You,Chris Janson,4403,288,4115,142,0,16292000,583400,15708600,512658,2023.12.07
12,We Got History,Mitchell Tenpenny,4200,301,3899,141,0,15965300,1029000,14936300,1108425,2023.12.07
13,Pretty Little Poison,Warren Zeiders,3940,373,3567,139,0,14475000,1306600,13168400,7441986,2023.12.07
14,Where The Wild Things Are,Luke Combs,3569,286,3283,142,0,14251100,958200,13292900,3880666,2023.12.07
15,I Can Feel It,Kane Brown,3633,153,3480,142,0,14046700,510700,13536000,2737575,2023.12.07
16,The Painter,Cody Johnson,3328,250,3078,142,0,13514200,1703900,11810300,4782746,2023.12.07
17,Creek Will Rise,Conner Smith,3438,12,3426,142,0,11314100,153800,11160300,847841,2023.12.07
18,23,Chayce Beckham,3370,126,3244,141,0,11191800,400700,10791100,3026124,2023.12.07
19,Truck Bed,Hardy,3107,134,2973,139,0,10436900,804100,9632800,6345558,2023.12.07
20,Burn It Down,Parker Mccollum,2574,139,2435,139,0,9066000,856300,8209700,4783361,2023.12.07
21,Fearless,Jackson Dean,2258,139,2119,139,0,7002200,105700,6896500,879616,2023.12.07
22,We Don'T Fight Anymore,Carly Pearce,2032,159,1873,140,0,6304700,903600,5401100,3629432,2023.12.07
23,Nobody's Nobody,Brothers Osborne,2153,-28,2181,137,0,6203200,-410500,6613700,944992,2023.12.07
24,Mamaw's House,Thomas Rhett,1795,51,1744,135,0,6064800,-333800,6398600,2293918,2023.12.07
25,Tucson Too Late,Jordan Davis,1712,114,1598,137,0,5806000,302900,5503100,1414373,2023.12.07
26,Glory Days,Gabby Barrett,2136,131,2005,140,0,5388800,467600,4921200,1125018,2023.12.07
27,Cab In A Solo,Scotty McCreery,2030,325,1705,141,0,5108200,496100,4612100,694583,2023.12.07
28,I Remember Everything,Zach Bryan Feat. Kacey Musgraves,1459,2,1457,129,0,4776200,-46200,4822400,19941098,2023.12.07
29,See You Next Summer,Brian Kelley,1752,-74,1826,139,0,4586800,-3300,4590100,564929,2023.12.07
30,Man Made A Bar,Morgan Wallen,1102,167,935,132,0,4446600,705000,3741600,4190411,2023.12.07
31,Back Then Right Now,Tyler Hubbard,1698,93,1605,134,0,4205900,236700,3969200,1134220,2023.12.07
32,Wildflowers And Wild Horses,Lainey Wilson,1269,336,933,137,0,4181900,969300,3212600,1829227,2023.12.07
33,Take Her Home,Kenny Chesney,1391,19,1372,138,0,4170000,-359600,4529600,751430,2023.12.07
34,Out Of That Truck,Carrie Underwood,1494,7,1487,129,0,4166300,-220700,4387000,1385327,2023.12.07
35,I'M Not Pretty,Megan Moroney,1560,0,1560,133,0,4148100,16700,4131400,2099815,2023.12.07
36,Love You Again,Chase Matthew,1306,57,1249,119,0,3585400,192100,3393300,2015566,2023.12.07
37,Outskirts,Sam Hunt,1207,37,1170,127,0,3233300,21600,3211700,1521208,2023.12.07
38,Young Love & Saturday Nights,Chris Young,748,5,743,66,0,2870300,151900,2718400,495263,2023.12.07
39,Drinkin' Problems,Dillon Carmichael,1037,33,1004,99,0,2809100,205600,2603500,65827,2023.12.07
40,Can't Break Up Now,Old Dominion,1049,167,882,116,0,2729700,586200,2143500,1315994,2023.12.07
41,Spirits And Demons,Michael Ray With Meghan Patrick,950,55,895,90,0,2381700,205100,2176600,213298,2023.12.07
42,We Ride,Bryan Martin,694,2,692,64,0,2093100,125900,1967200,3548110,2023.12.07
43,Where It Ends,Bailey Zimmerman,727,55,672,104,0,2076200,224600,1851600,3363454,2023.12.07
44,Rodeo Man,Garth Brooks & Ronnie Dunn,815,-31,846,109,0,2032700,-189600,2222300,1005672,2023.12.07
45,Something's Gonna Kill Me,Corey Kent,740,-35,775,72,0,2003500,-114100,2117600,2278282,2023.12.07
46,Cowboys And Plowboys,Jon Pardi Feat. Luke Bryan,648,4,644,81,0,1897800,-151000,2048800,714901,2023.12.07
47,Pickup Man (Feat. Post Malone),Hixtape & Joe Diffie,354,24,330,68,0,1779700,60200,1719500,902676,2023.12.07
48,Gonna Love You,Parmalee,693,26,667,64,0,1664700,119700,1545000,214403,2023.12.07
49,Dance With You,Brett Young,762,98,664,81,0,1484100,357400,1126700,1008453,2023.12.07
50,Let Your Boys Be Country,Jason Aldean,488,240,248,63,0,1216100,538000,678100,1478243,2023.12.07
51,In Your Love,Tyler Childers,494,-20,514,55,0,1003700,-78200,1081900,3215156,2023.12.07
52,Find Another Bar,Chris Lane,502,41,461,76,0,940900,47300,893600,220227,2023.12.07
53,This Is My Dirt,Justin Moore,506,123,383,74,0,905300,133100,772200,342676,2023.12.07
54,Wine Country,Hannah Ellis,605,97,508,69,0,855300,123100,732200,42428,2023.12.07
55,I'm In Love,Hailey Whitters,374,41,333,56,0,816800,66800,750000,504202,2023.12.07
56,Brokenhearted,Joe Nichols,476,15,461,58,0,769800,20400,749400,9115,2023.12.07
57,Love You Back,Lady A,291,122,169,41,0,762100,160800,601300,197931,2023.12.07
58,Long Live Cowgirls,Ian Munsick & Cody Johnson,286,18,268,37,0,698400,83200,615200,869422,2023.12.07
59,Make Me Wanna Smoke,Runaway June,281,-12,293,33,0,697100,82000,615100,10369,2023.12.07
60,Don'T Let The Old Man In,Toby Keith,426,20,406,75,0,614300,-31600,645900,177337,2023.12.07
61,She's Somebody's Daughter,Drew Baldridge,352,-16,368,51,0,573500,-37000,610500,401435,2023.12.07
62,King Of Country Music,Ryan Larkins,256,81,175,43,0,552500,-24500,577000,50427,2023.12.07
63,Ain'T About You,Huntergirl,398,36,362,63,0,543800,85200,458600,14697,2023.12.07
64,Cancelled,Randy Houser,309,16,293,42,0,511200,76300,434900,0,2023.12.07
64,Cancel,Randy Houser,309,16,293,42,0,511200,76300,434900,57786,2023.12.07
66,Thicc As Thieves,Lauren Alaina,275,-35,310,45,0,488200,-200400,688600,751190,2023.12.07
67,This Side Of The Dirt,Neon Union,263,-3,266,37,0,450100,106900,343200,21931,2023.12.07
68,Trouble,Josh Ross,248,-3,251,52,0,404400,39200,365200,1799533,2023.12.07
69,Without You,Thompson Square,52,4,48,9,0,332700,83400,249300,5869,2023.12.07
70,Left Their Mark,Frontmen,57,,,56,0,301600,,,1024,2023.12.07
71,Chevrolet,Dustin Lynch,103,89,14,29,0,249300,180100,69200,0,2023.12.07
72,Rain In The Rearview,Anne Wilson,173,-4,177,32,0,215800,-27100,242900,285146,2023.12.07
73,Ain't Missin' You,Dylan Schneider,205,-3,208,25,0,207500,-36400,243900,899504,2023.12.07
74,All I Want For Christmas Is You,Jon Pardi,30,9,21,10,0,192100,67900,124200,35159,2023.12.07
75,Heart They Didn'T Break,Maddie & Tae,212,1,211,32,0,189000,-9900,198900,816469,2023.12.07
76,How Is She,Cole Swindell,28,0,28,1,0,175700,-6900,182600,51457,2023.12.07
77,Nothing Compares To You,Mickey Guyton Feat. Kane Brown,88,-1,89,13,0,171500,9200,162300,477180,2023.12.07
78,Buy A Bar,Tim Dugger,24,-18,42,3,0,166900,-18000,184900,10952,2023.12.07
79,Amy's Back In Austin,Eli Young Band & George Birge,36,,,36,0,165000,,,0,2023.12.07
80,I Hate Alabama,Conner Smith,20,19,1,1,0,151700,146100,5600,146812,2023.12.07
81,Breakin' In Boots,Matt Stell,80,47,33,13,0,147300,91200,56100,483617,2023.12.07
82,Sarah's Place,Zach Bryan,16,-1,17,1,0,125300,800,124500,3820182,2023.12.07
83,Bet You Break My Heart,MacKenzie Porter,48,,,48,0,105500,,,101396,2023.12.07
84,Wrecking Ball,Dolly Parton Feat. Miley Cyrus,48,,,48,0,105400,,,174997,2023.12.07
84,Black Corvette,Kimberly Perry,48,,,48,0,105400,,,2607,2023.12.07
86,Beer For Santa,Jon Pardi,16,10,6,9,0,88600,37900,50700,212860,2023.12.07
87,Your Place,Ashley Cooke,40,28,12,9,0,88300,55900,32400,867538,2023.12.07
88,Colorado,Florida Georgia Line,16,0,16,2,0,88100,-2100,90200,38819,2023.12.07
89,Feel Like The Holidays,Scotty McCreery,18,-1,19,10,0,83200,-15800,99000,380981,2023.12.07
90,My Bar,Priscilla Block,11,0,11,2,0,82100,25400,56700,136100,2023.12.07
91,Million Little Bandaids,Caroline Jones,112,17,95,21,0,80000,10300,69700,45707,2023.12.07
92,Santa Looked A Lot Like Daddy,Jon Pardi,11,6,5,6,0,77600,36500,41100,284898,2023.12.07
93,Sunday Saints,Jordan Davis,15,-3,18,1,0,75600,-11800,87400,31460,2023.12.07
94,No Present LIke The Time,Jay Allen,72,5,67,13,0,72300,24700,47600,0,2023.12.07
95,Neon Baby,Annie Bosko,96,8,88,18,0,67600,18800,48800,33420,2023.12.07
96,Ain'T Got A Worry,Old Dominion,12,-3,15,1,0,66300,-27900,94200,201170,2023.12.07
97,The Star-Spangled Banner,Carly Pearce,6,5,1,6,0,62300,56000,6300,0,2023.12.07
98,It's Beginning To Look A Lot Like Christmas,Maddie & Tae,9,2,7,1,0,58000,-5500,63500,527760,2023.12.07
99,Fake Names,Priscilla Block,16,-3,19,1,0,53700,-13900,67600,80560,2023.12.07
100,Boys Back Home,Dylan Marlowe Feat. Dylan Scott,40,32,8,9,0,52500,27200,25300,2033828,2023.12.07
101,Lift Me Up,Darius Rucker,8,,,8,0,52500,,,22656,2023.12.07
102,Ol' Church Hymn,Darius Rucker Feat. Chapel Hart,8,,,8,0,52400,,,33528,2023.12.07
103,Stop Coming Over,Chris Lane,17,4,13,6,0,52300,8100,44200,25277,2023.12.07
104,What Christmas Means To Me,Old Dominion,7,1,6,1,0,50800,-5100,55900,0,2023.12.07
105,Wild Ones,Jessie Murph & Jelly Roll,14,5,9,1,0,45700,36500,9200,10045480,2023.12.07
106,Tulsa,Elle King,13,-2,15,1,0,45500,-3600,49100,42427,2023.12.07
107,The Star-Spangled Banner,Chris Stapleton,9,-5,14,8,0,44200,-30800,75000,81433,2023.12.07
108,With You I Am,Cody Johnson,4,-1,5,3,0,43800,-28300,72100,1474397,2023.12.07
109,Feliz Navidad,Frank Ray,9,2,7,7,0,43600,19400,24200,75130,2023.12.07
110,I'll Be Here,Colbie Caillat,22,6,16,1,0,41900,1900,40000,367309,2023.12.07
111,Blue Christmas,Elvis Presley & Kane Brown,10,-4,14,6,0,38900,-33900,72800,551378,2023.12.07
112,Bits & Pieces,Walker County,12,,,6,0,38600,,,1921,2023.12.07
112,When Will I Be Loved,"Ashley McBryde, Caylee Hammack & Pillbox Patti",12,,,6,0,38600,,,26705,2023.12.07
114,Loser,Mike Ryan,3,1,2,2,0,37000,33600,3400,16225,2023.12.07
115,Heart Attack,Boy Named Banjo,19,2,17,1,0,36800,6900,29900,4526,2023.12.07
116,West Of Tulsa,Wyatt Flores,8,-2,10,2,0,36100,23300,12800,269364,2023.12.07
117,Ok Cowboy,Catie Offerman,13,2,11,4,0,35900,5900,30000,29776,2023.12.07
118,She's Gotta Know,Conner Sweet,51,17,34,17,0,35700,11900,23800,531,2023.12.07
119,Work Boots,Cody Johnson,2,-3,5,1,0,34600,-39200,73800,587892,2023.12.07
120,Follow,William Beckmann,2,,,1,0,34600,,,5506,2023.12.07
121,400 Horsepower Sleigh,Jon Pardi,7,4,3,6,0,32300,12000,20300,310524,2023.12.07
122,Santa Baby,Trisha Yearwood,12,4,8,4,0,31800,-500,32300,6667,2023.12.07
123,Dancing Away With My Heart,Dillon Carmichael,2,,,1,0,31400,,,29440,2023.12.07
124,Oklahoma Sooner,Jake Banfield,17,-11,28,1,0,28900,-55700,84600,8411,2023.12.07
125,That's Texas,Cody Johnson,3,-2,5,1,0,28400,19500,8900,476616,2023.12.07
126,Hoops,Alison Nichols,33,-2,35,18,0,26900,-300,27200,7070,2023.12.07
127,Quittin' Time,Morgan Wallen,11,6,5,1,0,26800,13000,13800,854356,2023.12.07
128,Oklahoma Smokeshow,Zach Bryan,16,5,11,2,0,26700,7600,19100,5725057,2023.12.07
129,Blue Christmas,Elvie Shane,5,4,1,3,0,26600,26100,500,1460,2023.12.07
130,Hungover You,Emily Brooke,7,1,6,6,0,24900,5600,19300,716,2023.12.07
131,3 Feet Tall,Cole Swindell,4,,,4,0,24900,,,1200030,2023.12.07
132,Holy Water,Michael Ray,3,-8,11,1,0,24400,-55400,79800,245248,2023.12.07
133,Downtime,Roman Alexander,34,17,17,17,0,23800,11900,11900,16148,2023.12.07
133,Under A Southern Sky,Ian Flanigan,34,17,17,17,0,23800,11900,11900,4941,2023.12.07
133,Tea Was A Little Sweeter,Matt Rogers,34,17,17,17,0,23800,11900,11900,1819,2023.12.07
136,Bad Man,Twinnie,34,0,34,17,0,23800,0,23800,836,2023.12.07
137,Summer Soundtrack,Craig Campbell,34,-16,50,17,0,23800,-10400,34200,756,2023.12.07
138,Silverado,Caleb Lee Hutchinson,34,-17,51,17,0,23800,-11900,35700,15375,2023.12.07
139,Black Magic,Rachel Lipsky,33,-1,34,17,0,23000,-800,23800,338,2023.12.07
140,Boys 'Round Here (Live 2017),Blake Shelton,1,,,1,0,22500,,,0,2023.12.07
141,The Weight Of The Badge,George Strait,2,1,1,2,0,22400,20300,2100,41141,2023.12.07
142,Save The Roses,Lee Brice,16,-2,18,1,0,22400,-2800,25200,503176,2023.12.07
143,The Star Spangled Banner,Locash,1,,,1,0,22300,,,0,2023.12.07
144,Halfway To Hell,Jelly Roll,10,6,4,7,0,21700,12900,8800,1605222,2023.12.07
145,Blue Christmas,Lane Johnson & Jason Kelce,1,-1,2,1,0,21700,4700,17000,135001,2023.12.07
146,Mary Did You Know?,Hannah Ellis,2,,,1,0,21000,,,0,2023.12.07
147,God Blessed Texas,Frontmen,9,7,2,8,0,20300,14000,6300,0,2023.12.07
148,Grease,Lainey Wilson,4,,,4,0,20300,,,136391,2023.12.07
149,Heart Of A Small Town,Tim Dugger,4,0,4,2,0,19800,5000,14800,8906,2023.12.07
150,Just Drive,Erin Kinsey,6,0,6,6,0,19300,0,19300,83319,2023.12.07
151,Make You Mine,Marynn Taylor,6,-1,7,6,0,19300,-1300,20600,27759,2023.12.07
152,These Days,MacKenzie Porter,6,,,6,0,19300,,,24231,2023.12.07
152,Where The Neon Lies,Triston Marez & Ronnie Dunn,6,,,6,0,19300,,,18470,2023.12.07
152,Come Back To Bed,Sean Stemaly,6,,,6,0,19300,,,192662,2023.12.07
152,Peaked In High School,Priscilla Block,6,,,6,0,19300,,,12738,2023.12.07
156,Star Spangled Banner,Abby Anderson,3,0,3,3,0,19000,-4900,23900,0,2023.12.07
157,Star Spangled Banner,Mickey Guyton,2,-1,3,2,0,18900,9800,9100,0,2023.12.07
158,Daylight Savings,Kidd G,10,3,7,2,0,18800,11300,7500,63271,2023.12.07
159,Wild as You,Cody Johnson,1,,,1,0,18700,,,1413433,2023.12.07
160,"Jesus, My Mama, My Therapist",Tiera Kennedy,32,-2,34,7,0,18500,1300,17200,11575,2023.12.07
161,National Anthem From Battle At Bristol,Jennifer Nettles,4,3,1,4,0,18300,10000,8300,0,2023.12.07
162,Frosty The Snowman,Uncle Kracker,2,,,1,0,18200,,,20849,2023.12.07
163,Long Haul,Ian Munsick,2,1,1,2,0,17600,10400,7200,399028,2023.12.07
164,Messed Around,Huser Brother Band,1,0,1,1,0,17300,16300,1000,1276,2023.12.07
165,Give Me A Sunrise,Braxton Keith,1,0,1,1,0,17300,12400,4900,24698,2023.12.07
165,You In A Honky Tonk,Randall King,1,0,1,1,0,17300,12400,4900,399745,2023.12.07
167,Other Side Of The Radio,Mike Ryan,1,-1,2,1,0,17300,11400,5900,82692,2023.12.07
168,Record High,Randall King,1,-1,2,1,0,17300,9500,7800,26038,2023.12.07
169,Damn This Heart Of Mine,William Beckmann,1,,,1,0,17300,,,6627,2023.12.07
170,Young Man's Blues,Parker Mccollum,1,0,1,1,0,17000,0,17000,433888,2023.12.07
171,Way Back When,Wayland,25,-12,37,12,0,17000,-11700,28700,1882,2023.12.07
172,Out Of Nowhere,Walker Montgomery,4,-5,9,1,0,16700,-10800,27500,6994,2023.12.07
173,Cowgirls,Morgan Wallen,7,-2,9,3,0,16600,-5400,22000,5657084,2023.12.07
174,Have A Good Time,Darius Rucker,4,,,4,0,16500,,,131339,2023.12.07
175,Coal,Dylan Gossett,4,3,1,1,0,16400,15000,1400,4188094,2023.12.07
176,Must Be The Whiskey,Cody Jinks,7,-3,10,1,0,16100,-19900,36000,1428528,2023.12.07
177,Country Music,Tuten Brothers,6,1,5,1,0,15400,8200,7200,1322,2023.12.07
178,bad guy,Billie Eilish,1,,,1,0,15300,,,2830678,2023.12.07
179,Holiday Road,Chris Janson,5,4,1,4,0,15200,13800,1400,314690,2023.12.07
180,Broadway Girls,Lil Durk Feat. Morgan Wallen,3,-2,5,1,0,15200,-17100,32300,3839114,2023.12.07
181,Good Day (2021),Brett Eldredge,2,,,1,0,15200,,,76612,2023.12.07
182,Never Mine,Craig Campbell,6,,,6,0,15000,,,4655,2023.12.07
182,Local Honey,Mo Pitney,6,,,6,0,15000,,,626,2023.12.07
184,I'Ve Seen Me Do It,Joe Peters,3,2,1,1,0,14900,8800,6100,351,2023.12.07
185,"The Father, My Son, And The Holy Ghost",Craig Morgan,2,0,2,2,0,14600,3400,11200,53724,2023.12.07
186,I Need You,Frontmen,2,-2,4,1,0,13700,-6600,20300,2926,2023.12.07
187,Meet Me At The Cross,Brian Free & Assurance,2,,,2,0,13600,,,586,2023.12.07
188,Any Given Friday Night,Luke Combs,2,,,1,0,13400,,,191808,2023.12.07
189,No Yesterday,Jeremy McComb,7,1,6,1,0,13200,2000,11200,340,2023.12.07
190,Saltwater Gospel,Eli Young Band & Jimmy Buffett,6,1,5,2,0,12900,3800,9100,77954,2023.12.07
191,You'Re Gonna Love Me,Tim Dugger,2,,,1,0,12500,,,5538,2023.12.07
192,"Let It Snow, Let It Snow, Let It Snow",Jon Pardi,2,,,2,0,12400,,,251534,2023.12.07
193,Along For The Ride,Jordan Harvey,5,,,5,0,12100,,,15889,2023.12.07
194,Giving You Up,Kameron Marlowe,3,2,1,1,0,12000,10300,1700,835889,2023.12.07
195,But A Beer Can,Eric Burgett,17,0,17,17,0,11900,0,11900,4434,2023.12.07
196,Falalala Falling,Tigirlily Gold,2,-1,3,2,0,11900,-8400,20300,252234,2023.12.07
197,Dirt Cheap,Cody Johnson,1,-2,3,1,0,11600,700,10900,2797744,2023.12.07
198,Mississippi Or Me,Riley Green,1,,,1,0,11600,,,935644,2023.12.07
199,Here Comes Jesus,Jeff & Sheri Easter,2,1,1,2,0,11400,7300,4100,7665,2023.12.07
200,Soundtrack To A Small Town Sundown,Tyler Farr,2,1,1,1,0,11200,8200,3000,7777,2023.12.07
201,Things I Take For Granted,Larry Fleet,1,0,1,1,0,11200,0,11200,937462,2023.12.07
1,World On Fire,Nate Smith,7346,550,6796,142,0,29783500,2557000,27226500,5544488,2023.12.14
2,Save Me,Jelly Roll & Lainey Wilson,6845,-926,7771,141,0,28843500,-3727400,32570900,7868657,2023.12.14
3,Everything I Love,Morgan Wallen,7157,1065,6092,142,0,27884400,3773300,24111100,3594005,2023.12.14
4,Mind On You,George Birge,6520,168,6352,142,0,25711900,1132700,24579200,525305,2023.12.14
5,Thinkin' Bout Me,Morgan Wallen,5358,-482,5840,138,0,25198800,-1439900,26638700,12649477,2023.12.14
6,Save Me The Trouble,Dan + Shay,6312,132,6180,142,0,24585100,663200,23921900,1662466,2023.12.14
7,White Horse,Chris Stapleton,5207,336,4871,142,0,19848100,713200,19134900,8179332,2023.12.14
8,Different 'Round Here,Riley Green,4948,480,4468,142,0,18643700,1063700,17580000,2323694,2023.12.14
9,All I Need Is You,Chris Janson,4550,147,4403,142,0,17203300,911300,16292000,530058,2023.12.14
10,Where The Wild Things Are,Luke Combs,4173,604,3569,142,0,16568000,2316900,14251100,4081482,2023.12.14
11,Pretty Little Poison,Warren Zeiders,4245,305,3940,139,0,15572600,1097600,14475000,7486092,2023.12.14
12,I Can Feel It,Kane Brown,3914,281,3633,142,0,15280900,1234200,14046700,2467228,2023.12.14
13,But I Got A Beer In My Hand,Luke Bryan,3825,-2812,6637,142,0,14912600,-10071700,24984300,1537513,2023.12.14
14,The Painter,Cody Johnson,3579,251,3328,142,0,14182200,668000,13514200,4928273,2023.12.14
15,23,Chayce Beckham,3478,108,3370,141,0,11913700,721900,11191800,3233483,2023.12.14
16,Truck Bed,Hardy,3454,347,3107,141,0,11793000,1356100,10436900,6080377,2023.12.14
17,Creek Will Rise,Conner Smith,3517,79,3438,142,0,11642000,327900,11314100,802536,2023.12.14
18,Burn It Down,Parker Mccollum,3014,440,2574,139,0,10622200,1556200,9066000,4919414,2023.12.14
19,Fearless,Jackson Dean,2416,158,2258,140,0,7672800,670600,7002200,902604,2023.12.14
20,Mamaw's House,Thomas Rhett,1948,153,1795,138,0,6824400,759600,6064800,2109589,2023.12.14
21,Tucson Too Late,Jordan Davis,1968,256,1712,138,0,6612800,806800,5806000,1514394,2023.12.14
22,We Don'T Fight Anymore,Carly Pearce,2083,51,2032,140,0,6220100,-84600,6304700,3661114,2023.12.14
23,Nobody's Nobody,Brothers Osborne,2218,65,2153,136,0,6081700,-121500,6203200,968589,2023.12.14
24,Cab In A Solo,Scotty McCreery,2158,128,2030,141,0,6024700,916500,5108200,675200,2023.12.14
25,Glory Days,Gabby Barrett,2160,24,2136,141,0,5712200,323400,5388800,1256829,2023.12.14
26,Wildflowers And Wild Horses,Lainey Wilson,1660,391,1269,141,0,5345300,1163400,4181900,2142797,2023.12.14
27,I Remember Everything,Zach Bryan Feat. Kacey Musgraves,1590,131,1459,130,0,5188200,412000,4776200,18820133,2023.12.14
28,Man Made A Bar,Morgan Wallen,1336,234,1102,131,0,5031900,585300,4446600,4868409,2023.12.14
29,See You Next Summer,Brian Kelley,1843,91,1752,139,0,4951900,365100,4586800,299267,2023.12.14
30,Out Of That Truck,Carrie Underwood,1641,147,1494,131,0,4581200,414900,4166300,1347150,2023.12.14
31,Back Then Right Now,Tyler Hubbard,1770,72,1698,134,0,4533000,327100,4205900,1125383,2023.12.14
32,Take Her Home,Kenny Chesney,1543,152,1391,140,0,4470900,300900,4170000,702051,2023.12.14
33,I'M Not Pretty,Megan Moroney,1495,-65,1560,134,0,4102500,-45600,4148100,1955848,2023.12.14
34,Love You Again,Chase Matthew,1352,46,1306,125,0,3665500,80100,3585400,1895911,2023.12.14
35,Can't Break Up Now,Old Dominion,1271,222,1049,108,0,3560900,831200,2729700,1370752,2023.12.14
36,Outskirts,Sam Hunt,1294,87,1207,129,0,3551500,318200,3233300,1565659,2023.12.14
37,Drinkin' Problems,Dillon Carmichael,1067,30,1037,114,0,2879700,70600,2809100,65134,2023.12.14
38,Young Love & Saturday Nights,Chris Young,794,46,748,67,0,2826400,-43900,2870300,486579,2023.12.14
39,Let Your Boys Be Country,Jason Aldean,745,257,488,78,0,2701800,1485700,1216100,1399973,2023.12.14
40,Spirits And Demons,Michael Ray With Meghan Patrick,956,6,950,102,0,2363000,-18700,2381700,221671,2023.12.14
41,Where It Ends,Bailey Zimmerman,787,60,727,107,0,2218700,142500,2076200,3786941,2023.12.14
42,We Ride,Bryan Martin,698,4,694,71,0,2193400,100300,2093100,3563419,2023.12.14
43,Something's Gonna Kill Me,Corey Kent,761,21,740,69,0,2051100,47600,2003500,2057963,2023.12.14
44,Cowboys And Plowboys,Jon Pardi Feat. Luke Bryan,733,85,648,96,0,2044500,146700,1897800,638076,2023.12.14
45,Gonna Love You,Parmalee,763,70,693,73,0,1887400,222700,1664700,205664,2023.12.14
46,Rodeo Man,Garth Brooks & Ronnie Dunn,799,-16,815,110,0,1827400,-205300,2032700,1121459,2023.12.14
47,Dance With You,Brett Young,774,12,762,79,0,1662900,178800,1484100,1052195,2023.12.14
48,Pickup Man (Feat. Post Malone),Hixtape & Joe Diffie,331,-23,354,67,0,1316900,-462800,1779700,727152,2023.12.14
49,Brokenhearted,Joe Nichols,532,56,476,71,0,1058300,288500,769800,9366,2023.12.14
50,In Your Love,Tyler Childers,514,20,494,58,0,1016100,12400,1003700,3280693,2023.12.14
51,Love You Back,Lady A,428,137,291,66,0,995900,233800,762100,197112,2023.12.14
52,This Is My Dirt,Justin Moore,542,36,506,80,0,904600,-700,905300,336633,2023.12.14
53,Find Another Bar,Chris Lane,503,1,502,77,0,818600,-122300,940900,196482,2023.12.14
54,Wine Country,Hannah Ellis,487,-118,605,70,0,803100,-52200,855300,41142,2023.12.14
55,I'm In Love,Hailey Whitters,358,-16,374,57,0,714100,-102700,816800,673151,2023.12.14
56,Long Live Cowgirls,Ian Munsick & Cody Johnson,271,-15,286,37,0,703800,5400,698400,838219,2023.12.14
57,She's Somebody's Daughter,Drew Baldridge,404,52,352,56,0,685200,111700,573500,407818,2023.12.14
58,Ain'T About You,Huntergirl,438,40,398,68,0,555200,11400,543800,16205,2023.12.14
59,Make Me Wanna Smoke,Runaway June,292,11,281,35,0,553500,-143600,697100,11059,2023.12.14
60,Chevrolet,Dustin Lynch,229,126,103,46,0,518100,268800,249300,0,2023.12.14
61,King Of Country Music,Ryan Larkins,265,9,256,44,0,494500,-58000,552500,48419,2023.12.14
62,Cancelled,Randy Houser,297,-12,309,42,0,465000,-46200,511200,0,2023.12.14
62,Cancel,Randy Houser,297,-12,309,42,0,465000,-46200,511200,61242,2023.12.14
64,This Side Of The Dirt,Neon Union,260,-3,263,36,0,446800,-3300,450100,19242,2023.12.14
65,Black Corvette,Kimberly Perry,103,55,48,57,0,403200,297800,105400,2355,2023.12.14
66,Thicc As Thieves,Lauren Alaina,249,-26,275,45,0,387600,-100600,488200,652807,2023.12.14
67,Your Place,Ashley Cooke,132,92,40,38,0,380700,292400,88300,660599,2023.12.14
68,Without You,Thompson Square,42,-10,52,7,0,291400,-41300,332700,6371,2023.12.14
69,All I Want For Christmas Is You,Jon Pardi,46,16,30,12,0,277000,84900,192100,34951,2023.12.14
70,Trouble,Josh Ross,203,-45,248,39,0,255200,-149200,404400,1850256,2023.12.14
71,Heart They Didn'T Break,Maddie & Tae,204,-8,212,32,0,241300,52300,189000,808437,2023.12.14
72,Ain't Missin' You,Dylan Schneider,197,-8,205,25,0,232600,25100,207500,845603,2023.12.14
73,How Is She,Cole Swindell,29,1,28,1,0,208200,32500,175700,53103,2023.12.14
74,Rain In The Rearview,Anne Wilson,191,18,173,35,0,202900,-12900,215800,271851,2023.12.14
75,Breakin' In Boots,Matt Stell,152,72,80,31,0,174200,26900,147300,430365,2023.12.14
76,Amy's Back In Austin,Eli Young Band & George Birge,37,1,36,37,0,169500,4500,165000,589171,2023.12.14
77,The Christmas Song,Maddie & Tae,26,25,1,24,0,151300,143600,7700,223975,2023.12.14
78,Million Little Bandaids,Caroline Jones,136,24,112,22,0,138300,58300,80000,44519,2023.12.14
79,It's Beginning To Look A Lot Like Christmas,Maddie & Tae,22,13,9,15,0,134300,76300,58000,567416,2023.12.14
80,Nothing Compares To You,Mickey Guyton Feat. Kane Brown,68,-20,88,13,0,131500,-40000,171500,441245,2023.12.14
81,Boys Back Home,Dylan Marlowe Feat. Dylan Scott,115,75,40,27,0,128200,75700,52500,1782044,2023.12.14
82,Beer For Santa,Jon Pardi,20,4,16,11,0,122100,33500,88600,281563,2023.12.14
83,Buy A Bar,Tim Dugger,8,-16,24,1,0,116700,-50200,166900,11209,2023.12.14
84,Sarah's Place,Zach Bryan,15,-1,16,1,0,116100,-9200,125300,3710575,2023.12.14
85,Jealous Of Jane,Lauren Watkins,48,48,0,48,0,105400,105400,0,8901,2023.12.14
85,Genie In A Bottle,Kassi Ashton,48,48,0,48,0,105400,105400,0,12963,2023.12.14
87,Santa Looked A Lot Like Daddy,Jon Pardi,18,7,11,5,0,103300,25700,77600,323446,2023.12.14
88,I Need You,Frontmen,14,12,2,12,0,90100,76400,13700,2679,2023.12.14
89,Colorado,Florida Georgia Line,17,1,16,2,0,87600,-500,88100,41486,2023.12.14
90,Coal,Dylan Gossett,18,14,4,1,0,77900,61500,16400,4055942,2023.12.14
91,Feel Like The Holidays,Scotty McCreery,17,-1,18,10,0,77200,-6000,83200,424368,2023.12.14
92,There's The Sun,Zach Top,16,16,0,15,0,75800,75800,0,99795,2023.12.14
93,Blue Christmas,Elvis Presley & Kane Brown,17,7,10,9,0,73700,34800,38900,662555,2023.12.14
94,Sunday Saints,Jordan Davis,14,-1,15,1,0,72900,-2700,75600,31841,2023.12.14
95,Ain'T Got A Worry,Old Dominion,12,0,12,1,0,72500,6200,66300,182035,2023.12.14
96,Feliz Navidad,Frank Ray,22,13,9,7,0,71800,28200,43600,81325,2023.12.14
97,Santa Baby,Trisha Yearwood,16,4,12,5,0,70000,38200,31800,7947,2023.12.14
98,With You I Am,Cody Johnson,8,4,4,4,0,68400,24600,43800,1395672,2023.12.14
99,What Christmas Means To Me,Old Dominion,9,2,7,1,0,68100,17300,50800,0,2023.12.14
100,Neon Baby,Annie Bosko,102,6,96,19,0,64300,-3300,67600,23252,2023.12.14
101,Fake Names,Priscilla Block,22,6,16,1,0,60300,6600,53700,77478,2023.12.14
102,Tulsa,Elle King,15,2,13,2,0,59600,14100,45500,41391,2023.12.14
103,Must Be The Whiskey,Cody Jinks,11,4,7,2,0,56700,40600,16100,1424828,2023.12.14
104,Amazed,Frontmen,10,10,0,9,0,55600,55600,0,0,2023.12.14
105,I'Ll Still Be Loving You (The,Frontmen,9,9,0,9,0,53700,53700,0,1537,2023.12.14
106,Cowgirls,Morgan Wallen,18,11,7,5,0,53200,36600,16600,5384602,2023.12.14
107,My Bar,Priscilla Block,5,-6,11,1,0,44800,-37300,82100,131639,2023.12.14
108,No Present LIke The Time,Jay Allen,68,-4,72,12,0,43800,-28500,72300,0,2023.12.14
109,Please Come Home For Christmas,Jon Pardi,13,12,1,5,0,42800,34100,8700,172196,2023.12.14
110,The Star-Spangled Banner,Chris Stapleton,12,3,9,11,0,41900,-2300,44200,83049,2023.12.14
111,I'll Be Here,Colbie Caillat,22,0,22,1,0,41900,0,41900,355944,2023.12.14
112,Devil Don't Know,Morgan Wallen,13,13,0,13,0,40900,40900,0,849433,2023.12.14
113,Love Can Build A Bridge,"Jelly Roll, K. Michelle & The Fisk Jubilee Singers",13,13,0,13,0,39900,39900,0,45631,2023.12.14
114,Holy Water,Michael Ray,7,4,3,2,0,39700,15300,24400,229165,2023.12.14
115,Star Spangled Banner,Abby Anderson,7,4,3,6,0,38100,19100,19000,0,2023.12.14
116,Blue Christmas,Lane Johnson & Jason Kelce,2,1,1,1,0,37300,15600,21700,130535,2023.12.14
117,Holiday Road,Chris Janson,9,4,5,6,0,37000,21800,15200,400259,2023.12.14
118,Silverado,Caleb Lee Hutchinson,51,17,34,17,0,35700,11900,23800,14269,2023.12.14
119,Goodbye Looks Good On You,Alana Springsteen Feat. Mitchell Tenpenny,15,14,1,1,0,35600,30600,5000,1486584,2023.12.14
120,Frosty The Snowman,Uncle Kracker,4,2,2,1,0,34500,16300,18200,26114,2023.12.14
121,Outlaws And Mustangs,Cody Jinks,13,4,9,2,0,34300,24200,10100,232947,2023.12.14
122,Dancing Away With My Heart,Dillon Carmichael,2,0,2,1,0,32100,700,31400,29230,2023.12.14
123,Record High,Randall King,5,4,1,4,0,31700,14400,17300,26323,2023.12.14
124,Falalala Falling,Tigirlily Gold,6,4,2,2,0,31700,19800,11900,310121,2023.12.14
125,The Star-Spangled Banner,Carly Pearce,2,-4,6,2,0,29000,-33300,62300,0,2023.12.14
126,Long Haul,Ian Munsick,3,1,2,1,0,28400,10800,17600,385595,2023.12.14
127,Heart Attack,Boy Named Banjo,19,0,19,1,0,27100,-9700,36800,3971,2023.12.14
128,Wild Ones,Jessie Murph & Jelly Roll,15,1,14,1,0,26600,-19100,45700,10050407,2023.12.14
129,Ok Cowboy,Catie Offerman,8,-5,13,4,0,25600,-10300,35900,28706,2023.12.14
130,Back At The Bar,Landon Parker,34,34,0,17,0,23800,23800,0,662,2023.12.14
131,Make You Mine,Marynn Taylor,34,28,6,17,0,23800,4500,19300,31286,2023.12.14
132,But A Beer Can,Eric Burgett,34,17,17,17,0,23800,11900,11900,4169,2023.12.14
133,Black Magic,Rachel Lipsky,34,1,33,17,0,23800,800,23000,398,2023.12.14
134,Tea Was A Little Sweeter,Matt Rogers,34,0,34,17,0,23800,0,23800,1136,2023.12.14
134,Summer Soundtrack,Craig Campbell,34,0,34,17,0,23800,0,23800,809,2023.12.14
134,Under A Southern Sky,Ian Flanigan,34,0,34,17,0,23800,0,23800,3886,2023.12.14
137,She's Gotta Know,Conner Sweet,34,-17,51,17,0,23800,-11900,35700,448,2023.12.14
138,Give Me A Sunrise,Braxton Keith,3,2,1,1,0,23200,5900,17300,24010,2023.12.14
139,Star On Top Of The Tree,Grace Leer,33,33,0,17,0,22200,22200,0,1478,2023.12.14
140,Laying Low In Mexico,Frontmen,10,10,0,9,0,21500,21500,0,0,2023.12.14
141,If I Had A Bar,Jon Wolfe,2,1,1,2,0,19700,17300,2400,10525,2023.12.14
142,Wild as You,Cody Johnson,2,1,1,2,0,19700,1000,18700,1367121,2023.12.14
143,Left Their Mark,Frontmen,9,-48,57,9,0,19700,-281900,301600,642,2023.12.14
144,400 Horsepower Sleigh,Jon Pardi,3,-4,7,2,0,19600,-12700,32300,353722,2023.12.14
145,Every Single Summer,Marynn Taylor,6,6,0,6,0,19300,19300,0,1624,2023.12.14
145,Southern And Slow,Luke Bryan,6,6,0,6,0,19300,19300,0,105558,2023.12.14
145,Most Nights,Kat & Alex,6,6,0,6,0,19300,19300,0,1933,2023.12.14
145,Polaroid,Keith Urban,6,6,0,6,0,19300,19300,0,9483,2023.12.14
145,Don't Go Changing,Kip Moore,6,6,0,6,0,19300,19300,0,12068,2023.12.14
150,Just Drive,Erin Kinsey,6,0,6,6,0,19300,0,19300,79722,2023.12.14
151,National Anthem From Battle At Bristol,Jennifer Nettles,3,-1,4,3,0,19300,1000,18300,0,2023.12.14
152,When Will I Be Loved,"Ashley McBryde, Caylee Hammack & Pillbox Patti",6,-6,12,6,0,19300,-19300,38600,27182,2023.12.14
153,Cover Me Up,Morgan Wallen,5,2,3,4,0,18900,10100,8800,3734412,2023.12.14
154,Oklahoma Smokeshow,Zach Bryan,13,-3,16,1,0,18700,-8000,26700,5732312,2023.12.14
155,That's Why We Fight,Ella Langley & Koe Wetzel,10,3,7,1,0,18600,13500,5100,529429,2023.12.14
156,I'Ll Be Home For Christmas,Rodney Atkins,4,2,2,2,0,18600,9800,8800,1027,2023.12.14
157,West Of Tulsa,Wyatt Flores,10,2,8,2,0,18200,-17900,36100,259026,2023.12.14
158,Baby Do,Randall King,1,1,0,1,0,17300,17300,0,21423,2023.12.14
158,We Ain't The Only Ones,Randy Rogers & Wade Bowen,1,1,0,1,0,17300,17300,0,0,2023.12.14
160,Messed Around,Huser Brother Band,1,0,1,1,0,17300,0,17300,1495,2023.12.14
161,Without Jesus,Brian Free & Assurance,2,2,0,1,0,16800,16800,0,313,2023.12.14
161,Can I Get A Witness,Sound,2,2,0,1,0,16800,16800,0,1840,2023.12.14
163,Heartless,Diplo & Julia Michaels Feat. Morgan Wallen,4,2,2,3,0,16700,12800,3900,4700780,2023.12.14
164,Broadway Girls,Lil Durk Feat. Morgan Wallen,3,0,3,1,0,16600,1400,15200,3809188,2023.12.14
165,Heart Of A Small Town,Tim Dugger,2,-2,4,1,0,16500,-3300,19800,8718,2023.12.14
166,Way Back When,Wayland,24,-1,25,12,0,16400,-600,17000,1352,2023.12.14
167,No Yesterday,Jeremy McComb,8,1,7,1,0,16000,2800,13200,263,2023.12.14
168,"Jesus, My Mama, My Therapist",Tiera Kennedy,22,-10,32,6,0,15600,-2900,18500,10882,2023.12.14
169,Star Spangled Banner,Mickey Guyton,2,0,2,2,0,15400,-3500,18900,0,2023.12.14
170,Wild,Carter Faith,13,4,9,1,0,14800,4100,10700,222510,2023.12.14
171,Country A$$ Shit,Morgan Wallen,2,1,1,1,0,14800,13000,1800,458489,2023.12.14
172,"Mary, Did You Know",Restless Road,2,2,0,1,0,14600,14600,0,159763,2023.12.14
172,When My Tears Wash the Scars,Dunaways,2,2,0,1,0,14600,14600,0,201,2023.12.14
174,That Ain'T Country,Aaron Lewis,8,3,5,1,0,14400,4900,9500,105822,2023.12.14
175,'98 Braves,Morgan Wallen,4,2,2,3,0,14200,7600,6600,2103229,2023.12.14
176,Money Isn'T Real,Jordan Davis,3,2,1,1,0,13800,9200,4600,201308,2023.12.14
177,Loud and Heavy,Cody Jinks,7,2,5,1,0,13700,5600,8100,1561795,2023.12.14
178,Star Spangled Banner,Marlana Vanhoose,2,1,1,2,0,13200,6500,6700,0,2023.12.14
179,I'M Not For Everyone,Brothers Osborne,4,2,2,1,0,13100,7100,6000,391936,2023.12.14
180,Dirt Cheap,Cody Johnson,2,1,1,2,0,12400,800,11600,2632017,2023.12.14
181,Two Woman Man,Randall Fowler,17,17,0,17,0,11900,11900,0,257,2023.12.14
182,Hurry Up Christmas,Huntergirl,3,3,0,2,0,11900,11900,0,268338,2023.12.14
183,Hoops,Alison Nichols,17,-16,33,17,0,11900,-15000,26900,4067,2023.12.14
184,Downtime,Roman Alexander,17,-17,34,17,0,11900,-11900,23800,15926,2023.12.14
184,Bad Man,Twinnie,17,-17,34,17,0,11900,-11900,23800,875,2023.12.14
186,Good Day (2021),Brett Eldredge,1,-1,2,1,0,11600,-3600,15200,74923,2023.12.14
187,The Great Divide,Luke Combs & Billy Strings,7,4,3,1,0,11400,2300,9100,191173,2023.12.14
188,Better Off,Trace Adkins,2,-1,3,1,0,11200,1100,10100,12862,2023.12.14
189,Giving You Up,Kameron Marlowe,2,-1,3,1,0,11200,-800,12000,823098,2023.12.14
190,What Else Is New,Cody Jinks,3,1,2,1,0,11000,10100,900,77559,2023.12.14
191,Cowboy Forever,Carter Faith,11,2,9,1,0,10900,200,10700,30766,2023.12.14
192,Cigarettes,Laci Kaye Booth,1,1,0,1,0,10900,10900,0,89964,2023.12.14
193,God Only Knows,for King & Country,2,0,2,1,0,10900,0,10900,959184,2023.12.14
194,Merry Christmas From The Keys,Jon Pardi,1,-1,2,1,0,10800,4600,6200,33698,2023.12.14
195,Heart To Break,Ryan Griffin,18,5,13,1,0,10500,8400,2100,109142,2023.12.14
196,On The Boat Again,Jake Owen,6,1,5,1,0,10300,2300,8000,73484,2023.12.14
197,Biggest Fan,Adam Doleac,1,1,0,1,0,10000,10000,0,26271,2023.12.14
198,Life With You,Kelsey Hart,13,11,2,4,0,9700,-400,10100,988336,2023.12.14
199,Reindeer,Jon Pardi,4,3,1,2,0,9700,9200,500,26867,2023.12.14
200,3 Feet Tall,Cole Swindell,2,-2,4,2,0,9600,-15300,24900,1210514,2023.12.14
1,World On Fire,Nate Smith,7937,591,7346,142,0,33580800,3797300,29783500,5802793,2023.12.21
2,Save Me,Jelly Roll & Lainey Wilson,6946,101,6845,141,0,30211600,1368100,28843500,6602238,2023.12.21
3,Mind On You,George Birge,7213,693,6520,142,0,29428700,3716800,25711900,1121122,2023.12.21
4,Save Me The Trouble,Dan + Shay,6794,482,6312,142,0,26737700,2152600,24585100,3156306,2023.12.21
5,Thinkin' Bout Me,Morgan Wallen,5557,199,5358,138,0,25239600,40800,25198800,12588545,2023.12.21
6,White Horse,Chris Stapleton,5640,433,5207,142,0,22357000,2508900,19848100,8295719,2023.12.21
7,Everything I Love,Morgan Wallen,5234,-1923,7157,142,0,21692800,-6191600,27884400,3363982,2023.12.21
8,Different 'Round Here,Riley Green,5116,168,4948,142,0,19478500,834800,18643700,2500935,2023.12.21
9,All I Need Is You,Chris Janson,4891,341,4550,142,0,18540300,1337000,17203300,511548,2023.12.21
10,Where The Wild Things Are,Luke Combs,4605,432,4173,142,0,18506600,1938600,16568000,4441881,2023.12.21
11,Pretty Little Poison,Warren Zeiders,4546,301,4245,139,0,17412900,1840300,15572600,7563879,2023.12.21
12,I Can Feel It,Kane Brown,4233,319,3914,142,0,16663800,1382900,15280900,2450302,2023.12.21
13,The Painter,Cody Johnson,3930,351,3579,142,0,16321500,2139300,14182200,4585075,2023.12.21
14,Truck Bed,Hardy,3959,505,3454,141,0,14073500,2280500,11793000,6194087,2023.12.21
15,23,Chayce Beckham,3542,64,3478,141,0,12626400,712700,11913700,3576394,2023.12.21
16,Creek Will Rise,Conner Smith,3592,75,3517,142,0,12199400,557400,11642000,812010,2023.12.21
17,Burn It Down,Parker Mccollum,3259,245,3014,139,0,12021800,1399600,10622200,4703603,2023.12.21
18,Fearless,Jackson Dean,2474,58,2416,140,0,8170500,497700,7672800,1047552,2023.12.21
19,Mamaw's House,Thomas Rhett,2195,247,1948,137,0,7959100,1134700,6824400,2100868,2023.12.21
20,Tucson Too Late,Jordan Davis,2133,165,1968,138,0,7088300,475500,6612800,1246244,2023.12.21
21,We Don'T Fight Anymore,Carly Pearce,2174,91,2083,139,0,6993700,773600,6220100,3456415,2023.12.21
22,Wildflowers And Wild Horses,Lainey Wilson,1958,298,1660,139,0,6635000,1289700,5345300,1964241,2023.12.21
23,Cab In A Solo,Scotty McCreery,2350,192,2158,141,0,6610900,586200,6024700,643623,2023.12.21
24,Man Made A Bar,Morgan Wallen,1636,300,1336,137,0,6258800,1226900,5031900,4606734,2023.12.21
25,Glory Days,Gabby Barrett,2381,221,2160,141,0,6198600,486400,5712200,1111685,2023.12.21
26,Nobody's Nobody,Brothers Osborne,2267,49,2218,137,0,6117600,35900,6081700,938000,2023.12.21
27,Take Her Home,Kenny Chesney,1609,66,1543,139,0,5100700,629800,4470900,624524,2023.12.21
28,I Remember Everything,Zach Bryan Feat. Kacey Musgraves,1568,-22,1590,132,0,5032000,-156200,5188200,18630110,2023.12.21
29,Back Then Right Now,Tyler Hubbard,1882,112,1770,134,0,4985800,452800,4533000,1129783,2023.12.21
30,Out Of That Truck,Carrie Underwood,1651,10,1641,130,0,4729200,148000,4581200,1439195,2023.12.21
31,See You Next Summer,Brian Kelley,1596,-247,1843,137,0,4385600,-566300,4951900,269852,2023.12.21
32,I'M Not Pretty,Megan Moroney,1576,81,1495,136,0,4331200,228700,4102500,2306796,2023.12.21
33,Can't Break Up Now,Old Dominion,1298,27,1271,110,0,3924500,363600,3560900,1386630,2023.12.21
34,Love You Again,Chase Matthew,1459,107,1352,125,0,3903300,237800,3665500,1742504,2023.12.21
35,Outskirts,Sam Hunt,1344,50,1294,129,0,3653200,101700,3551500,1444711,2023.12.21
36,Let Your Boys Be Country,Jason Aldean,922,177,745,82,0,3610700,908900,2701800,1487537,2023.12.21
37,Young Love & Saturday Nights,Chris Young,808,14,794,66,0,2878400,52000,2826400,480363,2023.12.21
38,Drinkin' Problems,Dillon Carmichael,1059,-8,1067,114,0,2859900,-19800,2879700,60695,2023.12.21
39,Your Place,Ashley Cooke,769,637,132,71,0,2856400,2475700,380700,822414,2023.12.21
40,Where It Ends,Bailey Zimmerman,914,127,787,114,0,2626900,408200,2218700,3572999,2023.12.21
41,We Ride,Bryan Martin,741,43,698,69,0,2333300,139900,2193400,3622269,2023.12.21
42,Spirits And Demons,Michael Ray With Meghan Patrick,988,32,956,103,0,2287400,-75600,2363000,196228,2023.12.21
43,Cowboys And Plowboys,Jon Pardi Feat. Luke Bryan,811,78,733,99,0,2253900,209400,2044500,614791,2023.12.21
44,Something's Gonna Kill Me,Corey Kent,792,31,761,71,0,2224100,173000,2051100,1982922,2023.12.21
45,Gonna Love You,Parmalee,795,32,763,74,0,1999900,112500,1887400,210899,2023.12.21
46,Rodeo Man,Garth Brooks & Ronnie Dunn,831,32,799,117,0,1985000,157600,1827400,945001,2023.12.21
47,Dance With You,Brett Young,762,-12,774,80,0,1608100,-54800,1662900,947703,2023.12.21
48,Pickup Man (Feat. Post Malone),Hixtape & Joe Diffie,375,44,331,80,0,1509000,192100,1316900,675409,2023.12.21
49,Love You Back,Lady A,529,101,428,78,0,1088200,92300,995900,185299,2023.12.21
50,This Is My Dirt,Justin Moore,558,16,542,78,0,1064300,159700,904600,312109,2023.12.21
51,I'm In Love,Hailey Whitters,490,132,358,81,0,1030300,316200,714100,519404,2023.12.21
52,In Your Love,Tyler Childers,498,-16,514,56,0,938400,-77700,1016100,3327620,2023.12.21
53,Brokenhearted,Joe Nichols,480,-52,532,61,0,862900,-195400,1058300,8806,2023.12.21
54,She's Somebody's Daughter,Drew Baldridge,426,22,404,56,0,851000,165800,685200,392746,2023.12.21
55,Find Another Bar,Chris Lane,466,-37,503,59,0,831400,12800,818600,185003,2023.12.21
56,Chevrolet,Dustin Lynch,384,155,229,52,0,824900,306800,518100,0,2023.12.21
57,Long Live Cowgirls,Ian Munsick & Cody Johnson,254,-17,271,35,0,760500,56700,703800,860007,2023.12.21
58,All I Want For Christmas Is You,Jon Pardi,100,54,46,43,0,640400,363400,277000,45333,2023.12.21
59,Ain'T About You,Huntergirl,435,-3,438,68,0,623900,68700,555200,15948,2023.12.21
60,Wine Country,Hannah Ellis,349,-138,487,46,0,501000,-302100,803100,35303,2023.12.21
61,Make Me Wanna Smoke,Runaway June,284,-8,292,44,0,494900,-58600,553500,11824,2023.12.21
62,Cancel,Randy Houser,308,11,297,41,0,489000,24000,465000,59142,2023.12.21
62,Cancelled,Randy Houser,308,11,297,41,0,489000,24000,465000,0,2023.12.21
64,This Side Of The Dirt,Neon Union,251,-9,260,36,0,425300,-21500,446800,17225,2023.12.21
65,King Of Country Music,Ryan Larkins,246,-19,265,41,0,420600,-73900,494500,24725,2023.12.21
66,Thicc As Thieves,Lauren Alaina,265,16,249,41,0,402600,15000,387600,716617,2023.12.21
67,Beer For Santa,Jon Pardi,58,38,20,32,0,317900,195800,122100,364767,2023.12.21
68,Trouble,Josh Ross,185,-18,203,30,0,290500,35300,255200,1695077,2023.12.21
69,Rain In The Rearview,Anne Wilson,216,25,191,45,0,279200,76300,202900,247326,2023.12.21
70,Boys Back Home,Dylan Marlowe Feat. Dylan Scott,142,27,115,31,0,259500,131300,128200,2403031,2023.12.21
71,Breakin' In Boots,Matt Stell,240,88,152,35,0,258200,84000,174200,446365,2023.12.21
72,Shut Up and Dance,Walk The Moon,48,48,0,27,0,228000,228000,0,2167432,2023.12.21
73,Feel Like The Holidays,Scotty McCreery,33,16,17,16,0,214800,137600,77200,512312,2023.12.21
74,Ain't Missin' You,Dylan Schneider,184,-13,197,24,0,210800,-21800,232600,858762,2023.12.21
75,How Is She,Cole Swindell,33,4,29,2,0,209100,900,208200,51454,2023.12.21
76,Heart They Didn'T Break,Maddie & Tae,196,-8,204,28,0,207000,-34300,241300,741893,2023.12.21
77,That's Texas,Cody Johnson,18,17,1,1,0,194000,193000,1000,422006,2023.12.21
78,Santa Looked A Lot Like Daddy,Jon Pardi,29,11,18,10,0,173100,69800,103300,382803,2023.12.21
79,Girl In The Mirror,Megan Moroney,37,37,0,37,0,169500,169500,0,463476,2023.12.21
80,Without You,Thompson Square,24,-18,42,4,0,156200,-135200,291400,5397,2023.12.21
81,Feliz Navidad,Frank Ray,32,10,22,11,0,148200,76400,71800,100784,2023.12.21
82,Million Little Bandaids,Caroline Jones,141,5,136,21,0,133000,-5300,138300,50423,2023.12.21
83,Sunday Saints,Jordan Davis,19,5,14,1,0,108900,36000,72900,32966,2023.12.21
84,Sarah's Place,Zach Bryan,15,0,15,1,0,105900,-10200,116100,3639384,2023.12.21
85,Room,Gray Robinson,48,48,0,48,0,105400,105400,0,748,2023.12.21
85,Alarm Clock,Sheryl Crow,48,48,0,48,0,105400,105400,0,5977,2023.12.21
87,Cigarettes,Laci Kaye Booth,48,47,1,48,0,105400,94500,10900,62301,2023.12.21
88,I Need You,Frontmen,18,4,14,6,0,99700,9600,90100,2943,2023.12.21
89,Blue Christmas,Elvis Presley & Kane Brown,22,5,17,6,0,99500,25800,73700,1602300,2023.12.21
90,Run Outta Mistletoe,High Valley,137,137,0,50,0,96400,96400,0,493931,2023.12.21
91,Santa Baby,Trisha Yearwood,20,4,16,5,0,95900,25900,70000,9548,2023.12.21
92,Nothing Compares To You,Mickey Guyton Feat. Kane Brown,45,-23,68,10,0,86300,-45200,131500,438619,2023.12.21
93,It's Beginning To Look A Lot Like Christmas,Maddie & Tae,9,-13,22,2,0,81700,-52600,134300,604824,2023.12.21
94,Colorado,Florida Georgia Line,13,-4,17,2,0,78400,-9200,87600,40817,2023.12.21
95,Please Come Home For Christmas,Jon Pardi,15,2,13,8,0,77200,34400,42800,542042,2023.12.21
96,Ok Cowboy,Catie Offerman,15,7,8,2,0,75600,50000,25600,27006,2023.12.21
97,The Star-Spangled Banner,Chris Stapleton,13,1,12,12,0,75500,33600,41900,77363,2023.12.21
98,Fake Names,Priscilla Block,22,0,22,1,0,68100,7800,60300,74766,2023.12.21
99,Blue Christmas,Lane Johnson & Jason Kelce,4,2,2,1,0,67800,30500,37300,125561,2023.12.21
100,Neon Baby,Annie Bosko,96,-6,102,19,0,66000,1700,64300,21954,2023.12.21
101,Cowboy For Christmas,Runaway June,96,96,0,49,0,63800,63800,0,11943,2023.12.21
102,With You I Am,Cody Johnson,7,-1,8,2,0,63400,-5000,68400,1453807,2023.12.21
103,Mistletoe,Chase Matthew,18,17,1,11,0,60900,57500,3400,755070,2023.12.21
104,Holy Water,Michael Ray,8,1,7,2,0,60900,21200,39700,218581,2023.12.21
105,I'Ll Still Be Loving You (The,Frontmen,9,0,9,8,0,60800,7100,53700,975,2023.12.21
106,What Christmas Means To Me,Old Dominion,10,1,9,1,0,58300,-9800,68100,1,2023.12.21
107,Ain'T Got A Worry,Old Dominion,11,-1,12,1,0,55800,-16700,72500,168142,2023.12.21
108,My Favorite Things,Kelsea Ballerini & Joey Alexander,8,8,0,5,0,54900,54900,0,36309,2023.12.21
109,Cowgirls,Morgan Wallen,16,-2,18,5,0,54100,900,53200,5135706,2023.12.21
110,Coal,Dylan Gossett,17,-1,18,1,0,50800,-27100,77900,4117862,2023.12.21
111,Wondering Why,Red Clay Strays,4,3,1,2,0,49200,43800,5400,5754894,2023.12.21
112,It's Beginning To Look A Lot Like Christmas,Lindsay Ell,3,3,0,1,0,45000,45000,0,148885,2023.12.21
113,"Let It Snow, Let It Snow, Let It Snow",Jon Pardi,4,3,1,2,0,44900,44400,500,306082,2023.12.21
114,Tulsa,Elle King,13,-2,15,1,0,44700,-14900,59600,39750,2023.12.21
115,Hurry Up Christmas,Huntergirl,35,32,3,19,0,43100,31200,11900,338494,2023.12.21
116,Merry Christmas From The Keys,Jon Pardi,12,11,1,2,0,42000,31200,10800,46589,2023.12.21
117,Holiday Road,Chris Janson,15,6,9,10,0,42000,5000,37000,504472,2023.12.21
118,Hungover You,Emily Brooke,12,12,0,6,0,38600,38600,0,656,2023.12.21
119,No Present LIke The Time,Jay Allen,68,0,68,11,0,37600,-6200,43800,0,2023.12.21
120,Christmas Again,Huntergirl,16,16,0,12,0,37500,37500,0,336822,2023.12.21
121,One Bad Habit,Tim McGraw,7,6,1,6,0,36100,28900,7200,40584,2023.12.21
122,She's Gotta Know,Conner Sweet,51,17,34,17,0,35700,11900,23800,859,2023.12.21
123,Dirt Cheap,Cody Johnson,8,6,2,2,0,34600,22200,12400,2581359,2023.12.21
124,Give Me A Sunrise,Braxton Keith,6,3,3,1,0,34000,10800,23200,24606,2023.12.21
125,Wild Ones,Jessie Murph & Jelly Roll,13,-2,15,1,0,33000,6400,26600,10090530,2023.12.21
126,Star Spangled Banner,Maren Morris,2,2,0,2,0,32900,32900,0,0,2023.12.21
127,Blue Christmas,Elvie Shane,6,1,5,1,0,30600,23900,6700,2157,2023.12.21
128,My Bar,Priscilla Block,4,-1,5,1,0,29300,-15500,44800,145166,2023.12.21
129,I'Ll Be Home For Christmas,Rodney Atkins,6,2,4,2,0,27600,9000,18600,1047,2023.12.21
130,Heart Attack,Boy Named Banjo,19,0,19,1,0,26400,-700,27100,3769,2023.12.21
131,Make You Mine,Marynn Taylor,22,-12,34,22,0,25600,1800,23800,30006,2023.12.21
132,Goodbye Looks Good On You,Alana Springsteen Feat. Mitchell Tenpenny,14,-1,15,1,0,24400,-11200,35600,1231664,2023.12.21
133,The Star-Spangled Banner,Carly Pearce,3,1,2,3,0,24200,-4800,29000,0,2023.12.21
134,Halfway To Hell,Jelly Roll,9,7,2,3,0,24000,22800,1200,1282863,2023.12.21
135,Two Woman Man,Randall Fowler,34,17,17,17,0,23800,11900,11900,278,2023.12.21
135,Hoops,Alison Nichols,34,17,17,17,0,23800,11900,11900,5898,2023.12.21
135,Downtime,Roman Alexander,34,17,17,17,0,23800,11900,11900,15318,2023.12.21
138,Back At The Bar,Landon Parker,34,0,34,17,0,23800,0,23800,715,2023.12.21
138,Black Magic,Rachel Lipsky,34,0,34,17,0,23800,0,23800,206,2023.12.21
138,Summer Soundtrack,Craig Campbell,34,0,34,17,0,23800,0,23800,837,2023.12.21
138,Tea Was A Little Sweeter,Matt Rogers,34,0,34,17,0,23800,0,23800,927,2023.12.21
138,But A Beer Can,Eric Burgett,34,0,34,17,0,23800,0,23800,4373,2023.12.21
143,Silverado,Caleb Lee Hutchinson,34,-17,51,17,0,23800,-11900,35700,13643,2023.12.21
144,I'Ve Seen Me Do It,Joe Peters,3,2,1,1,0,23600,15200,8400,315,2023.12.21
145,Porch Swing Angel,Muscadine Bloodline,2,2,0,1,0,22200,22200,0,1078662,2023.12.21
145,Open The Gate,Zach Bryan,2,2,0,1,0,22200,22200,0,968086,2023.12.21
147,Stretchy Pants,Carrie Underwood,5,3,2,3,0,21900,14700,7200,144646,2023.12.21
148,That Ain'T Country,Aaron Lewis,8,0,8,1,0,21500,7100,14400,105603,2023.12.21
149,Falalala Falling,Tigirlily Gold,5,-1,6,3,0,21500,-10200,31700,399845,2023.12.21
150,Bad Man,Twinnie,32,15,17,17,0,20400,8500,11900,813,2023.12.21
151,West Texas Wind,NEEDTOBREATHE,9,9,0,8,0,20000,20000,0,29504,2023.12.21
152,Frosty The Snowman,Uncle Kracker,4,0,4,1,0,20000,-14500,34500,13778,2023.12.21
153,Outlaws And Mustangs,Cody Jinks,9,-4,13,2,0,19900,-14400,34300,230548,2023.12.21
154,We Ain't The Only Ones,Randy Rogers & Wade Bowen,2,1,1,2,0,19700,2400,17300,0,2023.12.21
155,If I Had A Bar,Jon Wolfe,2,0,2,2,0,19700,0,19700,10940,2023.12.21
156,Star Spangled Banner,Abby Anderson,4,-3,7,3,0,19600,-18500,38100,0,2023.12.21
157,Take It Slow,Conner Smith,6,6,0,6,0,19300,19300,0,332408,2023.12.21
157,Not Yet,Brett Young,6,6,0,6,0,19300,19300,0,60514,2023.12.21
157,Bits & Pieces,Walker County,6,6,0,6,0,19300,19300,0,1889,2023.12.21
157,wAnt me back,Lindsay Ell,6,6,0,6,0,19300,19300,0,30362,2023.12.21
161,I'll Be Here,Colbie Caillat,17,-5,22,1,0,18900,-23000,41900,318334,2023.12.21
162,Sun To Me,Zach Bryan,15,8,7,3,0,18700,10800,7900,4214930,2023.12.21
163,The Christmas Song,Maddie & Tae,3,-23,26,2,0,18700,-132600,151300,315311,2023.12.21
164,Loud and Heavy,Cody Jinks,7,0,7,1,0,18400,4700,13700,1519362,2023.12.21
165,She Ain'T Dancin' Here,Trent Cowie Band,2,2,0,1,0,18300,18300,0,177,2023.12.21
166,The Great Divide,Luke Combs & Billy Strings,6,-1,7,1,0,18200,6800,11400,182684,2023.12.21
167,Good Luck And God,Shane Profitt,5,4,1,5,0,17900,13300,4600,93004,2023.12.21
168,Work Boots,Cody Johnson,1,1,0,1,0,17300,17300,0,534320,2023.12.21
169,Tuggin' On My Heartstrings,Randall King,1,0,1,1,0,17300,16300,1000,27802,2023.12.21
170,Messed Around,Huser Brother Band,1,0,1,1,0,17300,0,17300,1104,2023.12.21
171,There's The Sun,Zach Top,1,-15,16,1,0,17300,-58500,75800,102126,2023.12.21
172,Wild,Carter Faith,11,-2,13,1,0,16900,2100,14800,149429,2023.12.21
173,Heart Of A Small Town,Tim Dugger,2,0,2,1,0,16500,0,16500,8144,2023.12.21
174,Way Back When,Wayland,24,0,24,12,0,16400,0,16400,1086,2023.12.21
175,Cowboy Forever,Carter Faith,8,-3,11,1,0,16300,5400,10900,28964,2023.12.21
176,Seven Minutes In Heaven,Reba Mcentire,4,4,0,4,0,15700,15700,0,142252,2023.12.21
177,John Deere Green,"HIXTAPE Feat. HARDY, Morgan Wallen, Joe Diffie",1,0,1,1,0,15400,6300,9100,0,2023.12.21
178,Winter Wonderland,Jon Pardi,3,2,1,3,0,15100,14600,500,27872,2023.12.21
179,Oklahoma Smokeshow,Zach Bryan,11,-2,13,2,0,14800,-3900,18700,5650830,2023.12.21
180,Broadway Girls,Lil Durk Feat. Morgan Wallen,3,0,3,1,0,14500,-2100,16600,3791673,2023.12.21
181,Star Spangled Banner,Mickey Guyton,3,1,2,3,0,14200,-1200,15400,0,2023.12.21
182,Cowboy For Christmas,Annie Bosko,4,1,3,1,0,13800,7800,6000,235771,2023.12.21
183,Oklahoma Sooner,Jake Banfield,13,2,11,1,0,13700,6500,7200,8941,2023.12.21
184,Any Given Friday Night,Luke Combs,2,1,1,1,0,13400,6700,6700,177666,2023.12.21
185,The Star Spangled Banner,Brad Paisley,4,4,0,4,0,13200,13200,0,0,2023.12.21
186,BELLS,Rachelle Garniez,1,1,0,1,0,12300,12300,0,0,2023.12.21
187,Under A Southern Sky,Ian Flanigan,17,-17,34,17,0,11900,-11900,23800,4541,2023.12.21
188,National Anthem,Pryor & Lee,1,0,1,1,0,11400,10800,600,0,2023.12.21
189,Life With You,Kelsey Hart,10,-3,13,4,0,11400,1700,9700,961724,2023.12.21
190,Looks Like Jesus,Brian Free & Assurance,2,2,0,2,0,11200,11200,0,477,2023.12.21
191,"The Father, My Son, And The Holy Ghost",Craig Morgan,2,1,1,1,0,11200,9500,1700,56438,2023.12.21
192,On The Boat Again,Jake Owen,6,0,6,1,0,11000,700,10300,72788,2023.12.21
193,Better Off,Trace Adkins,2,0,2,1,0,10900,-300,11200,13297,2023.12.21
194,A Little Bit Closer,Braxton Keith,3,2,1,1,0,10800,9800,1000,59100,2023.12.21
195,400 Horsepower Sleigh,Jon Pardi,2,-1,3,2,0,10700,-8900,19600,440619,2023.12.21
196,Must Be The Whiskey,Cody Jinks,9,-2,11,2,0,10700,-46000,56700,1418624,2023.12.21
197,National Anthem From Battle At Bristol,Jennifer Nettles,1,-2,3,1,0,10600,-8700,19300,0,2023.12.21
198,Quittin' Time,Morgan Wallen,2,-1,3,2,0,10000,3700,6300,818896,2023.12.21
199,I Love You (From An Old Rugged Cross),Joseph Habedank,1,1,0,1,0,9500,9500,0,3411,2023.12.21
199,This Grace,Joseph Habedank,1,1,0,1,0,9500,9500,0,1724,2023.12.21
201,Heart To Break,Ryan Griffin,19,1,18,1,0,9500,-1000,10500,91474,2023.12.21
1,World On Fire,Nate Smith,7125,-812,7937,142,0,29771700,-3809100,33580800,5512499,2023.12.28
2,Mind On You,George Birge,7179,-34,7213,142,0,28647700,-781000,29428700,1060239,2023.12.28
3,Save Me,Jelly Roll & Lainey Wilson,5995,-951,6946,140,0,25378900,-4832700,30211600,6457146,2023.12.28
4,Save Me The Trouble,Dan + Shay,6136,-658,6794,142,0,24127600,-2610100,26737700,3299935,2023.12.28
5,Thinkin' Bout Me,Morgan Wallen,4837,-720,5557,139,0,22024200,-3215400,25239600,11950863,2023.12.28
6,White Horse,Chris Stapleton,4956,-684,5640,142,0,19383300,-2973700,22357000,8236219,2023.12.28
7,Different 'Round Here,Riley Green,4714,-402,5116,142,0,17454100,-2024400,19478500,2315520,2023.12.28
8,Where The Wild Things Are,Luke Combs,4162,-443,4605,142,0,16651000,-1855600,18506600,4158262,2023.12.28
9,All I Need Is You,Chris Janson,4434,-457,4891,142,0,16360500,-2179800,18540300,482235,2023.12.28
10,Pretty Little Poison,Warren Zeiders,4025,-521,4546,137,0,15379800,-2033100,17412900,7289936,2023.12.28
11,I Can Feel It,Kane Brown,3775,-458,4233,142,0,14686900,-1976900,16663800,2450312,2023.12.28
12,The Painter,Cody Johnson,3326,-604,3930,141,0,13665100,-2656400,16321500,4441334,2023.12.28
13,Truck Bed,Hardy,3645,-314,3959,139,0,13039100,-1034400,14073500,6035228,2023.12.28
14,23,Chayce Beckham,3135,-407,3542,140,0,10810600,-1815800,12626400,3653262,2023.12.28
15,Creek Will Rise,Conner Smith,3146,-446,3592,142,0,10667500,-1531900,12199400,762053,2023.12.28
16,Burn It Down,Parker Mccollum,2895,-364,3259,140,0,10392800,-1629000,12021800,4848786,2023.12.28
17,Mamaw's House,Thomas Rhett,2068,-127,2195,136,0,7465100,-494000,7959100,2156485,2023.12.28
18,Fearless,Jackson Dean,2184,-290,2474,135,0,6965600,-1204900,8170500,929931,2023.12.28
19,We Don'T Fight Anymore,Carly Pearce,1984,-190,2174,137,0,6207400,-786300,6993700,3581560,2023.12.28
20,Tucson Too Late,Jordan Davis,1847,-286,2133,137,0,6056900,-1031400,7088300,1413224,2023.12.28
21,Wildflowers And Wild Horses,Lainey Wilson,1817,-141,1958,139,0,5970300,-664700,6635000,2224550,2023.12.28
22,Cab In A Solo,Scotty McCreery,2050,-300,2350,142,0,5862700,-748200,6610900,471663,2023.12.28
23,Glory Days,Gabby Barrett,2134,-247,2381,137,0,5606300,-592300,6198600,1330273,2023.12.28
24,Man Made A Bar,Morgan Wallen,1505,-131,1636,135,0,5589100,-669700,6258800,4926329,2023.12.28
25,Nobody's Nobody,Brothers Osborne,1936,-331,2267,135,0,4827800,-1289800,6117600,939297,2023.12.28
26,Back Then Right Now,Tyler Hubbard,1723,-159,1882,133,0,4582200,-403600,4985800,1094683,2023.12.28
27,I Remember Everything,Zach Bryan Feat. Kacey Musgraves,1401,-167,1568,125,0,4401800,-630200,5032000,18516971,2023.12.28
28,Take Her Home,Kenny Chesney,1459,-150,1609,137,0,4330300,-770400,5100700,625140,2023.12.28
29,Out Of That Truck,Carrie Underwood,1436,-215,1651,124,0,4192900,-536300,4729200,1339330,2023.12.28
30,Your Place,Ashley Cooke,1001,232,769,79,0,3953200,1096800,2856400,850416,2023.12.28
31,I'M Not Pretty,Megan Moroney,1432,-144,1576,130,0,3905400,-425800,4331200,2048103,2023.12.28
32,Love You Again,Chase Matthew,1283,-176,1459,119,0,3428800,-474500,3903300,1688834,2023.12.28
33,Outskirts,Sam Hunt,1275,-69,1344,124,0,3296700,-356500,3653200,1452262,2023.12.28
34,Can't Break Up Now,Old Dominion,1171,-127,1298,118,0,3210700,-713800,3924500,1337490,2023.12.28
35,See You Next Summer,Brian Kelley,1072,-524,1596,126,0,2888600,-1497000,4385600,240155,2023.12.28
36,Young Love & Saturday Nights,Chris Young,736,-72,808,68,0,2605500,-272900,2878400,471118,2023.12.28
37,Let Your Boys Be Country,Jason Aldean,720,-202,922,82,0,2422900,-1187800,3610700,1410580,2023.12.28
38,Drinkin' Problems,Dillon Carmichael,919,-140,1059,110,0,2359500,-500400,2859900,58123,2023.12.28
39,Where It Ends,Bailey Zimmerman,842,-72,914,107,0,2318800,-308100,2626900,3369529,2023.12.28
40,We Ride,Bryan Martin,663,-78,741,68,0,2050100,-283200,2333300,3090671,2023.12.28
41,Something's Gonna Kill Me,Corey Kent,708,-84,792,69,0,1924600,-299500,2224100,2004668,2023.12.28
42,Cowboys And Plowboys,Jon Pardi Feat. Luke Bryan,716,-95,811,90,0,1922500,-331400,2253900,571938,2023.12.28
43,Gonna Love You,Parmalee,733,-62,795,70,0,1824800,-175100,1999900,192881,2023.12.28
44,Spirits And Demons,Michael Ray With Meghan Patrick,843,-145,988,100,0,1773700,-513700,2287400,179151,2023.12.28
45,Rodeo Man,Garth Brooks & Ronnie Dunn,775,-56,831,111,0,1673500,-311500,1985000,1033559,2023.12.28
46,Dance With You,Brett Young,688,-74,762,79,0,1497600,-110500,1608100,966667,2023.12.28
47,Pickup Man (Feat. Post Malone),Hixtape & Joe Diffie,286,-89,375,70,0,1192300,-316700,1509000,580370,2023.12.28
48,Feel Like The Holidays,Scotty McCreery,207,174,33,50,0,1173800,959000,214800,462886,2023.12.28
49,All I Want For Christmas Is You,Jon Pardi,210,110,100,37,0,1104500,464100,640400,44778,2023.12.28
50,This Is My Dirt,Justin Moore,511,-47,558,86,0,935300,-129000,1064300,266696,2023.12.28
51,Love You Back,Lady A,476,-53,529,79,0,856600,-231600,1088200,170550,2023.12.28
52,In Your Love,Tyler Childers,439,-59,498,56,0,836400,-102000,938400,3307125,2023.12.28
53,Find Another Bar,Chris Lane,426,-40,466,59,0,806500,-24900,831400,177170,2023.12.28
54,Chevrolet,Dustin Lynch,382,-2,384,55,0,772300,-52600,824900,0,2023.12.28
55,My Favorite Things,Kelsea Ballerini & Joey Alexander,133,125,8,41,0,765400,710500,54900,28074,2023.12.28
56,Brokenhearted,Joe Nichols,447,-33,480,55,0,744800,-118100,862900,7919,2023.12.28
57,She's Somebody's Daughter,Drew Baldridge,392,-34,426,61,0,732800,-118200,851000,367124,2023.12.28
58,Beer For Santa,Jon Pardi,158,100,58,42,0,713400,395500,317900,320179,2023.12.28
59,I'm In Love,Hailey Whitters,407,-83,490,67,0,709900,-320400,1030300,524484,2023.12.28
60,Long Live Cowgirls,Ian Munsick & Cody Johnson,226,-28,254,36,0,608100,-152400,760500,743412,2023.12.28
61,Ain'T About You,Huntergirl,395,-40,435,65,0,542000,-81900,623900,14209,2023.12.28
62,O Come All Ye Faithful,Joe Nichols,85,84,1,16,0,523100,516800,6300,348424,2023.12.28
63,Make Me Wanna Smoke,Runaway June,252,-32,284,35,0,519400,24500,494900,9655,2023.12.28
64,It's Beginning To Look A Lot Like Christmas,Maddie & Tae,65,56,9,22,0,404700,323000,81700,504835,2023.12.28
65,This Side Of The Dirt,Neon Union,217,-34,251,34,0,400400,-24900,425300,16368,2023.12.28
66,Wine Country,Hannah Ellis,252,-97,349,40,0,398700,-102300,501000,27291,2023.12.28
67,King Of Country Music,Ryan Larkins,235,-11,246,43,0,376700,-43900,420600,27800,2023.12.28
68,Cancel,Randy Houser,255,-53,308,40,0,372000,-117000,489000,57153,2023.12.28
68,Cancelled,Randy Houser,255,-53,308,40,0,372000,-117000,489000,0,2023.12.28
70,Holiday Road,Chris Janson,217,202,15,68,0,360600,318600,42000,412608,2023.12.28
71,Breakin' In Boots,Matt Stell,260,20,240,40,0,358800,100600,258200,423341,2023.12.28
72,Blue Christmas,Elvis Presley & Kane Brown,196,174,22,60,0,353700,254200,99500,1225900,2023.12.28
73,Santa Baby,Trisha Yearwood,68,48,20,30,0,340200,244300,95900,8556,2023.12.28
74,My Truck,Breland,73,73,0,37,0,333000,333000,0,675107,2023.12.28
75,Thicc As Thieves,Lauren Alaina,218,-47,265,40,0,317900,-84700,402600,748201,2023.12.28
76,Dirt Cheap,Cody Johnson,23,15,8,3,0,271100,236500,34600,2283735,2023.12.28
77,Feliz Navidad,Frank Ray,61,29,32,17,0,250200,102000,148200,102940,2023.12.28
78,"Let It Snow, Let It Snow, Let It Snow",Jon Pardi,38,34,4,17,0,249100,204200,44900,236268,2023.12.28
79,Boys Back Home,Dylan Marlowe Feat. Dylan Scott,151,9,142,31,0,248900,-10600,259500,2192654,2023.12.28
80,Trouble,Josh Ross,159,-26,185,28,0,248500,-42000,290500,1668720,2023.12.28
81,Hurry Up Christmas,Huntergirl,65,30,35,38,0,242800,199700,43100,270499,2023.12.28
82,Run Outta Mistletoe,High Valley,263,126,137,62,0,226200,129800,96400,494081,2023.12.28
83,Santa Looked A Lot Like Daddy,Jon Pardi,48,19,29,15,0,219800,46700,173100,328205,2023.12.28
84,Rain In The Rearview,Anne Wilson,186,-30,216,34,0,218200,-61000,279200,506650,2023.12.28
85,Heart They Didn'T Break,Maddie & Tae,185,-11,196,29,0,197600,-9400,207000,770670,2023.12.28
86,How Is She,Cole Swindell,28,-5,33,1,0,197000,-12100,209100,43923,2023.12.28
87,Christmas Again,Huntergirl,63,47,16,34,0,192600,155100,37500,272549,2023.12.28
88,Cowboy For Christmas,Runaway June,258,162,96,49,0,192300,128500,63800,8888,2023.12.28
89,That's Texas,Cody Johnson,18,0,18,1,0,177400,-16600,194000,380491,2023.12.28
90,Ain't Missin' You,Dylan Schneider,163,-21,184,24,0,175100,-35700,210800,792458,2023.12.28
91,Stretchy Pants,Carrie Underwood,31,26,5,10,0,157100,135200,21900,129359,2023.12.28
92,Halfway To Hell,Jelly Roll,28,19,9,3,0,153400,129400,24000,1401048,2023.12.28
93,Once A Year,Ingrid Andress,27,27,0,22,0,147700,147700,0,231139,2023.12.28
94,Wondering Why,Red Clay Strays,11,7,4,1,0,141400,92200,49200,5183443,2023.12.28
95,Please Come Home For Christmas,Jon Pardi,26,11,15,7,0,135300,58100,77200,687487,2023.12.28
96,Million Little Bandaids,Caroline Jones,125,-16,141,22,0,133500,500,133000,42037,2023.12.28
97,Winter Wonderland,Jon Pardi,25,22,3,17,0,110000,94900,15100,27778,2023.12.28
98,Falalala Falling,Tigirlily Gold,20,15,5,7,0,107100,85600,21500,359474,2023.12.28
99,Without You,Thompson Square,20,-4,24,4,0,107000,-49200,156200,4807,2023.12.28
100,Sarah's Place,Zach Bryan,15,0,15,1,0,100900,-5000,105900,3249533,2023.12.28
101,The Christmas Song,Maddie & Tae,14,11,3,6,0,93200,74500,18700,237183,2023.12.28
102,Blue Christmas,Elvie Shane,17,11,6,5,0,88700,58100,30600,2280,2023.12.28
103,Nothing Compares To You,Mickey Guyton Feat. Kane Brown,39,-6,45,7,0,85800,-500,86300,397688,2023.12.28
104,Mistletoe,Chase Matthew,42,24,18,17,0,78800,17900,60900,702596,2023.12.28
105,We Can Reach The Stars,Blake Shelton,6,6,0,1,0,76800,76800,0,8638,2023.12.28
106,Ok Cowboy,Catie Offerman,14,-1,15,3,0,74000,-1600,75600,25542,2023.12.28
107,Mary Did You Know?,Hannah Ellis,14,13,1,3,0,70600,67200,3400,0,2023.12.28
108,What Christmas Means To Me,Old Dominion,12,2,10,1,0,69000,10700,58300,10,2023.12.28
109,400 Horsepower Sleigh,Jon Pardi,11,9,2,6,0,68300,57600,10700,364646,2023.12.28
110,Colorado,Florida Georgia Line,16,3,13,2,0,67700,-10700,78400,35688,2023.12.28
111,Blue Christmas,Lane Johnson & Jason Kelce,4,0,4,1,0,66200,-1600,67800,148055,2023.12.28
112,Coal,Dylan Gossett,13,-4,17,1,0,65500,14700,50800,3855324,2023.12.28
113,Merry Christmas From The Keys,Jon Pardi,15,3,12,3,0,62900,20900,42000,46599,2023.12.28
114,Neon Baby,Annie Bosko,91,-5,96,20,0,62600,-3400,66000,21341,2023.12.28
115,Silver Bells,Brett Young,10,10,0,9,0,60600,60600,0,116018,2023.12.28
116,Sunday Saints,Jordan Davis,11,-8,19,1,0,60600,-48300,108900,29604,2023.12.28
117,Ain'T Got A Worry,Old Dominion,11,0,11,2,0,56900,1100,55800,171528,2023.12.28
118,I Need You,Frontmen,10,-8,18,2,0,56800,-42900,99700,1419,2023.12.28
119,O Holy Night,Erin Kinsey,45,45,0,27,0,54900,54900,0,3239,2023.12.28
120,Fake Names,Priscilla Block,15,-7,22,1,0,54000,-14100,68100,64724,2023.12.28
121,The Star-Spangled Banner,Chris Stapleton,9,-4,13,8,0,48500,-27000,75500,80371,2023.12.28
122,With You I Am,Cody Johnson,6,-1,7,2,0,48300,-15100,63400,1414683,2023.12.28
123,There's The Sun,Zach Top,6,5,1,1,0,46100,28800,17300,101817,2023.12.28
124,New Baby For Christmas,Hailey Whitters,6,6,0,4,0,45200,45200,0,55452,2023.12.28
125,It's Beginning To Look A Lot Like Christmas,Lindsay Ell,7,4,3,4,0,43300,-1700,45000,141101,2023.12.28
126,White Christmas,Maddie & Tae,8,8,0,2,0,40900,40900,0,358939,2023.12.28
127,Make You Mine,Marynn Taylor,12,-10,22,6,0,38600,13000,25600,27629,2023.12.28
128,Jack And Diet Coke,Redferrin,12,12,0,1,0,38100,38100,0,1124047,2023.12.28
129,Wild Ones,Jessie Murph & Jelly Roll,17,4,13,1,0,37900,4900,33000,9636492,2023.12.28
130,No Present LIke The Time,Jay Allen,65,-3,68,12,0,36900,-700,37600,0,2023.12.28
131,Cowgirls,Morgan Wallen,12,-4,16,3,0,36500,-17600,54100,4860908,2023.12.28
132,Stop Coming Over,Chris Lane,11,11,0,6,0,35400,35400,0,23050,2023.12.28
133,Goodbye Looks Good On You,Alana Springsteen Feat. Mitchell Tenpenny,13,-1,14,1,0,35000,10600,24400,1180399,2023.12.28
134,Cowboy For Christmas,Annie Bosko,11,7,4,2,0,34100,20300,13800,189666,2023.12.28
135,I'Ll Be Home For Christmas,Rodney Atkins,5,-1,6,3,0,33500,5900,27600,1040,2023.12.28
136,Holy Water,Michael Ray,5,-3,8,2,0,31600,-29300,60900,209530,2023.12.28
137,Tulsa,Elle King,10,-3,13,1,0,31600,-13100,44700,35147,2023.12.28
138,Love Can Build A Bridge,"Jelly Roll, K. Michelle & The Fisk Jubilee Singers",7,7,0,7,0,28400,28400,0,43722,2023.12.28
139,As Far As You Could,Charles Kelley,13,13,0,9,0,26000,26000,0,4817,2023.12.28
140,The Star Spangled Banner,Locash,1,1,0,1,0,22300,22300,0,0,2023.12.28
141,Star Spangled Banner,Maren Morris,1,-1,2,1,0,22300,-10600,32900,0,2023.12.28
142,Unlive,"Jelly Roll, Yelawolf",2,2,0,1,0,21800,21800,0,432512,2023.12.28
143,Frosty The Snowman,Uncle Kracker,2,-2,4,1,0,21100,1100,20000,9914,2023.12.28
144,Outrunnin' Your Memory,Luke Combs & Miranda Lambert,7,7,0,6,0,20200,20200,0,325062,2023.12.28
145,Must Be The Whiskey,Cody Jinks,8,-1,9,2,0,19900,9200,10700,1326413,2023.12.28
146,Longneck Way To Go,Midland Feat. Jon Pardi,2,2,0,1,0,19700,19700,0,119060,2023.12.28
147,Along For The Ride,Jordan Harvey,6,6,0,6,0,19300,19300,0,11851,2023.12.28
147,Mine For The Summer,Jameson Rodgers,6,6,0,6,0,19300,19300,0,41174,2023.12.28
147,Almost Home,Craig Morgan And Jelly Roll,6,6,0,6,0,19300,19300,0,499597,2023.12.28
150,Sun To Me,Zach Bryan,12,-3,15,2,0,18500,-200,18700,3954944,2023.12.28
151,Star Spangled Banner,Abby Anderson,3,-1,4,2,0,17400,-2200,19600,0,2023.12.28
152,I'll Be Here,Colbie Caillat,16,-1,17,1,0,17400,-1500,18900,330155,2023.12.28
153,When My Baby's In Boots,Randall King,1,1,0,1,0,17300,17300,0,0,2023.12.28
154,Hungover You,Emily Brooke,6,-6,12,5,0,17300,-21300,38600,627,2023.12.28
155,Ours,Taylor Swift,2,-1,3,2,0,17000,12300,4700,100051,2023.12.28
156,Stranger In My House,Ronnie Milsap,3,-13,16,1,0,16900,-100200,117100,113693,2023.12.28
157,"I'Ve Been Bad, Santa","Jon Pardi, Pillbox Patti",9,9,0,2,0,16700,16700,0,41281,2023.12.28
158,Hard Candy Christmas,Trisha Yearwood,3,3,0,3,0,16500,16500,0,45109,2023.12.28
159,Outlaws And Mustangs,Cody Jinks,11,2,9,2,0,16300,-3600,19900,181121,2023.12.28
160,That Ain'T Country,Aaron Lewis,6,-2,8,1,0,16300,-5200,21500,93568,2023.12.28
161,Go Tell It On The Mountain,for King & Country,3,2,1,2,0,15500,6300,9200,1464203,2023.12.28
162,A Little Bit Closer,Braxton Keith,2,-1,3,1,0,15300,4500,10800,53980,2023.12.28
163,Christmas In The Backyard,Morgan Evans,3,3,0,1,0,15000,15000,0,404268,2023.12.28
164,Just Because It's Christmas,Anne Wilson,11,11,0,11,0,14900,14900,0,61508,2023.12.28
165,Reindeer,Jon Pardi,5,4,1,3,0,14800,13800,1000,36425,2023.12.28
166,Better Off,Trace Adkins,2,0,2,1,0,14600,3700,10900,11534,2023.12.28
167,For You For Christmas,Zach Top,4,4,0,1,0,14100,14100,0,95446,2023.12.28
167,Wishlist,Laura Bryna,4,4,0,1,0,14100,14100,0,12064,2023.12.28
169,One Bad Habit,Tim McGraw,6,-1,7,2,0,13900,-22200,36100,25365,2023.12.28
170,Honky Tonk Heartbreaker,Dustin Lynch,3,1,2,1,0,13800,6000,7800,43525,2023.12.28
171,Any Given Friday Night,Luke Combs,2,0,2,1,0,13400,0,13400,166546,2023.12.28
172,Heart Attack,Boy Named Banjo,10,-9,19,1,0,13400,-13000,26400,2576,2023.12.28
173,National Anthem From Battle At Bristol,Jennifer Nettles,3,2,1,3,0,13300,2700,10600,0,2023.12.28
174,Oklahoma Smokeshow,Zach Bryan,12,1,11,1,0,13100,-1700,14800,5481751,2023.12.28
175,Swing On Down To Texas,Jon Pardi,4,3,1,2,0,12800,9400,3400,180242,2023.12.28
176,Hey There Hometown,Abby Leigh Anderson,3,2,1,1,0,12700,8600,4100,993,2023.12.28
177,Cold Beer & Country Music,Zach Top,3,3,0,1,0,12400,12400,0,58838,2023.12.28
178,BELLS,Rachelle Garniez,1,0,1,1,0,12300,0,12300,0,2023.12.28
179,The Great Divide,Luke Combs & Billy Strings,6,0,6,1,0,12100,-6100,18200,172533,2023.12.28
180,O Holy Night,Anne Wilson,17,17,0,17,0,11900,11900,0,96761,2023.12.28
181,Under A Southern Sky,Ian Flanigan,17,0,17,17,0,11900,0,11900,4174,2023.12.28
182,Bad Man,Twinnie,17,-15,32,17,0,11900,-8500,20400,641,2023.12.28
183,Downtime,Roman Alexander,17,-17,34,17,0,11900,-11900,23800,12766,2023.12.28
183,But A Beer Can,Eric Burgett,17,-17,34,17,0,11900,-11900,23800,3870,2023.12.28
183,Two Woman Man,Randall Fowler,17,-17,34,17,0,11900,-11900,23800,221,2023.12.28
183,Tea Was A Little Sweeter,Matt Rogers,17,-17,34,17,0,11900,-11900,23800,840,2023.12.28
183,Summer Soundtrack,Craig Campbell,17,-17,34,17,0,11900,-11900,23800,714,2023.12.28
183,Back At The Bar,Landon Parker,17,-17,34,17,0,11900,-11900,23800,960,2023.12.28
183,Silverado,Caleb Lee Hutchinson,17,-17,34,17,0,11900,-11900,23800,11692,2023.12.28
190,She's Gotta Know,Conner Sweet,17,-34,51,17,0,11900,-23800,35700,735,2023.12.28
191,I'M Not For Everyone,Brothers Osborne,3,2,1,2,0,11800,8000,3800,350676,2023.12.28
192,No Yesterday,Jeremy McComb,7,3,4,1,0,11500,3800,7700,213,2023.12.28
193,Meet Me At The Cross,Brian Free & Assurance,2,1,1,2,0,11400,11000,400,459,2023.12.28
194,Here Comes Jesus,Jeff & Sheri Easter,2,1,1,2,0,11400,7300,4100,5877,2023.12.28
195,Star On Top Of The Tree,Grace Leer,16,16,0,16,0,11100,11100,0,1438,2023.12.28
196,Meet Me Under The Mistletoe,Hailey Whitters,4,4,0,1,0,11100,11100,0,132192,2023.12.28
197,Rudolph The Red-nosed Reindeer,John Driskell Hopkins,1,1,0,1,0,11100,11100,0,0,2023.12.28
198,"The Father, My Son, And The Holy Ghost",Craig Morgan,2,0,2,1,0,10900,-300,11200,48719,2023.12.28
199,Record High,Randall King,2,2,0,1,0,10800,10800,0,25109,2023.12.28
200,"Houston, We Got A Problem",Luke Combs,5,1,4,1,0,10500,1200,9300,935993,2023.12.28
1,World On Fire,Nate Smith,7998,849,7149,143,0,34042700,4097300,29945400,7133962,2024.01.04
2,Save Me The Trouble,Dan + Shay,7889,1731,6158,143,0,30006800,5702500,24304300,4333742,2024.01.04
3,Mind On You,George Birge,7530,328,7202,143,0,29900400,1104400,28796000,1054252,2024.01.04
4,Save Me,Jelly Roll & Lainey Wilson,6839,844,5995,141,0,28891100,3512200,25378900,7350619,2024.01.04
5,Thinkin' Bout Me,Morgan Wallen,5509,649,4860,139,0,25106800,2927800,22179000,13747550,2024.01.04
6,White Horse,Chris Stapleton,6045,1066,4979,143,0,23460300,3908300,19552000,10053501,2024.01.04
7,Different 'Round Here,Riley Green,5570,839,4731,143,0,20506000,2937600,17568400,2636583,2024.01.04
8,Where The Wild Things Are,Luke Combs,4745,560,4185,143,0,19290800,2464600,16826200,5249863,2024.01.04
9,All I Need Is You,Chris Janson,5070,613,4457,142,0,18275400,1742000,16533400,590379,2024.01.04
10,Pretty Little Poison,Warren Zeiders,4872,841,4031,138,0,17750300,2338800,15411500,8780849,2024.01.04
11,I Can Feel It,Kane Brown,4505,714,3791,143,0,17569200,2763600,14805600,4022383,2024.01.04
12,The Painter,Cody Johnson,4187,842,3345,142,0,16718200,2915600,13802600,6044559,2024.01.04
13,Truck Bed,Hardy,4380,718,3662,139,0,15472300,2313100,13159200,7480197,2024.01.04
14,23,Chayce Beckham,3686,534,3152,142,0,12666100,1738300,10927800,4022984,2024.01.04
15,Burn It Down,Parker Mccollum,3446,544,2902,139,0,12352400,1920000,10432400,6188632,2024.01.04
16,Creek Will Rise,Conner Smith,3688,525,3163,143,0,12123400,1335800,10787600,919420,2024.01.04
17,Mamaw's House,Thomas Rhett,2375,307,2068,133,0,8343200,878100,7465100,2664212,2024.01.04
18,Wildflowers And Wild Horses,Lainey Wilson,2214,391,1823,140,0,7685300,1680400,6004900,2861439,2024.01.04
19,Fearless,Jackson Dean,2592,400,2192,135,0,7644100,635200,7008900,971195,2024.01.04
20,Cab In A Solo,Scotty McCreery,2560,493,2067,143,0,7442300,1459500,5982800,553804,2024.01.04
21,Man Made A Bar,Morgan Wallen,1827,307,1520,136,0,7320400,1631500,5688900,5197626,2024.01.04
22,We Don'T Fight Anymore,Carly Pearce,2295,296,1999,138,0,7277200,955400,6321800,4710937,2024.01.04
23,Tucson Too Late,Jordan Davis,2176,323,1853,138,0,7202500,1116800,6085700,1626148,2024.01.04
24,Glory Days,Gabby Barrett,2318,177,2141,138,0,6292400,650700,5641700,1850619,2024.01.04
25,Nobody's Nobody,Brothers Osborne,2176,234,1942,135,0,5949200,1099100,4850100,1251756,2024.01.04
26,Back Then Right Now,Tyler Hubbard,1965,236,1729,135,0,5483700,874000,4609700,1432722,2024.01.04
27,Take Her Home,Kenny Chesney,1763,298,1465,138,0,5442100,1067100,4375000,823227,2024.01.04
28,I Remember Everything,Zach Bryan Feat. Kacey Musgraves,1628,207,1421,126,0,5344300,803600,4540700,21554965,2024.01.04
29,Out Of That Truck,Carrie Underwood,1796,354,1442,126,0,5230800,1013300,4217500,1396667,2024.01.04
30,I'M Not Pretty,Megan Moroney,1660,210,1450,131,0,4876300,844200,4032100,2683847,2024.01.04
31,Your Place,Ashley Cooke,1162,161,1001,81,0,4602000,648800,3953200,992731,2024.01.04
32,Can't Break Up Now,Old Dominion,1420,246,1174,120,0,4094800,860100,3234700,1871042,2024.01.04
33,Love You Again,Chase Matthew,1560,270,1290,123,0,4003400,535000,3468400,1938544,2024.01.04
34,Outskirts,Sam Hunt,1491,209,1282,128,0,3993000,657300,3335700,1823432,2024.01.04
35,Let Your Boys Be Country,Jason Aldean,1017,278,739,86,0,3990000,1441300,2548700,1541257,2024.01.04
36,Young Love & Saturday Nights,Chris Young,904,168,736,68,0,3301900,696400,2605500,548749,2024.01.04
37,Where It Ends,Bailey Zimmerman,992,130,862,87,0,3008000,565500,2442500,3995569,2024.01.04
38,See You Next Summer,Brian Kelley,1011,-67,1078,121,0,2979600,73900,2905700,277946,2024.01.04
39,Drinkin' Problems,Dillon Carmichael,1157,238,919,125,0,2756800,397300,2359500,71547,2024.01.04
40,Something's Gonna Kill Me,Corey Kent,868,154,714,74,0,2660500,691800,1968700,2511459,2024.01.04
41,We Ride,Bryan Martin,814,151,663,72,0,2525000,474900,2050100,3357231,2024.01.04
42,Cowboys And Plowboys,Jon Pardi Feat. Luke Bryan,849,127,722,91,0,2449500,504700,1944800,407907,2024.01.04
43,Gonna Love You,Parmalee,856,116,740,72,0,2146700,277100,1869600,234711,2024.01.04
44,Spirits And Demons,Michael Ray With Meghan Patrick,936,93,843,100,0,2095400,321700,1773700,198575,2024.01.04
45,Rodeo Man,Garth Brooks & Ronnie Dunn,920,145,775,112,0,1991900,318400,1673500,1407413,2024.01.04
46,Dance With You,Brett Young,797,102,695,81,0,1755700,218500,1537200,1171915,2024.01.04
47,Pickup Man (Feat. Post Malone),Hixtape & Joe Diffie,330,44,286,68,0,1212000,19700,1192300,600726,2024.01.04
48,This Is My Dirt,Justin Moore,638,127,511,87,0,1152600,217300,935300,291945,2024.01.04
49,Love You Back,Lady A,580,104,476,82,0,1018500,161900,856600,216882,2024.01.04
50,In Your Love,Tyler Childers,514,75,439,55,0,1007800,171400,836400,3912430,2024.01.04
51,Find Another Bar,Chris Lane,518,92,426,63,0,991500,185000,806500,209803,2024.01.04
52,Chevrolet,Dustin Lynch Feat. Jelly Roll,461,79,382,59,0,895200,122900,772300,1820440,2024.01.04
53,I'm In Love,Hailey Whitters,409,2,407,56,0,831300,121400,709900,733758,2024.01.04
54,Brokenhearted,Joe Nichols,493,46,447,55,0,829700,84900,744800,8389,2024.01.04
55,Long Live Cowgirls,Ian Munsick & Cody Johnson,269,43,226,40,0,797600,189500,608100,849360,2024.01.04
56,She's Somebody's Daughter,Drew Baldridge,485,93,392,65,0,784800,52000,732800,381446,2024.01.04
57,Ain'T About You,Huntergirl,448,53,395,65,0,639200,97200,542000,16605,2024.01.04
58,Make Me Wanna Smoke,Runaway June,297,45,252,35,0,530800,11400,519400,12047,2024.01.04
59,King Of Country Music,Ryan Larkins,283,48,235,45,0,529700,153000,376700,41234,2024.01.04
60,Cancelled,Randy Houser,324,69,255,41,0,486300,114300,372000,0,2024.01.04
60,Cancel,Randy Houser,324,69,255,41,0,486300,114300,372000,64089,2024.01.04
62,Boys Back Home,Dylan Marlowe Feat. Dylan Scott,213,62,151,47,0,468100,219200,248900,2542254,2024.01.04
63,Thicc As Thieves,Lauren Alaina,266,48,218,43,0,457800,139900,317900,968816,2024.01.04
64,Wine Country,Hannah Ellis,287,35,252,43,0,454500,55800,398700,34131,2024.01.04
65,Dirt Cheap,Cody Johnson,39,16,23,5,0,451000,179900,271100,2469927,2024.01.04
66,Breakin' In Boots,Matt Stell,301,41,260,41,0,410000,51200,358800,477047,2024.01.04
67,This Side Of The Dirt,Neon Union,256,39,217,36,0,403400,3000,400400,20772,2024.01.04
68,Halfway To Hell,Jelly Roll,79,51,28,18,0,379600,226200,153400,1548613,2024.01.04
69,Heart They Didn'T Break,Maddie & Tae,226,34,192,30,0,316500,67000,249500,847850,2024.01.04
70,Rain In The Rearview,Anne Wilson,241,55,186,36,0,295500,77300,218200,611187,2024.01.04
71,That's Texas,Cody Johnson,27,9,18,1,0,277700,100300,177400,414570,2024.01.04
72,Trouble,Josh Ross,172,13,159,34,0,273400,24900,248500,2006976,2024.01.04
73,Wondering Why,Red Clay Strays,18,7,11,1,0,253400,112000,141400,5284582,2024.01.04
74,Without You,Thompson Square,33,13,20,4,0,209000,102000,107000,5277,2024.01.04
75,Who Says You Can'T Have Everything,Brothers Osborne,36,36,0,30,0,206700,206700,0,414425,2024.01.04
76,How Is She,Cole Swindell,29,1,28,1,0,188600,-8400,197000,47722,2024.01.04
77,Ain't Missin' You,Dylan Schneider,180,17,163,23,0,188200,13100,175100,962029,2024.01.04
78,The Star-Spangled Banner,Chris Stapleton,52,43,9,47,0,187800,139300,48500,83528,2024.01.04
79,Million Little Bandaids,Caroline Jones,151,26,125,22,0,172300,38800,133500,52896,2024.01.04
80,Goin' Crazy,Catie Offerman,37,37,0,37,0,166000,166000,0,0,2024.01.04
81,Once A Year,Ingrid Andress,26,-1,27,23,0,152600,4900,147700,16522,2024.01.04
82,Sarah's Place,Zach Bryan,17,2,15,1,0,141000,40100,100900,3452276,2024.01.04
83,Anybody But You,Lauren Watkins,20,20,0,15,0,105400,105400,0,126428,2024.01.04
84,Oklahoma Sooner,Jake Banfield,30,19,11,1,0,104300,94500,9800,9893,2024.01.04
85,Sunday Saints,Jordan Davis,20,9,11,1,0,104300,43700,60600,37444,2024.01.04
86,Coal,Dylan Gossett,18,5,13,1,0,101400,35900,65500,4299044,2024.01.04
87,Homesite,Caroline Jones,46,46,0,46,0,99400,99400,0,2238,2024.01.04
87,The Kiss Or The Crash,Nikita Karmen,46,46,0,46,0,99400,99400,0,553,2024.01.04
87,Bad For Me,Kasey Tyndall,46,46,0,46,0,99400,99400,0,2,2024.01.04
90,Amazed,Frontmen,14,14,0,14,0,98800,98800,0,0,2024.01.04
91,The Champion,Carrie Underwood Feat. Ludacris,19,19,0,14,0,96900,96900,0,449937,2024.01.04
92,With You I Am,Cody Johnson,7,1,6,2,0,91900,43600,48300,1568831,2024.01.04
93,Colorado,Florida Georgia Line,16,0,16,2,0,89600,21900,67700,44240,2024.01.04
94,As Far As You Could,Charles Kelley,17,4,13,9,0,89300,63300,26000,6875,2024.01.04
95,Jack And Diet Coke,Redferrin,24,12,12,2,0,85900,47800,38100,1321321,2024.01.04
96,Neon Baby,Annie Bosko,109,18,91,20,0,83400,20800,62600,30623,2024.01.04
97,Nothing Compares To You,Mickey Guyton Feat. Kane Brown,45,6,39,8,0,80000,-5800,85800,455129,2024.01.04
98,Ok Cowboy,Catie Offerman,14,0,14,3,0,65700,-8300,74000,29776,2024.01.04
99,I Need You,Frontmen,14,4,10,2,0,64900,8100,56800,1786,2024.01.04
100,Fake Names,Priscilla Block,21,6,15,1,0,64700,10700,54000,75630,2024.01.04
101,Cowgirls,Morgan Wallen,18,6,12,5,0,60100,23600,36500,5299763,2024.01.04
102,One Bad Habit,Tim McGraw,9,3,6,6,0,59900,46000,13900,33079,2024.01.04
103,Ain'T Got A Worry,Old Dominion,10,-1,11,1,0,57300,400,56900,230758,2024.01.04
104,Wild Ones,Jessie Murph & Jelly Roll,19,2,17,1,0,55800,17900,37900,10927875,2024.01.04
105,That's What I Love About Sunday,Craig Morgan & Gary Levox,9,9,0,9,0,55400,55400,0,18470,2024.01.04
106,Praise You Anywhere,Brandon Lake,15,15,0,1,0,55100,55100,0,1720726,2024.01.04
107,Holy Water,Michael Ray,9,4,5,2,0,53100,21500,31600,202182,2024.01.04
108,No Present LIke The Time,Jay Allen,63,-2,65,12,0,50100,13200,36900,0,2024.01.04
109,Leave Me Again,Kelsea Ballerini,5,5,0,4,0,50000,50000,0,214710,2024.01.04
109,Girl In The Mirror,Megan Moroney,5,5,0,4,0,50000,50000,0,537031,2024.01.04
111,(I Can't Get No) Satisfaction,Dolly Parton,5,5,0,4,0,48900,48900,0,56854,2024.01.04
112,I Believe,Phil Wickham,14,14,0,1,0,47000,47000,0,493578,2024.01.04
113,Trust In God,Elevation Worship,13,13,0,1,0,45000,45000,0,1682586,2024.01.04
114,Good Plans,Red Rocks Worship,14,14,0,1,0,44200,44200,0,466544,2024.01.04
115,Hungover You,Emily Brooke,13,7,6,6,0,44100,26800,17300,569,2024.01.04
116,Make You Mine,Marynn Taylor,14,2,12,7,0,41700,3100,38600,33200,2024.01.04
117,Honest Offering / I Surrender All,CAIN,12,12,0,1,0,40000,40000,0,60683,2024.01.04
118,God Problems,Maverick City Music,12,12,0,1,0,39200,39200,0,781403,2024.01.04
119,Bigger Houses,Dan + Shay,10,10,0,7,0,37700,37700,0,189801,2024.01.04
120,Stop Coming Over,Chris Lane,12,1,11,6,0,37700,2300,35400,26776,2024.01.04
121,So Help Me God,Benjamin William Hastings,12,12,0,1,0,36200,36200,0,22237,2024.01.04
122,There's The Sun,Zach Top,4,-2,6,1,0,36200,-9900,46100,161954,2024.01.04
123,Two Woman Man,Randall Fowler,51,34,17,17,0,36100,24200,11900,187,2024.01.04
124,Good News,Chandler Moore And Todd Galberth,11,11,0,1,0,35500,35500,0,0,2024.01.04
125,Lead On Good Shepherd,Patrick Mayberry,10,10,0,1,0,34800,34800,0,399305,2024.01.04
125,Shelter,Pat Barrett,10,10,0,1,0,34800,34800,0,134256,2024.01.04
127,Tulsa,Elle King,11,1,10,1,0,34600,3000,31600,43695,2024.01.04
128,Count 'Em,Brandon Lake,10,10,0,1,0,34100,34100,0,520156,2024.01.04
129,I've Witnessed It,Passion Feat. Melodie Malone,10,10,0,1,0,33800,33800,0,132640,2024.01.04
130,Praise,"Elevation Worship Feat. Brandon Lake, Chris Brown, & Chandler Moore",12,12,0,1,0,32600,32600,0,1804475,2024.01.04
130,Stay Strong,Danny Gokey,12,12,0,1,0,32600,32600,0,218680,2024.01.04
132,I'M Not For Everyone,Brothers Osborne,6,3,3,3,0,31300,19500,11800,430921,2024.01.04
133,Things I Take For Granted,Larry Fleet,5,3,2,2,0,30400,21200,9200,758897,2024.01.04
134,Heart Attack,Boy Named Banjo,17,7,10,1,0,30300,16900,13400,3249,2024.01.04
135,Sun To Me,Zach Bryan,21,9,12,2,0,28800,10300,18500,4288303,2024.01.04
136,Goodbye Looks Good On You,Alana Springsteen Feat. Mitchell Tenpenny,14,1,13,1,0,28700,-6300,35000,1590706,2024.01.04
137,Heartbreak On The Map,Dan + Shay,8,8,0,7,0,28400,28400,0,70777,2024.01.04
138,I'll Be Here,Colbie Caillat,17,1,16,2,0,28100,10700,17400,473738,2024.01.04
139,Pray All The Way Home,Austin Snell,35,35,0,17,0,27500,27500,0,1006385,2024.01.04
140,West Of Tulsa,Wyatt Flores,10,7,3,2,0,27000,23600,3400,230020,2024.01.04
141,In The Room (Feat. Tasha Cobbs Leonard),Maverick City Music,7,7,0,1,0,26400,26400,0,910758,2024.01.04
142,Way Back When,Wayland,36,24,12,12,0,25400,17200,8200,557,2024.01.04
143,Sunrise,River Valley Ages,7,7,0,1,0,25400,25400,0,25427,2024.01.04
143,People Of Heaven,Phil Wickham & Brandon Lake,7,7,0,1,0,25400,25400,0,82985,2024.01.04
145,Star Spangled Banner,Abby Anderson,6,3,3,5,0,25200,7800,17400,0,2024.01.04
146,Cold Beer & Country Music,Zach Top,4,1,3,1,0,25100,12700,12400,72922,2024.01.04
147,Fall On Me,NEEDTOBREATHE,7,7,0,1,0,24400,24400,0,350091,2024.01.04
148,Always You,Trey Lewis,34,34,0,17,0,24200,24200,0,140842,2024.01.04
149,Silverado,Caleb Lee Hutchinson,34,17,17,17,0,24200,12300,11900,13099,2024.01.04
150,John Deere Green,"HIXTAPE Feat. HARDY, Morgan Wallen, Joe Diffie",2,1,1,2,0,24000,22000,2000,0,2024.01.04
151,Hoops,Alison Nichols,34,34,0,17,0,23800,23800,0,4478,2024.01.04
152,Summer Soundtrack,Craig Campbell,34,17,17,17,0,23800,11900,11900,631,2024.01.04
152,Under A Southern Sky,Ian Flanigan,34,17,17,17,0,23800,11900,11900,722,2024.01.04
152,Tea Was A Little Sweeter,Matt Rogers,34,17,17,17,0,23800,11900,11900,899,2024.01.04
155,You'Ve Already Won (Live),Shane & Shane,6,6,0,1,0,23700,23700,0,494900,2024.01.04
156,Thank You Jesus For The Blood,Charity Gayle,7,7,0,1,0,23300,23300,0,406277,2024.01.04
157,More Like Jesus (Feat. Canaan Baca),One Voice Int Music,7,7,0,1,0,22600,22600,0,110443,2024.01.04
158,Porch Swing Angel,Muscadine Bloodline,3,3,0,1,0,22400,22400,0,1059828,2024.01.04
159,Wild as You,Cody Johnson,3,3,0,2,0,22300,22300,0,1443194,2024.01.04
160,Longneck Way To Go,Midland Feat. Jon Pardi,2,0,2,1,0,21800,2100,19700,135241,2024.01.04
161,Oh But God,Davy Flowers,6,6,0,1,0,21200,21200,0,21907,2024.01.04
162,Heart Of A Small Town,Tim Dugger,5,3,2,1,0,21200,16500,4700,8110,2024.01.04
163,Heartfirst,Kelsea Ballerini,2,2,0,2,0,21100,21100,0,331045,2024.01.04
164,How Far,Tasha Layton,5,5,0,1,0,20900,20900,0,197497,2024.01.04
165,Bless God,Brooke Ligertwood,7,7,0,1,0,19800,19800,0,393372,2024.01.04
166,Crowns Down,Gateway Worship & Josh Baldwin,5,5,0,1,0,19500,19500,0,72845,2024.01.04
166,Jesus Does,We The Kingdom,5,5,0,1,0,19500,19500,0,1221073,2024.01.04
168,The Star-Spangled Banner,Carly Pearce,2,2,0,2,0,19400,19400,0,0,2024.01.04
169,Must Be The Whiskey,Cody Jinks,10,2,8,1,0,19400,-500,19900,1395611,2024.01.04
170,3 Feet Tall,Cole Swindell,4,4,0,1,0,19000,19000,0,366089,2024.01.04
171,God Only Knows,for King & Country,3,2,1,1,0,19000,9800,9200,1001181,2024.01.04
172,"The Father, My Son, And The Holy Ghost",Craig Morgan,3,1,2,1,0,18700,7800,10900,51168,2024.01.04
173,Beer For Santa,Jon Pardi,9,-149,158,8,0,18700,-694700,713400,25256,2024.01.04
174,Polaroid,Keith Urban,6,6,0,6,0,18400,18400,0,10580,2024.01.04
175,Along For The Ride,Jordan Harvey,6,0,6,6,0,18400,-900,19300,14074,2024.01.04
176,Star Spangled Banner,Mickey Guyton,2,1,1,2,0,18200,14200,4000,0,2024.01.04
177,The Great Divide,Luke Combs & Billy Strings,5,-1,6,1,0,17000,4900,12100,196889,2024.01.04
178,My Bar,Priscilla Block,3,2,1,2,0,16500,13100,3400,146828,2024.01.04
179,Stranger In My House,Ronnie Milsap,2,-1,3,1,0,16500,-400,16900,130277,2024.01.04
180,Bits & Pieces,Walker County,5,5,0,5,0,16400,16400,0,2131,2024.01.04
181,The Weight Of The Badge,George Strait,1,1,0,1,0,16400,16400,0,41743,2024.01.04
182,Leave You Alone,Kane Brown,5,5,0,5,0,15900,15900,0,256141,2024.01.04
183,Yes I Will,Vertical Worship,4,4,0,1,0,15700,15700,0,626958,2024.01.04
183,Faithful,Erik Nieder,4,4,0,1,0,15700,15700,0,82992,2024.01.04
183,This Is Our God,Phil Wickham,4,4,0,1,0,15700,15700,0,1103904,2024.01.04
186,Only Jesus,Patrick Mayberry,5,5,0,1,0,15300,15300,0,6311,2024.01.04
187,Whatever Gets You Through It,Morgan Gruber,10,4,6,1,0,15200,6800,8400,269,2024.01.04
188,Ain't That Some,Morgan Wallen,4,3,1,4,0,15200,10600,4600,3338010,2024.01.04
189,Quittin' Time,Zach Bryan,1,1,0,1,0,15100,15100,0,869049,2024.01.04
190,Holy Forever,Chris Tomlin,5,5,0,1,0,14900,14900,0,2032192,2024.01.04
191,Mountain With A View,Kelsea Ballerini,8,3,5,2,0,14800,8200,6600,1015475,2024.01.04
192,For All My Life,Taya,5,5,0,1,0,14600,14600,0,427302,2024.01.04
193,Heartless,Diplo & Julia Michaels Feat. Morgan Wallen,2,0,2,2,0,14600,10000,4600,4494999,2024.01.04
194,Joy In The Morning,Tauren Wells,3,3,0,1,0,14300,14300,0,586987,2024.01.04
195,I Speak Jesus,Charity Gayle,4,4,0,1,0,14200,14200,0,1117075,2024.01.04
196,Outlaws And Mustangs,Cody Jinks,11,0,11,2,0,14200,-2100,16300,198742,2024.01.04
197,"Salt, Lime & Tequila",Ryan Griffin,3,2,1,1,0,14100,13800,300,54322,2024.01.04
198,National Anthem From Battle At Bristol,Jennifer Nettles,2,-1,3,2,0,13900,600,13300,0,2024.01.04
199,That's Why We Fight,Ella Langley & Koe Wetzel,9,4,5,1,0,13700,8800,4900,559645,2024.01.04
200,Loud and Heavy,Cody Jinks,8,3,5,2,0,13500,6800,6700,1460514,2024.01.04
1,World On Fire,Nate Smith,8702,704,7998,143,0,35923900,1881200,34042700,7143304,2024.01.11
2,Save Me,Jelly Roll & Lainey Wilson,6741,-98,6839,141,0,27804800,-1086300,28891100,7486661,2024.01.11
3,Save Me The Trouble,Dan + Shay,6667,-1222,7889,143,0,27605500,-2401300,30006800,4271642,2024.01.11
4,Mind On You,George Birge,6309,-1221,7530,141,0,25393200,-4507200,29900400,1146159,2024.01.11
5,White Horse,Chris Stapleton,6539,494,6045,143,0,24277500,817200,23460300,10592959,2024.01.11
6,Thinkin' Bout Me,Morgan Wallen,5291,-218,5509,140,0,23682000,-1424800,25106800,13382554,2024.01.11
7,Different 'Round Here,Riley Green,5895,325,5570,143,0,21404500,898500,20506000,2989589,2024.01.11
8,Where The Wild Things Are,Luke Combs,5499,754,4745,143,0,20692100,1401300,19290800,5206173,2024.01.11
9,All I Need Is You,Chris Janson,5343,273,5070,143,0,19115800,840400,18275400,612004,2024.01.11
10,Pretty Little Poison,Warren Zeiders,5347,475,4872,140,0,18985000,1234700,17750300,9344682,2024.01.11
11,The Painter,Cody Johnson,4702,515,4187,143,0,18850700,2132500,16718200,6487164,2024.01.11
12,I Can Feel It,Kane Brown,4757,252,4505,143,0,18074500,505300,17569200,4022939,2024.01.11
13,Truck Bed,Hardy,4726,346,4380,141,0,17113800,1641500,15472300,7449712,2024.01.11
14,23,Chayce Beckham,3926,240,3686,143,0,13128000,461900,12666100,4199441,2024.01.11
15,Burn It Down,Parker Mccollum,3642,196,3446,141,0,12851900,499500,12352400,6362191,2024.01.11
16,Creek Will Rise,Conner Smith,3996,308,3688,143,0,12798200,674800,12123400,1069126,2024.01.11
17,Mamaw's House,Thomas Rhett,2713,338,2375,139,0,9746500,1403300,8343200,3294507,2024.01.11
18,Cab In A Solo,Scotty McCreery,2766,206,2560,143,0,8099700,657400,7442300,585463,2024.01.11
19,Fearless,Jackson Dean,2980,388,2592,141,0,8093700,449600,7644100,1466377,2024.01.11
20,Man Made A Bar,Morgan Wallen,2137,310,1827,141,0,8027000,706600,7320400,5062611,2024.01.11
21,We Don'T Fight Anymore,Carly Pearce,2510,215,2295,141,0,7895700,618500,7277200,4716843,2024.01.11
22,Tucson Too Late,Jordan Davis,2491,315,2176,140,0,7843400,640900,7202500,1776892,2024.01.11
23,Wildflowers And Wild Horses,Lainey Wilson,2429,215,2214,141,0,7704900,19600,7685300,2507303,2024.01.11
24,Glory Days,Gabby Barrett,2586,268,2318,141,0,7200300,907900,6292400,2065962,2024.01.11
25,Back Then Right Now,Tyler Hubbard,2187,222,1965,135,0,6015700,532000,5483700,1786369,2024.01.11
26,Nobody's Nobody,Brothers Osborne,2299,123,2176,138,0,5971500,22300,5949200,1161874,2024.01.11
27,Take Her Home,Kenny Chesney,1894,131,1763,141,0,5739200,297100,5442100,893946,2024.01.11
28,I Remember Everything,Zach Bryan Feat. Kacey Musgraves,1671,43,1628,134,0,5510000,165700,5344300,21727518,2024.01.11
29,Out Of That Truck,Carrie Underwood,1932,136,1796,133,0,5492300,261500,5230800,1209870,2024.01.11
30,Your Place,Ashley Cooke,1413,251,1162,111,0,5360400,758400,4602000,1841349,2024.01.11
31,I'M Not Pretty,Megan Moroney,1700,40,1660,138,0,4692600,-183700,4876300,2743114,2024.01.11
32,Let Your Boys Be Country,Jason Aldean,1189,172,1017,94,0,4640100,650100,3990000,1567881,2024.01.11
33,Can't Break Up Now,Old Dominion,1614,194,1420,137,0,4304800,210000,4094800,1754178,2024.01.11
34,Love You Again,Chase Matthew,1646,86,1560,133,0,4052300,48900,4003400,1996911,2024.01.11
35,Outskirts,Sam Hunt,1514,23,1491,133,0,4006600,13600,3993000,2305888,2024.01.11
36,Young Love & Saturday Nights,Chris Young,950,46,904,74,0,3221400,-80500,3301900,556705,2024.01.11
37,Where It Ends,Bailey Zimmerman,1053,61,992,90,0,3123700,115700,3008000,4011362,2024.01.11
38,We Ride,Bryan Martin,945,131,814,72,0,3008900,483900,2525000,3487474,2024.01.11
39,Drinkin' Problems,Dillon Carmichael,1221,64,1157,130,0,2665100,-91700,2756800,73910,2024.01.11
40,Something's Gonna Kill Me,Corey Kent,848,-20,868,74,0,2474700,-185800,2660500,2073962,2024.01.11
41,Cowboys And Plowboys,Jon Pardi Feat. Luke Bryan,851,2,849,95,0,2377500,-72000,2449500,434137,2024.01.11
42,Gonna Love You,Parmalee,878,22,856,75,0,2188900,42200,2146700,279224,2024.01.11
43,Rodeo Man,Garth Brooks & Ronnie Dunn,1025,105,920,122,0,2150700,158800,1991900,1453014,2024.01.11
44,Spirits And Demons,Michael Ray With Meghan Patrick,985,49,936,106,0,2085600,-9800,2095400,192279,2024.01.11
45,Dance With You,Brett Young,773,-24,797,82,0,1633200,-122500,1755700,1074717,2024.01.11
46,Pickup Man (Feat. Post Malone),Hixtape & Joe Diffie,386,56,330,75,0,1352700,140700,1212000,583865,2024.01.11
47,This Is My Dirt,Justin Moore,661,23,638,87,0,1170900,18300,1152600,315076,2024.01.11
48,Chevrolet,Dustin Lynch Feat. Jelly Roll,509,48,461,58,0,1090900,195700,895200,2842181,2024.01.11
49,Find Another Bar,Chris Lane,565,47,518,63,0,1087800,96300,991500,188713,2024.01.11
50,Love You Back,Lady A,600,20,580,84,0,1041300,22800,1018500,230502,2024.01.11
51,Brokenhearted,Joe Nichols,579,86,493,65,0,977000,147300,829700,8363,2024.01.11
52,In Your Love,Tyler Childers,575,61,514,61,0,956500,-51300,1007800,3721431,2024.01.11
53,I'm In Love,Hailey Whitters,431,22,409,64,0,883200,51900,831300,777658,2024.01.11
54,She's Somebody's Daughter,Drew Baldridge,493,8,485,65,0,796700,11900,784800,403814,2024.01.11
55,Long Live Cowgirls,Ian Munsick & Cody Johnson,310,41,269,37,0,745700,-51900,797600,924776,2024.01.11
56,Sounds Like The Radio,Zach Top,275,271,4,56,0,715100,713700,1400,94049,2024.01.11
57,King Of Country Music,Ryan Larkins,319,36,283,55,0,603900,74200,529700,42006,2024.01.11
58,Ain'T About You,Huntergirl,440,-8,448,69,0,550000,-89200,639200,19438,2024.01.11
59,Amy's Back In Austin,Eli Young Band & George Birge,126,126,0,58,0,545600,545600,0,16887,2024.01.11
60,Boys Back Home,Dylan Marlowe Feat. Dylan Scott,265,52,213,40,0,475000,6900,468100,2881321,2024.01.11
61,Halfway To Hell,Jelly Roll,122,43,79,14,0,466800,87200,379600,1647976,2024.01.11
62,Breakin' In Boots,Matt Stell,353,52,301,56,0,455200,45200,410000,532446,2024.01.11
63,Make Me Wanna Smoke,Runaway June,307,10,297,37,0,437800,-93000,530800,13031,2024.01.11
64,Dirt Cheap,Cody Johnson,43,4,39,5,0,422700,-28300,451000,2632761,2024.01.11
65,Wine Country,Hannah Ellis,235,-52,287,34,0,404100,-50400,454500,43762,2024.01.11
66,Thicc As Thieves,Lauren Alaina,267,1,266,39,0,403600,-54200,457800,918258,2024.01.11
67,Heart They Didn'T Break,Maddie & Tae,245,19,226,30,0,358900,42400,316500,894882,2024.01.11
68,Cancelled,Randy Houser,329,5,324,42,0,357800,-128500,486300,0,2024.01.11
68,Cancel,Randy Houser,329,5,324,42,0,357800,-128500,486300,71102,2024.01.11
70,This Side Of The Dirt,Neon Union,299,43,256,40,0,355900,-47500,403400,21182,2024.01.11
71,Rain In The Rearview,Anne Wilson,250,9,241,36,0,320900,25400,295500,766943,2024.01.11
72,Cowboy Songs,George Birge,74,74,0,37,0,259800,259800,0,0,2024.01.11
73,Wondering Why,Red Clay Strays,24,6,18,2,0,255700,2300,253400,5387013,2024.01.11
74,How Is She,Cole Swindell,31,2,29,1,0,205400,16800,188600,48766,2024.01.11
75,Trouble,Josh Ross,137,-35,172,37,0,197800,-75600,273400,1947267,2024.01.11
76,That's Texas,Cody Johnson,23,-4,27,2,0,182900,-94800,277700,397126,2024.01.11
77,Without You,Thompson Square,32,-1,33,4,0,163800,-45200,209000,5637,2024.01.11
78,Mama He's Crazy,Lainey Wilson & Dolly Parton,17,17,0,17,0,160600,160600,0,267755,2024.01.11
79,Oklahoma Sooner,Jake Banfield,30,0,30,1,0,132800,28500,104300,6114,2024.01.11
80,Million Little Bandaids,Caroline Jones,168,17,151,24,0,128700,-43600,172300,49228,2024.01.11
81,Sarah's Place,Zach Bryan,16,-1,17,1,0,127000,-14000,141000,3429446,2024.01.11
82,Colorado,Florida Georgia Line,17,1,16,2,0,100200,10600,89600,45612,2024.01.11
83,Sunday Saints,Jordan Davis,16,-4,20,1,0,94900,-9400,104300,31097,2024.01.11
84,Making It Up As I Go,Kylie Morgan,47,47,0,47,0,93600,93600,0,40025,2024.01.11
84,Underestimate Me,Maggie Rose,47,47,0,47,0,93600,93600,0,7939,2024.01.11
84,Talk Of The Town,Abbey Cone,47,47,0,47,0,93600,93600,0,11033,2024.01.11
87,Neon Baby,Annie Bosko,118,9,109,23,0,87300,3900,83400,36845,2024.01.11
88,Jack And Diet Coke,Redferrin,26,2,24,2,0,82700,-3200,85900,1157438,2024.01.11
89,Fake Names,Priscilla Block,23,2,21,1,0,81000,16300,64700,83252,2024.01.11
90,Ok Cowboy,Catie Offerman,13,-1,14,2,0,80400,14700,65700,32884,2024.01.11
91,3 Feet Tall,Cole Swindell,14,10,4,1,0,79500,60500,19000,365260,2024.01.11
92,With You I Am,Cody Johnson,8,1,7,2,0,76600,-15300,91900,1600651,2024.01.11
93,West Of Tulsa,Wyatt Flores,20,10,10,2,0,75500,48500,27000,235052,2024.01.11
94,I Need You,Frontmen,16,2,14,2,0,65000,100,64900,2614,2024.01.11
95,Coal,Dylan Gossett,18,0,18,1,0,59200,-42200,101400,4988136,2024.01.11
96,"'Beer Beer, Truck Truck'",George Birge,9,9,0,9,0,54800,54800,0,31958,2024.01.11
96,If That Ain'T God,Chris Young,9,9,0,9,0,54800,54800,0,21515,2024.01.11
98,Jesus Got A Tight Grip,Blake Shelton,9,9,0,9,0,54400,54400,0,10631,2024.01.11
99,Pray All The Way Home,Austin Snell,69,34,35,17,0,51800,24300,27500,1015660,2024.01.11
100,Cowgirls,Morgan Wallen,18,0,18,5,0,51400,-8700,60100,5394132,2024.01.11
101,Open The Gate,Zach Bryan,5,4,1,1,0,48700,44600,4100,988507,2024.01.11
102,No Present LIke The Time,Jay Allen,75,12,63,12,0,47800,-2300,50100,0,2024.01.11
103,Ain't Missin' You,Dylan Schneider,86,-94,180,19,0,43700,-144500,188200,996289,2024.01.11
104,The Star-Spangled Banner,Chris Stapleton,12,-40,52,11,0,43200,-144600,187800,81199,2024.01.11
105,One Bad Habit,Tim McGraw,12,3,9,6,0,43100,-16800,59900,28239,2024.01.11
106,Holy Water,Michael Ray,7,-2,9,2,0,41600,-11500,53100,203771,2024.01.11
107,Tulsa,Elle King,12,1,11,1,0,40200,5600,34600,44868,2024.01.11
108,Black Magic,Rachel Lipsky,51,34,17,17,0,36900,25000,11900,60,2024.01.11
109,Hoops,Alison Nichols,51,17,34,17,0,36900,13100,23800,4109,2024.01.11
110,Always You,Trey Lewis,51,17,34,17,0,36900,12700,24200,156356,2024.01.11
110,Silverado,Caleb Lee Hutchinson,51,17,34,17,0,36900,12700,24200,13539,2024.01.11
112,Two Woman Man,Randall Fowler,51,0,51,17,0,36900,800,36100,295,2024.01.11
113,Just Drive,Erin Kinsey,12,12,0,6,0,36800,36800,0,81519,2024.01.11
114,Make You Mine,Marynn Taylor,12,-2,14,6,0,36800,-4900,41700,26076,2024.01.11
115,But A Beer Can,Eric Burgett,50,33,17,17,0,35400,23500,11900,4695,2024.01.11
116,Give Me A Sunrise,Braxton Keith,5,2,3,1,0,32000,25500,6500,24396,2024.01.11
117,Porch Swing Angel,Muscadine Bloodline,3,0,3,1,0,30800,8400,22400,1030801,2024.01.11
118,Outlaws And Mustangs,Cody Jinks,15,4,11,2,0,30500,16300,14200,210612,2024.01.11
119,We Ain't The Only Ones,Randy Rogers & Wade Bowen,2,2,0,1,0,30200,30200,0,0,2024.01.11
120,Hungover You,Emily Brooke,10,-3,13,6,0,27400,-16700,44100,602,2024.01.11
121,Bigger Houses,Dan + Shay,12,2,10,5,0,24700,-13000,37700,287940,2024.01.11
122,She's Gotta Know,Conner Sweet,34,17,17,17,0,24600,12700,11900,1020,2024.01.11
123,Quittin' Time,Zach Bryan,3,2,1,1,0,23300,8200,15100,856706,2024.01.11
124,Goodbye Looks Good On You,Alana Springsteen Feat. Mitchell Tenpenny,16,2,14,1,0,22900,-5800,28700,1266375,2024.01.11
125,I'll Be Here,Colbie Caillat,17,0,17,1,0,22600,-5500,28100,534572,2024.01.11
126,Must Be The Whiskey,Cody Jinks,6,-4,10,2,0,22600,3200,19400,1270295,2024.01.11
127,The Star-Spangled Banner,Carly Pearce,3,1,2,3,0,21800,2400,19400,0,2024.01.11
128,Ain'T She,Adam Doleac,4,4,0,1,0,21600,21600,0,459786,2024.01.11
129,Heart Attack,Boy Named Banjo,15,-2,17,1,0,21500,-8800,30300,3302,2024.01.11
130,I'M Not Blonde,Meredith Foster,13,4,9,1,0,20300,8900,11400,28,2024.01.11
131,I Found You,Nate Smith,6,6,0,6,0,18400,18400,0,291458,2024.01.11
131,When Will I Be Loved,"Ashley McBryde, Caylee Hammack & Pillbox Patti",6,6,0,6,0,18400,18400,0,26881,2024.01.11
131,Outrunnin' Your Memory,Luke Combs & Miranda Lambert,6,6,0,6,0,18400,18400,0,387453,2024.01.11
131,House On Fire,Bailey Zimmerman,6,6,0,6,0,18400,18400,0,995797,2024.01.11
135,Life With You,Kelsey Hart,46,28,18,10,0,18300,6400,11900,1460713,2024.01.11
136,I Tried A Ring On,Tigirlily Gold,5,5,0,3,0,18300,18300,0,524697,2024.01.11
137,Loud and Heavy,Cody Jinks,10,2,8,2,0,17800,4300,13500,1466171,2024.01.11
138,Star Spangled Banner,Abby Anderson,3,-3,6,2,0,17700,-7500,25200,0,2024.01.11
139,Sun To Me,Zach Bryan,14,-7,21,3,0,17700,-11100,28800,4411542,2024.01.11
140,That's Why We Fight,Ella Langley & Koe Wetzel,13,4,9,1,0,17600,3900,13700,568978,2024.01.11
141,Loser,Mike Ryan,2,2,0,2,0,17600,17600,0,18518,2024.01.11
142,A Little Bit Closer,Braxton Keith,5,1,4,1,0,17500,13900,3600,59089,2024.01.11
143,Way Back When,Wayland,24,-12,36,12,0,17200,-8200,25400,659,2024.01.11
144,Any Old Iron,Sherlocks,5,5,0,1,0,16900,16900,0,0,2024.01.11
145,Long Haul,Ian Munsick,3,2,1,3,0,16900,11500,5400,374232,2024.01.11
146,Last Rodeo,Restless Road,2,1,1,2,0,16400,12700,3700,1784302,2024.01.11
147,Codigo,George Strait,1,0,1,1,0,16400,16400,0,24478,2024.01.11
148,Any Given Friday Night,Luke Combs,2,0,2,1,0,15200,1800,13400,175768,2024.01.11
149,Me On You,Muscadine Bloodline,1,1,0,1,0,15100,15100,0,730536,2024.01.11
149,Baby Do,Randall King,1,1,0,1,0,15100,15100,0,22058,2024.01.11
149,Damn This Heart Of Mine,William Beckmann,1,1,0,1,0,15100,15100,0,5527,2024.01.11
149,Little Rain,Morgan Wallen,1,1,0,1,0,15100,15100,0,469144,2024.01.11
153,"Houston, We Got A Problem",Luke Combs,7,1,6,1,0,14500,1900,12600,1020476,2024.01.11
154,Playboys,Midland,1,1,0,1,0,14300,14300,0,63598,2024.01.11
155,Cowboy Forever,Carter Faith,8,1,7,1,0,13900,5700,8200,30562,2024.01.11
156,Nothing Compares To You,Mickey Guyton Feat. Kane Brown,26,-19,45,7,0,13800,-66200,80000,407561,2024.01.11
157,'98 Braves,Morgan Wallen,4,0,4,4,0,13700,900,12800,2086960,2024.01.11
158,National Anthem From Battle At Bristol,Jennifer Nettles,3,1,2,3,0,13600,-300,13900,0,2024.01.11
159,I GOT AWAY WITH YOU,Luke Combs,6,6,0,1,0,13400,13400,0,297493,2024.01.11
160,Star Spangled Banner,Mickey Guyton,2,0,2,2,0,13300,-4900,18200,0,2024.01.11
161,Sayin' What I'm Thinkin',Lainey Wilson,7,6,1,1,0,12800,9800,3000,164303,2024.01.11
162,"Thankful, So Thankful",Triumphant Quartet,2,1,1,2,0,12700,12300,400,0,2024.01.11
163,Think About There,Greater Vision,2,0,2,2,0,12700,4700,8000,18274,2024.01.11
164,No Yesterday,Jeremy McComb,6,0,6,1,0,12200,1500,10700,263,2024.01.11
165,Wild as You,Cody Johnson,5,2,3,1,0,11900,-10400,22300,1501091,2024.01.11
166,Fake Id,Sydney Mack,7,2,5,1,0,11100,2000,9100,649,2024.01.11
167,What Are You Listening To?,Megan Moroney,2,2,0,2,0,10800,10800,0,0,2024.01.11
168,Honky Tonk Heartbreaker,Dustin Lynch,2,1,1,1,0,10800,5400,5400,51419,2024.01.11
169,Longneck Way To Go,Midland Feat. Jon Pardi,2,0,2,1,0,10800,-11000,21800,125777,2024.01.11
170,Holy Roller,Zach Bryan,9,1,8,1,0,10600,1700,8900,1302667,2024.01.11
171,Raise The Roof,Christian Beck,7,1,6,1,0,9800,1200,8600,129,2024.01.11
172,The Weight Of The Badge,George Strait,2,1,1,2,0,9600,-6800,16400,44340,2024.01.11
173,The Great Divide,Luke Combs & Billy Strings,5,0,5,1,0,9500,-7500,17000,196392,2024.01.11
174,Days That End In Why,Morgan Wallen,5,-2,7,1,0,9500,-500,10000,915210,2024.01.11
175,Wild,Carter Faith,6,-3,9,1,0,9400,-800,10200,118274,2024.01.11
176,Holy Smoke,Frank Vieira,10,0,10,1,0,9300,2200,7100,160,2024.01.11
177,Saltwater Gospel,Eli Young Band & Jimmy Buffett,4,1,3,1,0,8800,3800,5000,81532,2024.01.11
178,Decoration,Jillian Riscoe,5,-1,6,1,0,8800,6400,2400,12,2024.01.11
179,Whatever Gets You Through It,Morgan Gruber,6,-4,10,1,0,8800,-6400,15200,276,2024.01.11
180,Whatcha Looking At,Curves,12,12,0,12,0,8600,8600,0,267,2024.01.11
181,Oklahoma Smokeshow,Zach Bryan,7,-1,8,1,0,8500,500,8000,6051414,2024.01.11
182,I Know It’ll Never End,Castellows,1,1,0,1,0,8300,8300,0,832652,2024.01.11
182,Ain'T The One,Josh Ross,1,1,0,1,0,8300,8300,0,106122,2024.01.11
184,That Ain'T Country,Aaron Lewis,7,-2,9,1,0,8300,-2100,10400,100132,2024.01.11
185,Heart To Break,Ryan Griffin,19,0,19,1,0,8000,-200,8200,109294,2024.01.11
186,"Jesus, Won't You Come By Here",Hank Williams Jr.,1,1,0,1,0,7800,7800,0,4776,2024.01.11
186,Still,Riley Harrison Clark,1,1,0,1,0,7800,7800,0,23,2024.01.11
186,I Surrender All,Carrie Underwood,1,1,0,1,0,7800,7800,0,29404,2024.01.11
186,Way Home,Tyler Hubbard,1,1,0,1,0,7800,7800,0,61733,2024.01.11
190,Star Spangled Banner,Demi Lovato,1,0,1,1,0,7800,-1600,9400,76,2024.01.11
191,My Bar,Priscilla Block,2,-1,3,2,0,7800,-8700,16500,149248,2024.01.11
192,Take You With Me,Luke Combs,1,1,0,1,0,7700,7700,0,341889,2024.01.11
193,I'Ve Seen Me Do It,Joe Peters,1,0,1,1,0,7700,1500,6200,286,2024.01.11
194,Giving You Up,Kameron Marlowe,4,4,0,2,0,7600,7600,0,804964,2024.01.11
195,I'M Not For Everyone,Brothers Osborne,3,-3,6,3,0,7600,-23700,31300,423368,2024.01.11
196,I Deserve A Drink,Morgan Wallen,2,1,1,2,0,7300,1900,5400,1453724,2024.01.11
197,Wild Ones,Jessie Murph & Jelly Roll,3,-16,19,1,0,7300,-48500,55800,11201919,2024.01.11
198,Raised Up,Nate Smith,2,2,0,1,0,7100,7100,0,52041,2024.01.11
199,Heartbreak On The Map,Dan + Shay,2,-6,8,1,0,7100,-21300,28400,72045,2024.01.11
200,Don'T Close Your Eyes,Dylan Scott,1,1,0,1,0,7000,7000,0,22761,2024.01.11
1,World On Fire,Nate Smith,8631,-71,8702,142,0,35502400,-421500,35923900,6570818,2024.01.18
2,Save Me,Jelly Roll & Lainey Wilson,6553,-188,6741,140,0,26901800,-903000,27804800,6936339,2024.01.18
3,White Horse,Chris Stapleton,7045,506,6539,142,0,26576400,2298900,24277500,9808120,2024.01.18
4,Thinkin' Bout Me,Morgan Wallen,5226,-65,5291,138,0,23365400,-316600,23682000,13363051,2024.01.18
5,Different 'Round Here,Riley Green,6275,380,5895,142,0,22778400,1373900,21404500,2975330,2024.01.18
6,Save Me The Trouble,Dan + Shay,5011,-1656,6667,139,0,22450000,-5155500,27605500,2319016,2024.01.18
7,Where The Wild Things Are,Luke Combs,5807,308,5499,142,0,21646600,954500,20692100,5954305,2024.01.18
8,The Painter,Cody Johnson,5257,555,4702,142,0,20652600,1801900,18850700,5564614,2024.01.18
9,Pretty Little Poison,Warren Zeiders,5793,446,5347,139,0,20591200,1606200,18985000,8778686,2024.01.18
10,All I Need Is You,Chris Janson,5452,109,5343,142,0,19814800,699000,19115800,544118,2024.01.18
11,I Can Feel It,Kane Brown,4929,172,4757,142,0,18579700,505200,18074500,3310457,2024.01.18
12,Truck Bed,Hardy,4982,256,4726,141,0,18381700,1267900,17113800,7290414,2024.01.18
13,23,Chayce Beckham,4060,134,3926,142,0,13855700,727700,13128000,4031272,2024.01.18
14,Burn It Down,Parker Mccollum,3821,179,3642,140,0,13672800,820900,12851900,6167279,2024.01.18
15,Creek Will Rise,Conner Smith,3949,-47,3996,142,0,13214000,415800,12798200,1033462,2024.01.18
16,Mamaw's House,Thomas Rhett,3149,436,2713,138,0,11860900,2114400,9746500,3082458,2024.01.18
17,Man Made A Bar,Morgan Wallen,2422,285,2137,140,0,9277700,1250700,8027000,5390496,2024.01.18
18,Cab In A Solo,Scotty McCreery,2938,172,2766,142,0,9035800,936100,8099700,558991,2024.01.18
19,Wildflowers And Wild Horses,Lainey Wilson,2687,258,2429,141,0,8750800,1045900,7704900,2723799,2024.01.18
20,Tucson Too Late,Jordan Davis,2677,186,2491,140,0,8310100,466700,7843400,1739059,2024.01.18
21,We Don'T Fight Anymore,Carly Pearce,2606,96,2510,140,0,8203600,307900,7895700,4521245,2024.01.18
22,Fearless,Jackson Dean,2989,9,2980,140,0,8123600,29900,8093700,1854861,2024.01.18
23,Glory Days,Gabby Barrett,2739,153,2586,140,0,7644300,444000,7200300,1555350,2024.01.18
24,Back Then Right Now,Tyler Hubbard,2269,82,2187,139,0,6673300,657600,6015700,1599728,2024.01.18
25,Take Her Home,Kenny Chesney,2086,192,1894,142,0,6315900,576700,5739200,858817,2024.01.18
26,I Remember Everything,Zach Bryan Feat. Kacey Musgraves,1855,184,1671,133,0,6018900,508900,5510000,20876184,2024.01.18
27,Your Place,Ashley Cooke,1547,134,1413,118,0,5721700,361300,5360400,1353984,2024.01.18
28,Out Of That Truck,Carrie Underwood,1957,25,1932,131,0,5522500,30200,5492300,1135812,2024.01.18
29,Let Your Boys Be Country,Jason Aldean,1255,66,1189,101,0,4920900,280800,4640100,1511839,2024.01.18
30,I'M Not Pretty,Megan Moroney,1714,14,1700,136,0,4828700,136100,4692600,2437967,2024.01.18
31,Outskirts,Sam Hunt,1498,-16,1514,128,0,4394600,388000,4006600,2016531,2024.01.18
32,Can't Break Up Now,Old Dominion,1629,15,1614,138,0,4141600,-163200,4304800,1399611,2024.01.18
33,Love You Again,Chase Matthew,1505,-141,1646,127,0,3683100,-369200,4052300,1933784,2024.01.18
34,Where It Ends,Bailey Zimmerman,1106,53,1053,95,0,3485600,361900,3123700,3858657,2024.01.18
35,Young Love & Saturday Nights,Chris Young,997,47,950,83,0,3334800,113400,3221400,997068,2024.01.18
36,We Ride,Bryan Martin,986,41,945,72,0,3221700,212800,3008900,3419603,2024.01.18
37,Drinkin' Problems,Dillon Carmichael,1195,-26,1221,128,0,2480700,-184400,2665100,70060,2024.01.18
38,Cowboys And Plowboys,Jon Pardi Feat. Luke Bryan,915,64,851,98,0,2467200,89700,2377500,398827,2024.01.18
39,Spirits And Demons,Michael Ray With Meghan Patrick,956,-29,985,100,0,2346100,260500,2085600,179270,2024.01.18
40,Something's Gonna Kill Me,Corey Kent,834,-14,848,71,0,2311800,-162900,2474700,1945096,2024.01.18
41,Gonna Love You,Parmalee,855,-23,878,76,0,2116400,-72500,2188900,279169,2024.01.18
42,Rodeo Man,Garth Brooks & Ronnie Dunn,1053,28,1025,135,0,2102300,-48400,2150700,1218667,2024.01.18
43,Dance With You,Brett Young,802,29,773,79,0,1737200,104000,1633200,1756956,2024.01.18
44,Pickup Man (Feat. Post Malone),Hixtape & Joe Diffie,333,-53,386,64,0,1314100,-38600,1352700,563353,2024.01.18
45,This Is My Dirt,Justin Moore,681,20,661,92,0,1311200,140300,1170900,320701,2024.01.18
46,Sounds Like The Radio,Zach Top,503,228,275,77,0,1310800,595700,715100,249048,2024.01.18
47,Love You Back,Lady A,615,15,600,87,0,1157500,116200,1041300,238070,2024.01.18
48,Find Another Bar,Chris Lane,567,2,565,65,0,1149100,61300,1087800,205469,2024.01.18
49,Chevrolet,Dustin Lynch Feat. Jelly Roll,532,23,509,59,0,1148100,57200,1090900,2283793,2024.01.18
50,In Your Love,Tyler Childers,576,1,575,62,0,1078300,121800,956500,3673422,2024.01.18
51,Halfway To Hell,Jelly Roll,268,146,122,40,0,900000,433200,466800,2471800,2024.01.18
52,I'm In Love,Hailey Whitters,425,-6,431,58,0,872500,-10700,883200,849853,2024.01.18
53,Brokenhearted,Joe Nichols,558,-21,579,63,0,852100,-124900,977000,8117,2024.01.18
54,She's Somebody's Daughter,Drew Baldridge,467,-26,493,65,0,714800,-81900,796700,403719,2024.01.18
55,Ain'T About You,Huntergirl,462,22,440,69,0,654600,104600,550000,19324,2024.01.18
56,Long Live Cowgirls,Ian Munsick & Cody Johnson,305,-5,310,35,0,635000,-110700,745700,817343,2024.01.18
57,Breakin' In Boots,Matt Stell,416,63,353,59,0,632700,177500,455200,561745,2024.01.18
58,Dirt Cheap,Cody Johnson,81,38,43,15,0,600400,177700,422700,2375888,2024.01.18
59,Boys Back Home,Dylan Marlowe Feat. Dylan Scott,332,67,265,50,0,570600,95600,475000,2836030,2024.01.18
60,King Of Country Music,Ryan Larkins,300,-19,319,47,0,478400,-125500,603900,34602,2024.01.18
61,Make Me Wanna Smoke,Runaway June,308,1,307,36,0,440500,2700,437800,13196,2024.01.18
62,Ok Cowboy,Catie Offerman,68,55,13,55,0,397600,317200,80400,22458,2024.01.18
63,This Side Of The Dirt,Neon Union,306,7,299,40,0,347400,-8500,355900,24455,2024.01.18
64,Thicc As Thieves,Lauren Alaina,233,-34,267,38,0,313900,-89700,403600,882478,2024.01.18
65,Cancel,Randy Houser,297,-32,329,41,0,311300,-46500,357800,66071,2024.01.18
66,Heart They Didn'T Break,Maddie & Tae,215,-30,245,28,0,306100,-52800,358900,791520,2024.01.18
67,Wondering Why,Red Clay Strays,23,-1,24,1,0,273100,17400,255700,5516075,2024.01.18
68,Wine Country,Hannah Ellis,133,-102,235,23,0,265300,-138800,404100,37844,2024.01.18
69,Rain In The Rearview,Anne Wilson,216,-34,250,28,0,224000,-96900,320900,708281,2024.01.18
70,That's Texas,Cody Johnson,26,3,23,1,0,208600,25700,182900,358421,2024.01.18
71,One Bad Habit,Tim McGraw,84,72,12,12,0,189500,146400,43100,26102,2024.01.18
72,Chasing Cars,Nate Smith,47,47,0,46,0,188300,188300,0,66393,2024.01.18
73,Heart Shaped Box,Nate Smith,44,44,0,44,0,183100,183100,0,0,2024.01.18
74,How Is She,Cole Swindell,29,-2,31,1,0,180600,-24800,205400,45331,2024.01.18
75,Neon Baby,Annie Bosko,126,8,118,22,0,162600,75300,87300,34302,2024.01.18
76,Sarah's Place,Zach Bryan,17,1,16,1,0,133000,6000,127000,3123240,2024.01.18
77,Million Little Bandaids,Caroline Jones,162,-6,168,23,0,126700,-2000,128700,47964,2024.01.18
78,Jack And Diet Coke,Redferrin,43,17,26,12,0,124500,41800,82700,1175272,2024.01.18
79,Colorado,Florida Georgia Line,19,2,17,2,0,110400,10200,100200,45004,2024.01.18
80,Without You,Thompson Square,28,-4,32,4,0,103700,-60100,163800,5134,2024.01.18
81,Any Old Iron,Sherlocks,32,27,5,1,0,96400,79500,16900,0,2024.01.18
82,That Dog,Caylee Hammack,48,48,0,48,0,95700,95700,0,3854,2024.01.18
82,Wide Open,Colbie Caillat,48,48,0,48,0,95700,95700,0,88240,2024.01.18
82,Heartless,Camille Parker,48,48,0,48,0,95700,95700,0,9525,2024.01.18
85,3 Feet Tall,Cole Swindell,14,0,14,1,0,89500,10000,79500,361459,2024.01.18
86,West Of Tulsa,Wyatt Flores,20,0,20,2,0,85900,10400,75500,224542,2024.01.18
87,Forever Bound,12/Oc,31,31,0,1,0,83100,83100,0,3869,2024.01.18
88,I Tried A Ring On,Tigirlily Gold,30,25,5,5,0,81200,62900,18300,353271,2024.01.18
89,Holy Water,Michael Ray,9,2,7,1,0,65900,24300,41600,204532,2024.01.18
90,Fake Names,Priscilla Block,21,-2,23,1,0,65800,-15200,81000,73749,2024.01.18
91,Trouble,Josh Ross,73,-64,137,11,0,63100,-134700,197800,2054451,2024.01.18
92,The Star-Spangled Banner,Chris Stapleton,11,-1,12,11,0,61700,18500,43200,87579,2024.01.18
93,Coal,Dylan Gossett,17,-1,18,1,0,58600,-600,59200,4966669,2024.01.18
94,Life With You,Kelsey Hart,108,62,46,16,0,50900,32600,18300,1598202,2024.01.18
95,Up In Texas,Midland,5,4,1,1,0,50000,47500,2500,387131,2024.01.18
96,Two Woman Man,Randall Fowler,68,17,51,17,0,49200,12300,36900,339,2024.01.18
97,Pray All The Way Home,Austin Snell,68,-1,69,17,0,49200,-2600,51800,975886,2024.01.18
98,Tulsa,Elle King,12,0,12,1,0,47400,7200,40200,39813,2024.01.18
99,Narcissist,Avery Anna,7,7,0,1,0,46500,46500,0,562627,2024.01.18
100,With You I Am,Cody Johnson,6,-2,8,2,0,45900,-30700,76600,1469753,2024.01.18
101,Tennessee Numbers,Morgan Wallen,14,14,0,14,0,45000,45000,0,754271,2024.01.18
102,I Need You,Frontmen,13,-3,16,2,0,42600,-22400,65000,1834,2024.01.18
103,Hoops,Alison Nichols,52,1,51,18,0,40600,3700,36900,4058,2024.01.18
104,Leave You Alone,Kane Brown,10,10,0,6,0,37700,37700,0,281207,2024.01.18
105,A Cowboy Who Would,Chancey Williams,51,21,30,17,0,36900,11300,25600,39044,2024.01.18
106,Black Magic,Rachel Lipsky,51,0,51,17,0,36900,0,36900,65,2024.01.18
107,Just Drive,Erin Kinsey,12,0,12,6,0,36800,0,36800,74378,2024.01.18
108,Always You,Trey Lewis,50,-1,51,17,0,36400,-500,36900,134286,2024.01.18
109,Cowgirls,Morgan Wallen,15,-3,18,3,0,34600,-16800,51400,5332556,2024.01.18
110,Ain'T She,Adam Doleac,7,3,4,1,0,34100,12500,21600,487331,2024.01.18
111,Bigger Houses,Dan + Shay,11,-1,12,6,0,33400,8700,24700,230596,2024.01.18
112,Star Spangled Banner,Abby Anderson,6,3,3,6,0,32100,14400,17700,0,2024.01.18
113,Oklahoma Sooner,Jake Banfield,15,-15,30,1,0,29800,-103000,132800,4919,2024.01.18
114,I Like Big Trucks,Alli Walker,9,9,0,1,0,29600,29600,0,0,2024.01.18
115,Must Be The Whiskey,Cody Jinks,9,3,6,3,0,29100,6500,22600,1128056,2024.01.18
116,No Present LIke The Time,Jay Allen,69,-6,75,11,0,29100,-18700,47800,0,2024.01.18
117,Goodbye Looks Good On You,Alana Springsteen Feat. Mitchell Tenpenny,16,0,16,1,0,28200,5300,22900,1133080,2024.01.18
118,Oklahoma Smokeshow,Zach Bryan,5,-2,7,2,0,27500,19000,8500,5852325,2024.01.18
119,25-8,Larry Fleet,7,7,0,1,0,26200,26200,0,117561,2024.01.18
120,Way Back When,Wayland,36,12,24,12,0,25800,8600,17200,609,2024.01.18
121,Things I Take For Granted,Larry Fleet,6,6,0,3,0,25000,25000,0,1267365,2024.01.18
122,She's Gotta Know,Conner Sweet,34,0,34,17,0,24600,0,24600,679,2024.01.18
123,But A Beer Can,Eric Burgett,34,-16,50,17,0,24600,-10800,35400,4363,2024.01.18
124,Silverado,Caleb Lee Hutchinson,34,-17,51,17,0,24600,-12300,36900,17992,2024.01.18
125,National Anthem From Battle At Bristol,Jennifer Nettles,4,1,3,4,0,23700,10100,13600,0,2024.01.18
126,Takin' Turns,Eamon Owen,32,32,0,16,0,23400,23400,0,0,2024.01.18
127,Heart Attack,Boy Named Banjo,16,1,15,1,0,22600,1100,21500,2959,2024.01.18
128,That's Why We Fight,Ella Langley & Koe Wetzel,12,-1,13,1,0,21900,4300,17600,514365,2024.01.18
129,Goin' Crazy,Catie Offerman,3,3,0,3,0,21200,21200,0,0,2024.01.18
130,Ours,Taylor Swift,3,1,2,2,0,20600,14000,6600,111044,2024.01.18
131,Sun To Me,Zach Bryan,15,1,14,2,0,20600,2900,17700,4307400,2024.01.18
132,Star Spangled Banner,Maren Morris,3,3,0,3,0,20300,20300,0,0,2024.01.18
133,The Star Spangled Banner,Locash,1,1,0,1,0,19500,19500,0,0,2024.01.18
134,Drinkin' It Wrong,Adam Doleac,6,6,0,6,0,18400,18400,0,7658,2024.01.18
134,Almost Home,Craig Morgan And Jelly Roll,6,6,0,6,0,18400,18400,0,676708,2024.01.18
134,Raise The Bar,Craig Morgan & Luke Combs,6,6,0,6,0,18400,18400,0,160113,2024.01.18
134,Redneck Yacht Club,Craig Morgan & Blake Shelton,6,6,0,6,0,18400,18400,0,14581,2024.01.18
134,That's What I Love About Sunday,Craig Morgan & Gary Levox,6,6,0,6,0,18400,18400,0,14205,2024.01.18
139,"Trucks, Ducks, Bucks & Beer",Brian Kelley,3,3,0,3,0,18400,18400,0,396444,2024.01.18
140,When Will I Be Loved,"Ashley McBryde, Caylee Hammack & Pillbox Patti",6,0,6,6,0,18400,0,18400,25113,2024.01.18
141,"'Beer Beer, Truck Truck'",George Birge,6,-3,9,6,0,18400,-36400,54800,31559,2024.01.18
142,Make You Mine,Marynn Taylor,6,-6,12,6,0,18400,-18400,36800,46341,2024.01.18
143,You In A Honky Tonk,Randall King,2,2,0,2,0,18300,18300,0,294325,2024.01.18
144,Love Can Build A Bridge,"Jelly Roll, K. Michelle & The Fisk Jubilee Singers",1,1,0,1,0,18200,18200,0,44655,2024.01.18
145,I'M Not Blonde,Meredith Foster,12,-1,13,1,0,17800,-2500,20300,70,2024.01.18
146,If I Had A Bar,Jon Wolfe,2,1,1,2,0,17600,15100,2500,8683,2024.01.18
147,Outlaws And Mustangs,Cody Jinks,15,0,15,3,0,17000,-13500,30500,216848,2024.01.18
148,Codigo,George Strait,1,0,1,1,0,16400,0,16400,24147,2024.01.18
149,Any Given Friday Night,Luke Combs,2,0,2,1,0,15200,0,15200,164470,2024.01.18
150,A Life Where We Work Out,Flatland Cavalry,1,1,0,1,0,15100,15100,0,1080495,2024.01.18
150,Honky Tonk Hardwood Floors,Cody Johnson,1,1,0,1,0,15100,15100,0,90886,2024.01.18
152,We Ain't The Only Ones,Randy Rogers & Wade Bowen,1,-1,2,1,0,15100,-15100,30200,0,2024.01.18
153,Quittin' Time,Zach Bryan,1,-2,3,1,0,15100,-8200,23300,803243,2024.01.18
154,Porch Swing Angel,Muscadine Bloodline,1,-2,3,1,0,15100,-15700,30800,1020397,2024.01.18
155,Star Spangled Banner,Marlana Vanhoose,2,1,1,2,0,14100,7400,6700,0,2024.01.18
156,Let's Go Fishing,Aaron Lewis,4,4,0,2,0,13800,13800,0,0,2024.01.18
157,The Great Divide,Luke Combs & Billy Strings,5,0,5,1,0,13300,3800,9500,169903,2024.01.18
158,Stop Coming Over,Chris Lane,6,6,0,6,0,13200,13200,0,24844,2024.01.18
159,Broadway Girls,Lil Durk Feat. Morgan Wallen,3,2,1,1,0,12900,10200,2700,3508373,2024.01.18
160,Turn Your Back,Justified Quartet,2,1,1,1,0,12800,6400,6400,67,2024.01.18
161,Sayin' What I'm Thinkin',Lainey Wilson,7,0,7,1,0,12800,0,12800,157520,2024.01.18
162,'98 Braves,Morgan Wallen,2,-2,4,1,0,12800,-900,13700,2044741,2024.01.18
163,A Hundred Different Altars,Steeles,2,1,1,2,0,12700,6300,6400,3271,2024.01.18
164,Think About There,Greater Vision,2,0,2,2,0,12700,0,12700,15445,2024.01.18
165,Little Rain,Morgan Wallen,1,0,1,1,0,12700,-2400,15100,466331,2024.01.18
166,The Star-Spangled Banner,Carly Pearce,1,-2,3,1,0,12700,-9100,21800,0,2024.01.18
167,Ain't Missin' You,Dylan Schneider,21,-65,86,4,0,12400,-31300,43700,985832,2024.01.18
168,No Yesterday,Jeremy McComb,6,0,6,1,0,11900,-300,12200,185,2024.01.18
169,That Ain'T Country,Aaron Lewis,6,-1,7,1,0,11300,3000,8300,98061,2024.01.18
170,Wild,Carter Faith,8,2,6,1,0,11200,1800,9400,112950,2024.01.18
171,Meanwhile In Carolina,Conner Smith,1,1,0,1,0,11200,11200,0,675791,2024.01.18
172,My Bar,Priscilla Block,1,-1,2,1,0,11200,3400,7800,132294,2024.01.18
173,In Love With My Problems,Larry Fleet Feat. Jon Pardi,6,1,5,1,0,11000,5600,5400,88392,2024.01.18
174,Fake Id,Sydney Mack,7,0,7,1,0,10900,-200,11100,780,2024.01.18
175,Raise The Roof,Christian Beck,6,-1,7,1,0,10800,1000,9800,142,2024.01.18
176,National Anthem,Pryor & Lee,1,1,0,1,0,10700,10700,0,0,2024.01.18
177,Roots,Parmalee,3,3,0,3,0,10500,10500,0,6110,2024.01.18
178,Wild as You,Cody Johnson,8,3,5,1,0,10500,-1400,11900,1407814,2024.01.18
179,Buckles And Broken Hearts,Joe Peters,2,1,1,1,0,10400,10000,400,906,2024.01.18
180,If It Wasn't For Trucks,Riley Green,11,6,5,3,0,10200,4600,5600,493147,2024.01.18
181,BELLS,Rachelle Garniez,1,1,0,1,0,10200,10200,0,0,2024.01.18
182,"Houston, We Got A Problem",Luke Combs,5,-2,7,1,0,10200,-4300,14500,972638,2024.01.18
183,Give Me A Sunrise,Braxton Keith,5,0,5,1,0,10000,-22000,32000,24371,2024.01.18
184,Holy Smoke,Frank Vieira,11,1,10,1,0,9900,600,9300,144,2024.01.18
185,Cold Case Breakthrough,David Joseph Kropf,2,2,0,1,0,9100,9100,0,0,2024.01.18
186,House Fire,Tyler Childers,3,3,0,1,0,8900,8900,0,932068,2024.01.18
187,John Deere Green,"HIXTAPE Feat. HARDY, Morgan Wallen, Joe Diffie",1,1,0,1,0,8700,8700,0,0,2024.01.18
188,Smell Like Smoke,Lainey Wilson,2,2,0,2,0,8600,8600,0,384353,2024.01.18
189,I GOT AWAY WITH YOU,Luke Combs,3,-3,6,1,0,8600,-4800,13400,270053,2024.01.18
190,Arkansas,Chris Stapleton,6,2,4,1,0,8400,2800,5600,404515,2024.01.18
191,Classic,Ernest,6,1,5,1,0,8400,4200,4200,26969,2024.01.18
192,Mountain With A View,Kelsea Ballerini,6,1,5,1,0,8200,1600,6600,946668,2024.01.18
193,Heart To Break,Ryan Griffin,19,0,19,1,0,8000,0,8000,118039,2024.01.18
194,Whatever Gets You Through It,Morgan Gruber,6,0,6,1,0,8000,-800,8800,284,2024.01.18
195,Loud and Heavy,Cody Jinks,4,-6,10,1,0,8000,-9800,17800,1369788,2024.01.18
196,Thy Will,Hillary Scott & The Scott Family,1,1,0,1,0,7800,7800,0,365935,2024.01.18
197,Star Spangled Banner,Demi Lovato,1,0,1,1,0,7800,0,7800,76,2024.01.18
198,Gaslighter,The Chicks,1,1,0,1,0,7700,7700,0,93003,2024.01.18
199,Cover Me Up,Morgan Wallen,3,-1,4,2,0,7700,1300,6400,3921395,2024.01.18
200,Heartless,Diplo & Julia Michaels Feat. Morgan Wallen,4,0,4,2,0,7600,6200,1400,4369133,2024.01.18
201,Ain't That Some,Morgan Wallen,1,0,1,1,0,7600,5800,1800,3304465,2024.01.18
1,World On Fire,Nate Smith,8182,-548,8730,144,0,34232200,-1409900,35642100,5083894,2024.01.25
2,White Horse,Chris Stapleton,7985,878,7107,144,0,30590300,3936100,26654200,10261372,2024.01.25
3,Save Me,Jelly Roll & Lainey Wilson,6011,-608,6619,142,0,25267000,-1723500,26990500,6028966,2024.01.25
4,Different 'Round Here,Riley Green,6519,201,6318,144,0,23657700,819500,22838200,2982710,2024.01.25
5,Pretty Little Poison,Warren Zeiders,6535,651,5884,143,0,22845900,2134700,20711200,9408350,2024.01.25
6,The Painter,Cody Johnson,5961,641,5320,144,0,22553000,1819900,20733100,6229305,2024.01.25
7,Where The Wild Things Are,Luke Combs,5882,50,5832,144,0,22028100,356200,21671900,8574934,2024.01.25
8,All I Need Is You,Chris Janson,5908,395,5513,144,0,21157200,1259400,19897800,608503,2024.01.25
9,Truck Bed,Hardy,5124,91,5033,143,0,18893400,448600,18444800,7424731,2024.01.25
10,I Can Feel It,Kane Brown,5023,78,4945,144,0,18886600,291300,18595300,3226571,2024.01.25
11,23,Chayce Beckham,4306,156,4150,144,0,14276900,298600,13978300,4201558,2024.01.25
12,Mamaw's House,Thomas Rhett,3772,593,3179,142,0,14075300,2176800,11898500,3197146,2024.01.25
13,Burn It Down,Parker Mccollum,3967,114,3853,143,0,13749800,34400,13715400,6114002,2024.01.25
14,Creek Will Rise,Conner Smith,3962,3,3959,144,0,13102900,-111900,13214800,1182222,2024.01.25
15,Man Made A Bar,Morgan Wallen,2813,390,2423,143,0,10906000,1628300,9277700,5767210,2024.01.25
16,Cab In A Solo,Scotty McCreery,3152,187,2965,144,0,9911700,843000,9068700,624205,2024.01.25
17,Tucson Too Late,Jordan Davis,2973,206,2767,142,0,9597600,1164700,8432900,1905980,2024.01.25
18,Wildflowers And Wild Horses,Lainey Wilson,2906,187,2719,144,0,9173100,379700,8793400,2588771,2024.01.25
19,Fearless,Jackson Dean,3094,75,3019,142,0,8667600,504200,8163400,1140484,2024.01.25
20,We Don'T Fight Anymore,Carly Pearce,2710,64,2646,142,0,8309700,48700,8261000,4637669,2024.01.25
21,Glory Days,Gabby Barrett,2729,-19,2748,143,0,7719400,71200,7648200,1491396,2024.01.25
22,Back Then Right Now,Tyler Hubbard,2495,174,2321,140,0,7294800,551900,6742900,1758470,2024.01.25
23,Take Her Home,Kenny Chesney,2193,91,2102,143,0,6658500,324700,6333800,982258,2024.01.25
24,Out Of That Truck,Carrie Underwood,2036,79,1957,135,0,6149500,627000,5522500,1175954,2024.01.25
25,Your Place,Ashley Cooke,1716,169,1547,123,0,6075000,353300,5721700,1609478,2024.01.25
26,I Remember Everything,Zach Bryan Feat. Kacey Musgraves,1771,-118,1889,137,0,5429700,-634200,6063900,21704030,2024.01.25
27,Let Your Boys Be Country,Jason Aldean,1447,182,1265,126,0,5157300,234400,4922900,1559845,2024.01.25
28,I'M Not Pretty,Megan Moroney,1752,38,1714,138,0,4942200,113500,4828700,2334025,2024.01.25
29,Can't Break Up Now,Old Dominion,1838,159,1679,143,0,4787200,575400,4211800,1585320,2024.01.25
30,Outskirts,Sam Hunt,1579,72,1507,132,0,4428400,32600,4395800,1831601,2024.01.25
31,Where It Ends,Bailey Zimmerman,1335,157,1178,105,0,4229000,645800,3583200,4278608,2024.01.25
32,Love You Again,Chase Matthew,1613,39,1574,132,0,3979600,199600,3780000,2062266,2024.01.25
33,We Ride,Bryan Martin,1149,162,987,90,0,3861900,640200,3221700,3588664,2024.01.25
34,Young Love & Saturday Nights,Chris Young,1022,17,1005,86,0,3370800,34600,3336200,815587,2024.01.25
35,Cowboys And Plowboys,Jon Pardi Feat. Luke Bryan,959,35,924,100,0,2708600,240600,2468000,423855,2024.01.25
36,Halfway To Hell,Jelly Roll,694,421,273,83,0,2531900,1630900,901000,2144628,2024.01.25
37,Spirits And Demons,Michael Ray With Meghan Patrick,1006,42,964,103,0,2524000,176900,2347100,192263,2024.01.25
38,Drinkin' Problems,Dillon Carmichael,1277,74,1203,131,0,2437000,-45100,2482100,76200,2024.01.25
39,Gonna Love You,Parmalee,945,20,925,77,0,2237100,28200,2208900,284814,2024.01.25
40,Rodeo Man,Garth Brooks & Ronnie Dunn,1125,64,1061,126,0,2104800,900,2103900,1338391,2024.01.25
41,Something's Gonna Kill Me,Corey Kent,821,-22,843,73,0,2083700,-229700,2313400,1891713,2024.01.25
42,Dance With You,Brett Young,824,13,811,83,0,1795700,56900,1738800,1637066,2024.01.25
43,This Is My Dirt,Justin Moore,891,136,755,98,0,1678500,269400,1409100,324743,2024.01.25
44,Pickup Man (Feat. Post Malone),Hixtape & Joe Diffie,344,11,333,62,0,1433400,119300,1314100,573281,2024.01.25
45,Chevrolet,Dustin Lynch Feat. Jelly Roll,577,38,539,67,0,1422000,272500,1149500,2273140,2024.01.25
46,Sounds Like The Radio,Zach Top,623,120,503,106,0,1402100,91300,1310800,261494,2024.01.25
47,In Your Love,Tyler Childers,675,91,584,73,0,1251800,171900,1079900,3560790,2024.01.25
48,Find Another Bar,Chris Lane,616,40,576,67,0,1249200,99300,1149900,337225,2024.01.25
49,Love You Back,Lady A,659,35,624,91,0,1227800,68700,1159100,230261,2024.01.25
50,Brokenhearted,Joe Nichols,594,28,566,63,0,963700,110000,853700,8024,2024.01.25
51,She's Somebody's Daughter,Drew Baldridge,536,68,468,70,0,822200,107400,714800,429036,2024.01.25
52,I'm In Love,Hailey Whitters,431,6,425,60,0,765700,-106800,872500,706071,2024.01.25
53,Ain'T About You,Huntergirl,531,39,492,73,0,751400,59000,692400,20902,2024.01.25
54,Boys Back Home,Dylan Marlowe Feat. Dylan Scott,370,29,341,53,0,650800,78600,572200,2758539,2024.01.25
55,One Bad Habit,Tim McGraw,305,221,84,56,0,575900,386400,189500,130273,2024.01.25
56,Long Live Cowgirls,Ian Munsick & Cody Johnson,308,3,305,36,0,572600,-62400,635000,824586,2024.01.25
57,Breakin' In Boots,Matt Stell,389,-35,424,61,0,525900,-108400,634300,573160,2024.01.25
58,Dirt Cheap,Cody Johnson,69,-12,81,7,0,506800,-93600,600400,3223617,2024.01.25
59,King Of Country Music,Ryan Larkins,322,22,300,50,0,483800,5400,478400,29954,2024.01.25
60,Make Me Wanna Smoke,Runaway June,330,15,315,39,0,421500,-20400,441900,18923,2024.01.25
61,This Side Of The Dirt,Neon Union,328,13,315,42,0,411000,61800,349200,23275,2024.01.25
62,Shape Of You,Ed Sheeran,74,74,0,37,0,332000,332000,0,3875758,2024.01.25
63,Wondering Why,Red Clay Strays,29,6,23,2,0,313200,40100,273100,5510001,2024.01.25
64,Cancel,Randy Houser,312,15,297,41,0,310600,-700,311300,69643,2024.01.25
65,Heart They Didn'T Break,Maddie & Tae,227,12,215,30,0,309200,3100,306100,813726,2024.01.25
66,Rain In The Rearview,Anne Wilson,259,36,223,35,0,294200,69000,225200,928617,2024.01.25
67,Chasing Cars,Nate Smith,52,5,47,51,0,279400,91100,188300,58383,2024.01.25
68,Heart Shaped Box,Nate Smith,58,14,44,56,0,278800,95700,183100,0,2024.01.25
69,I Tried A Ring On,Tigirlily Gold,164,134,30,73,0,276700,195500,81200,244891,2024.01.25
70,Wine Country,Hannah Ellis,83,-50,133,13,0,233700,-31600,265300,23237,2024.01.25
71,Neon Baby,Annie Bosko,143,17,126,25,0,219700,57100,162600,33021,2024.01.25
72,Thicc As Thieves,Lauren Alaina,148,-85,233,25,0,195100,-118800,313900,767614,2024.01.25
73,How Is She,Cole Swindell,28,-1,29,1,0,188800,8200,180600,44728,2024.01.25
74,Million Little Bandaids,Caroline Jones,196,34,162,26,0,162800,36100,126700,43189,2024.01.25
75,Too Soon To Tell,Johnny Clawson,30,30,0,30,0,162800,162800,0,256,2024.01.25
76,Life With You,Kelsey Hart,152,44,108,29,0,159400,108500,50900,1677344,2024.01.25
77,Without You,Thompson Square,21,-7,28,3,0,129600,25900,103700,5300,2024.01.25
78,Jack And Diet Coke,Redferrin,39,-4,43,12,0,114200,-10300,124500,1258315,2024.01.25
79,That's Texas,Cody Johnson,12,-14,26,2,0,99400,-109200,208600,363140,2024.01.25
80,Sarah's Place,Zach Bryan,12,-5,17,1,0,96100,-36900,133000,3218800,2024.01.25
81,What Are You Listening To?,Megan Moroney,48,48,0,48,0,95700,95700,0,0,2024.01.25
82,Bigger Houses,Dan + Shay,38,27,11,12,0,95200,61800,33400,260899,2024.01.25
83,Night In,Brittney Spencer,46,46,0,45,0,93700,93700,0,56131,2024.01.25
84,Colorado,Florida Georgia Line,15,-4,19,2,0,89000,-21400,110400,46550,2024.01.25
85,With You I Am,Cody Johnson,8,0,8,2,0,87000,31700,55300,1561672,2024.01.25
86,I Need You,Frontmen,18,5,13,2,0,81500,38900,42600,1419,2024.01.25
87,Forever Bound,12/Oc,28,-3,31,1,0,71800,-11300,83100,2704,2024.01.25
88,Things I Take For Granted,Larry Fleet,23,17,6,5,0,66600,41600,25000,1004476,2024.01.25
89,3 Feet Tall,Cole Swindell,11,-3,14,1,0,65000,-24500,89500,354877,2024.01.25
90,Outlaws And Mustangs,Cody Jinks,23,8,15,3,0,63500,46500,17000,215571,2024.01.25
91,West Of Tulsa,Wyatt Flores,21,1,20,2,0,62200,-23700,85900,270964,2024.01.25
92,Fake Names,Priscilla Block,19,-2,21,1,0,62100,-3700,65800,76503,2024.01.25
93,Last Rodeo,Restless Road,58,57,1,8,0,60200,59700,500,1752931,2024.01.25
94,The Star-Spangled Banner,Chris Stapleton,14,3,11,11,0,59500,-2200,61700,90949,2024.01.25
95,Coal,Dylan Gossett,15,-2,17,1,0,56200,-2400,58600,5823867,2024.01.25
96,Seven Minutes In Heaven,Reba Mcentire,8,8,0,8,0,53100,53100,0,121563,2024.01.25
97,That's What I Love About Sunday,Craig Morgan & Gary Levox,8,2,6,8,0,53100,34700,18400,10637,2024.01.25
98,Holy Water,Michael Ray,6,-3,9,2,0,53000,-12900,65900,210312,2024.01.25
99,Silverado,Caleb Lee Hutchinson,68,34,34,17,0,49200,24600,24600,15541,2024.01.25
99,She's Gotta Know,Conner Sweet,68,34,34,17,0,49200,24600,24600,983,2024.01.25
101,Trouble,Josh Ross,53,-20,73,8,0,46200,-16900,63100,2257626,2024.01.25
102,I'M Not For Everyone,Brothers Osborne,8,7,1,3,0,43800,42900,900,418602,2024.01.25
103,Cowgirls,Morgan Wallen,15,0,15,6,0,42700,8100,34600,5855632,2024.01.25
104,I Like Big Trucks,Alli Walker,15,6,9,1,0,41500,11900,29600,0,2024.01.25
105,Tulsa,Elle King,10,-2,12,1,0,38800,-8600,47400,43573,2024.01.25
106,My Bar,Priscilla Block,5,4,1,1,0,37600,26400,11200,127772,2024.01.25
107,Always You,Trey Lewis,51,1,50,17,0,36900,500,36400,150205,2024.01.25
108,A Cowboy Who Would,Chancey Williams,51,0,51,17,0,36900,0,36900,92028,2024.01.25
109,Two Woman Man,Randall Fowler,51,-17,68,17,0,36900,-12300,49200,507,2024.01.25
110,Make You Mine,Marynn Taylor,12,6,6,6,0,36800,18400,18400,22406,2024.01.25
111,Broadway Girls,Lil Durk Feat. Morgan Wallen,7,4,3,2,0,35100,22200,12900,3571439,2024.01.25
112,25-8,Larry Fleet,9,2,7,1,0,31400,5200,26200,111177,2024.01.25
113,Can'T Pass The Bar,Scotty McCreery,5,4,1,3,0,30700,26000,4700,1179448,2024.01.25
114,Let's Go Fishing,Aaron Lewis,17,13,4,2,0,29500,15700,13800,0,2024.01.25
115,Don't Think Jesus,Morgan Wallen,9,9,0,9,0,28900,28900,0,974468,2024.01.25
116,Hey Driver,Zach Bryan Feat. The War and Treaty,19,19,0,2,0,28800,28800,0,6775577,2024.01.25
117,No Present LIke The Time,Jay Allen,67,-2,69,11,0,28500,-600,29100,0,2024.01.25
118,Pray All The Way Home,Austin Snell,35,-33,68,17,0,27200,-22000,49200,988382,2024.01.25
119,Holy Roller,Zach Bryan,13,9,4,1,0,26200,23000,3200,1237158,2024.01.25
120,"Houston, We Got A Problem",Luke Combs,10,5,5,2,0,26200,16000,10200,1040850,2024.01.25
121,Way Back When,Wayland,36,0,36,12,0,25800,0,25800,813,2024.01.25
122,Black Magic,Rachel Lipsky,34,-17,51,17,0,24600,-12300,36900,59,2024.01.25
123,Hoops,Alison Nichols,34,-18,52,17,0,24600,-16000,40600,3485,2024.01.25
124,Wild Ones,Jessie Murph & Jelly Roll,10,10,0,2,0,21300,21300,0,13213627,2024.01.25
125,Narcissist,Avery Anna,3,-4,7,1,0,20100,-26400,46500,618764,2024.01.25
126,No Caller Id,Megan Moroney,3,3,0,3,0,19800,19800,0,7991958,2024.01.25
127,The Star Spangled Banner,Locash,1,0,1,1,0,19500,0,19500,0,2024.01.25
128,Star Spangled Banner,Maren Morris,1,-2,3,1,0,19500,-800,20300,0,2024.01.25
129,Goodbye Looks Good On You,Alana Springsteen Feat. Mitchell Tenpenny,14,-2,16,1,0,19300,-8900,28200,1305353,2024.01.25
130,I GOT AWAY WITH YOU,Luke Combs,8,5,3,1,0,18800,10200,8600,276511,2024.01.25
131,Give Me A Sunrise,Braxton Keith,8,3,5,1,0,18800,8800,10000,26667,2024.01.25
132,Bits & Pieces,Walker County,6,6,0,6,0,18400,18400,0,1665,2024.01.25
133,Almost Home,Craig Morgan And Jelly Roll,6,0,6,6,0,18400,0,18400,585738,2024.01.25
134,Sayin' What I'm Thinkin',Lainey Wilson,10,3,7,1,0,18300,5500,12800,152248,2024.01.25
135,The Girl Can'T Help It,Blake Shelton,1,1,0,1,0,18200,18200,0,7919,2024.01.25
136,How You Get To Heaven,Ty Herndon,1,1,0,1,0,17900,17900,0,409,2024.01.25
137,I'M Not Blonde,Meredith Foster,9,-3,12,1,0,17600,-200,17800,39,2024.01.25
138,The Star Spangled Banner,Brad Paisley,3,2,1,3,0,17500,17100,400,0,2024.01.25
139,Sun To Me,Zach Bryan,9,-6,15,2,0,17200,-3400,20600,4497367,2024.01.25
140,This Town's Been Too Good To Us,Dylan Scott,5,5,0,2,0,17100,17100,0,2996535,2024.01.25
141,What Else Is New,Cody Jinks,8,6,2,1,0,16700,12000,4700,69774,2024.01.25
142,The Great Divide,Luke Combs & Billy Strings,5,0,5,1,0,16400,3100,13300,169654,2024.01.25
143,Must Be The Whiskey,Cody Jinks,8,-1,9,1,0,16400,-12700,29100,1212939,2024.01.25
144,John Deere Green,"HIXTAPE Feat. HARDY, Morgan Wallen, Joe Diffie",2,1,1,2,0,16300,7600,8700,0,2024.01.25
145,Star Spangled Banner,Abby Anderson,5,-1,6,5,0,16000,-16100,32100,0,2024.01.25
146,Dirty Looks,Lainey Wilson,4,3,1,2,0,15900,14900,1000,872721,2024.01.25
147,Heart Attack,Boy Named Banjo,11,-5,16,1,0,15700,-6900,22600,3270,2024.01.25
148,Any Given Friday Night,Luke Combs,2,0,2,1,0,15200,0,15200,177709,2024.01.25
149,Record High,Randall King,3,3,0,2,0,15100,15100,0,27842,2024.01.25
150,Seven Year Ache,Aaron Watson & Jenna Paulette,1,1,0,1,0,15100,15100,0,0,2024.01.25
150,Damn This Heart Of Mine,William Beckmann,1,1,0,1,0,15100,15100,0,6015,2024.01.25
150,Open The Gate,Zach Bryan,1,1,0,1,0,15100,15100,0,984087,2024.01.25
150,Work Boots,Cody Johnson,1,1,0,1,0,15100,15100,0,445926,2024.01.25
154,Porch Swing Angel,Muscadine Bloodline,1,0,1,1,0,15100,0,15100,1007921,2024.01.25
155,You In A Honky Tonk,Randall King,1,-1,2,1,0,15100,-3200,18300,290584,2024.01.25
156,Up In Texas,Midland,1,-4,5,1,0,15100,-34900,50000,310399,2024.01.25
157,Wreckage,Nate Smith,7,6,1,1,0,14800,11200,3600,682751,2024.01.25
158,The Star-Spangled Banner,Carly Pearce,4,3,1,3,0,14800,2100,12700,0,2024.01.25
159,Days That End In Why,Morgan Wallen,7,1,6,2,0,13900,6400,7500,1065317,2024.01.25
160,Raise The Roof,Christian Beck,7,1,6,1,0,13600,2800,10800,150,2024.01.25
161,That Ain'T Country,Aaron Lewis,5,-1,6,1,0,13300,2000,11300,101302,2024.01.25
162,Hungover You,Emily Brooke,6,6,0,6,0,13200,13200,0,662,2024.01.25
163,Am I The Only One,Aaron Lewis,2,2,0,2,0,13200,13200,0,612787,2024.01.25
164,Star Spangled Banner,Mickey Guyton,3,2,1,3,0,13100,10500,2600,0,2024.01.25
165,5 Leaf Clover,Luke Combs,2,2,0,2,0,13100,13100,0,1716775,2024.01.25
166,Breaking My Heart,Mitchell Tenpenny,2,2,0,2,0,13000,13000,0,1290399,2024.01.25
167,Whatever Gets You Through It,Morgan Gruber,7,1,6,1,0,13000,5000,8000,368,2024.01.25
168,Think About There,Greater Vision,3,1,2,3,0,12700,0,12700,15685,2024.01.25
169,A Hundred Different Altars,Steeles,2,0,2,2,0,12700,0,12700,3649,2024.01.25
170,Cowboy Songs,George Birge,7,7,0,6,0,12600,12600,0,0,2024.01.25
171,But A Beer Can,Eric Burgett,17,-17,34,17,0,12300,-12300,24600,4687,2024.01.25
172,Heart To Break,Ryan Griffin,18,-1,19,1,0,12000,4000,8000,113397,2024.01.25
173,"Trucks, Ducks, Bucks & Beer",Brian Kelley,2,-1,3,2,0,11600,-6800,18400,201627,2024.01.25
174,How Do You Miss Me,Dallas Smith,2,2,0,1,0,10800,10800,0,18823,2024.01.25
174,Honky Tonk Heartbreaker,Dustin Lynch,2,2,0,1,0,10800,10800,0,51307,2024.01.25
174,George Strait Jr.,Dustin Lynch,2,2,0,1,0,10800,10800,0,24698,2024.01.25
177,Me To Me,Morgan Wallen,1,1,0,1,0,10800,10800,0,941206,2024.01.25
178,Ain'T She,Adam Doleac,2,-5,7,1,0,10800,-23300,34100,312937,2024.01.25
179,National Anthem,Pryor & Lee,1,0,1,1,0,10700,0,10700,0,2024.01.25
180,Loud and Heavy,Cody Jinks,6,2,4,2,0,10200,2200,8000,1409942,2024.01.25
181,BELLS,Rachelle Garniez,1,0,1,1,0,10200,0,10200,0,2024.01.25
182,Come Back,November Blue,6,0,6,1,0,10100,2800,7300,1158,2024.01.25
183,She Gone,Randall King,2,2,0,2,0,10000,10000,0,8102,2024.01.25
184,No Yesterday,Jeremy McComb,6,0,6,1,0,9300,-2600,11900,208,2024.01.25
185,Your Old Love Letters,Vince Gill & Paul Franklin,4,4,0,1,0,9200,9200,0,0,2024.01.25
186,"Salt, Lime & Tequila",Ryan Griffin,2,1,1,1,0,8800,8500,300,55095,2024.01.25
187,A Little Bit Closer,Braxton Keith,3,-1,4,1,0,8800,6400,2400,61861,2024.01.25
188,If It Wasn't For Trucks,Riley Green,11,0,11,4,0,8600,-1600,10200,515198,2024.01.25
189,White House Road,Tyler Childers & The Highwall,4,1,3,2,0,8400,6200,2200,2255086,2024.01.25
190,Arkansas,Chris Stapleton,6,0,6,1,0,8400,0,8400,434276,2024.01.25
191,Ain't Missin' You,Dylan Schneider,16,-5,21,3,0,8400,-4000,12400,936548,2024.01.25
192,The Star-Spangled Banner,Eric Church & Jazmine Sullivan,2,2,0,2,0,8300,8300,0,0,2024.01.25
193,Truck Girl,Josh Ross,1,1,0,1,0,8300,8300,0,148105,2024.01.25
193,"Take Me Home, Country Roads",Dalton Dover,1,1,0,1,0,8300,8300,0,92645,2024.01.25
193,When It  All Shakes Out,Jake Owen,1,1,0,1,0,8300,8300,0,3190,2024.01.25
193,Pretty Like You,Rayne Johnson,1,1,0,1,0,8300,8300,0,8086,2024.01.25
197,Right Now,Chris Young,1,0,1,1,0,8300,2100,6200,1224491,2024.01.25
198,Beautiful Messes,Hillary Scott & The Scott Family,1,1,0,1,0,7800,7800,0,10475,2024.01.25
198,Way Home,Tyler Hubbard,1,1,0,1,0,7800,7800,0,57889,2024.01.25
200,Fake Id,Sydney Mack,7,0,7,1,0,7800,-3100,10900,963,2024.01.25
1,World On Fire,Nate Smith,7524,-658,8182,144,0,32137100,-2095100,34232200,5183857,2024.02.01
2,White Horse,Chris Stapleton,7108,-877,7985,144,0,26989500,-3600800,30590300,10463168,2024.02.01
3,All I Need Is You,Chris Janson,7591,1683,5908,144,0,26624800,5467600,21157200,575515,2024.02.01
4,Different 'Round Here,Riley Green,6683,164,6519,144,0,24789200,1131500,23657700,2987044,2024.02.01
5,Pretty Little Poison,Warren Zeiders,6774,239,6535,143,0,24132400,1286500,22845900,9932031,2024.02.01
6,The Painter,Cody Johnson,6313,352,5961,144,0,23942500,1389500,22553000,7019399,2024.02.01
7,Where The Wild Things Are,Luke Combs,6111,229,5882,144,0,22627400,599300,22028100,8572306,2024.02.01
8,Truck Bed,Hardy,5397,273,5124,143,0,20161400,1268000,18893400,7379332,2024.02.01
9,I Can Feel It,Kane Brown,5208,185,5023,144,0,19644500,757900,18886600,3405315,2024.02.01
10,Mamaw's House,Thomas Rhett,4578,806,3772,143,0,16559200,2483900,14075300,3324755,2024.02.01
11,23,Chayce Beckham,4409,103,4306,144,0,14839700,562800,14276900,4216543,2024.02.01
12,Burn It Down,Parker Mccollum,3975,8,3967,143,0,14189900,440100,13749800,6079013,2024.02.01
13,Creek Will Rise,Conner Smith,4033,71,3962,144,0,13320300,217400,13102900,3262028,2024.02.01
14,Man Made A Bar,Morgan Wallen,3060,247,2813,143,0,12288400,1382400,10906000,5562406,2024.02.01
15,Tucson Too Late,Jordan Davis,3199,226,2973,142,0,10385600,788000,9597600,1729039,2024.02.01
16,Cab In A Solo,Scotty McCreery,3145,-7,3152,144,0,10310400,398700,9911700,630814,2024.02.01
17,Wildflowers And Wild Horses,Lainey Wilson,3076,170,2906,144,0,10259800,1086700,9173100,3596153,2024.02.01
18,Fearless,Jackson Dean,3190,96,3094,142,0,9233600,566000,8667600,1128965,2024.02.01
19,We Don'T Fight Anymore,Carly Pearce,2753,43,2710,142,0,8530300,220600,8309700,4763643,2024.02.01
20,Back Then Right Now,Tyler Hubbard,2737,242,2495,144,0,8298100,1003300,7294800,2616551,2024.02.01
21,Glory Days,Gabby Barrett,2885,156,2729,143,0,7783600,64200,7719400,1515532,2024.02.01
22,Take Her Home,Kenny Chesney,2299,106,2193,143,0,7216600,558100,6658500,995100,2024.02.01
23,Out Of That Truck,Carrie Underwood,2141,105,2036,136,0,6585200,435700,6149500,1030067,2024.02.01
24,Your Place,Ashley Cooke,1889,173,1716,126,0,6397400,322400,6075000,1540429,2024.02.01
25,Let Your Boys Be Country,Jason Aldean,1645,198,1447,131,0,5523500,366200,5157300,1661238,2024.02.01
26,I Remember Everything,Zach Bryan Feat. Kacey Musgraves,1802,31,1771,136,0,5470400,40700,5429700,22347684,2024.02.01
27,I'M Not Pretty,Megan Moroney,1834,82,1752,141,0,5469400,527200,4942200,2161510,2024.02.01
28,Outskirts,Sam Hunt,1766,187,1579,136,0,5256900,828500,4428400,1665839,2024.02.01
29,Can't Break Up Now,Old Dominion,1880,42,1838,143,0,5061600,274400,4787200,1488537,2024.02.01
30,Where It Ends,Bailey Zimmerman,1692,357,1335,124,0,5001700,772700,4229000,4297470,2024.02.01
31,Halfway To Hell,Jelly Roll,1269,575,694,115,0,4603000,2071100,2531900,2080560,2024.02.01
32,We Ride,Bryan Martin,1230,81,1149,91,0,4289100,427200,3861900,3687144,2024.02.01
33,Love You Again,Chase Matthew,1593,-20,1613,132,0,3775100,-204500,3979600,2063797,2024.02.01
34,Young Love & Saturday Nights,Chris Young,1123,101,1022,94,0,3597300,226500,3370800,803204,2024.02.01
35,Cowboys And Plowboys,Jon Pardi Feat. Luke Bryan,971,12,959,103,0,2669800,-38800,2708600,460447,2024.02.01
36,Spirits And Demons,Michael Ray With Meghan Patrick,997,-9,1006,105,0,2579000,55000,2524000,174629,2024.02.01
37,Drinkin' Problems,Dillon Carmichael,1258,-19,1277,133,0,2508200,71200,2437000,37067,2024.02.01
38,Gonna Love You,Parmalee,1031,86,945,78,0,2461100,224000,2237100,266008,2024.02.01
39,Rodeo Man,Garth Brooks & Ronnie Dunn,1154,29,1125,138,0,2211600,106800,2104800,1517131,2024.02.01
40,Dance With You,Brett Young,892,68,824,83,0,2109000,313300,1795700,1730074,2024.02.01
41,Chevrolet,Dustin Lynch Feat. Jelly Roll,631,54,577,73,0,1705100,283100,1422000,2493533,2024.02.01
42,This Is My Dirt,Justin Moore,888,-3,891,98,0,1645800,-32700,1678500,355427,2024.02.01
43,In Your Love,Tyler Childers,775,100,675,80,0,1522500,270700,1251800,3955209,2024.02.01
44,Sounds Like The Radio,Zach Top,612,-11,623,77,0,1518200,116100,1402100,270965,2024.02.01
45,Pickup Man (Feat. Post Malone),Hixtape & Joe Diffie,309,-35,344,61,0,1327000,-106400,1433400,586387,2024.02.01
46,Find Another Bar,Chris Lane,656,40,616,81,0,1289800,40600,1249200,204056,2024.02.01
47,Brokenhearted,Joe Nichols,597,3,594,66,0,961500,-2200,963700,8716,2024.02.01
48,Love You Back,Lady A,595,-64,659,90,0,943100,-284700,1227800,168124,2024.02.01
49,One Bad Habit,Tim McGraw,521,216,305,74,0,939700,363800,575900,79951,2024.02.01
50,She's Somebody's Daughter,Drew Baldridge,576,40,536,78,0,911100,88900,822200,417565,2024.02.01
51,I'm In Love,Hailey Whitters,456,25,431,63,0,906700,141000,765700,682660,2024.02.01
52,Ain'T About You,Huntergirl,570,39,531,74,0,856300,104900,751400,21023,2024.02.01
53,Long Live Cowgirls,Ian Munsick & Cody Johnson,305,-3,308,37,0,723300,150700,572600,873237,2024.02.01
54,I Tried A Ring On,Tigirlily Gold,291,127,164,86,0,656100,379400,276700,270881,2024.02.01
55,Boys Back Home,Dylan Marlowe Feat. Dylan Scott,387,17,370,55,0,651200,400,650800,2775027,2024.02.01
56,King Of Country Music,Ryan Larkins,330,8,322,50,0,620800,137000,483800,28556,2024.02.01
57,Spin You Around (1/24),Morgan Wallen,120,120,0,31,0,610600,610600,0,13479396,2024.02.01
58,Breakin' In Boots,Matt Stell,417,28,389,65,0,586200,60300,525900,574534,2024.02.01
59,Dirt Cheap,Cody Johnson,73,4,69,7,0,522600,15800,506800,3503671,2024.02.01
60,Make Me Wanna Smoke,Runaway June,358,28,330,41,0,465300,43800,421500,48288,2024.02.01
61,Wondering Why,Red Clay Strays,45,16,29,2,0,414700,101500,313200,5426831,2024.02.01
62,This Side Of The Dirt,Neon Union,319,-9,328,41,0,386500,-24500,411000,26510,2024.02.01
63,Amy's Back In Austin,Eli Young Band & George Birge,56,56,0,55,0,305600,305600,0,15912,2024.02.01
64,Cancel,Randy Houser,301,-11,312,41,0,289700,-20900,310600,51563,2024.02.01
65,Heart They Didn'T Break,Maddie & Tae,197,-30,227,27,0,287900,-21300,309200,524364,2024.02.01
66,Rain In The Rearview,Anne Wilson,266,7,259,38,0,245100,-49100,294200,884032,2024.02.01
67,Million Little Bandaids,Caroline Jones,217,21,196,33,0,221400,58600,162800,46410,2024.02.01
68,Cowboy Songs,George Birge,45,38,7,44,0,221100,208500,12600,0,2024.02.01
69,Bigger Houses,Dan + Shay,109,71,38,16,0,204600,109400,95200,547501,2024.02.01
70,Neon Baby,Annie Bosko,145,2,143,27,0,194600,-25100,219700,30437,2024.02.01
71,Hillbillies & Betties,Renee Blair,47,47,0,46,0,188300,188300,0,12865,2024.02.01
72,Last Rodeo,Restless Road,110,52,58,28,0,186600,126400,60200,1793627,2024.02.01
73,How Is She,Cole Swindell,19,-9,28,1,0,124400,-64400,188800,47096,2024.02.01
74,Outlaws And Mustangs,Cody Jinks,27,4,23,4,0,123200,59700,63500,186932,2024.02.01
75,Sarah's Place,Zach Bryan,16,4,12,1,0,116400,20300,96100,3186817,2024.02.01
76,Life With You,Kelsey Hart,136,-16,152,25,0,101600,-57800,159400,1722054,2024.02.01
77,Jack And Diet Coke,Redferrin,32,-7,39,3,0,99400,-14800,114200,1433691,2024.02.01
78,A Cowboy Who Would,Chancey Williams,67,16,51,32,0,98400,61500,36900,94179,2024.02.01
79,Sound Of Missing You,Catie Offerman,48,48,0,48,0,95700,95700,0,50983,2024.02.01
79,That Girl,Hannah Ellis,48,48,0,48,0,95700,95700,0,53077,2024.02.01
81,Country Girl,Kylie Morgan,47,47,0,47,0,94600,94600,0,45930,2024.02.01
82,Coal,Dylan Gossett,20,5,15,2,0,89400,33200,56200,5989735,2024.02.01
83,Thicc As Thieves,Lauren Alaina,87,-61,148,17,0,85100,-110000,195100,779689,2024.02.01
84,Colorado,Florida Georgia Line,13,-2,15,2,0,76200,-12800,89000,47931,2024.02.01
85,Things I Take For Granted,Larry Fleet,31,8,23,6,0,76100,9500,66600,1103671,2024.02.01
86,With You I Am,Cody Johnson,8,0,8,2,0,76000,-11000,87000,1663140,2024.02.01
87,Think I’m In Love With You,Chris Stapleton,23,22,1,7,0,74000,71500,2500,2953931,2024.02.01
88,Wine Country,Hannah Ellis,37,-46,83,10,0,74000,-159700,233700,19665,2024.02.01
89,West Of Tulsa,Wyatt Flores,21,0,21,2,0,72000,9800,62200,291123,2024.02.01
90,Without You,Thompson Square,19,-2,21,4,0,70000,-59600,129600,5703,2024.02.01
91,Forever Bound,12/Oc,27,-1,28,1,0,67900,-3900,71800,2167,2024.02.01
92,How You Get To Heaven,Ty Herndon,6,5,1,1,0,67800,49900,17900,415,2024.02.01
93,Broadway Girls,Lil Durk Feat. Morgan Wallen,18,11,7,2,0,67100,32000,35100,3821282,2024.02.01
94,25-8,Larry Fleet,13,4,9,1,0,66700,35300,31400,45807,2024.02.01
95,I Need You,Frontmen,23,5,18,3,0,62800,-18700,81500,950,2024.02.01
96,Fake Names,Priscilla Block,20,1,19,1,0,55300,-6800,62100,95367,2024.02.01
97,Let It Be,Dolly Parton,9,9,0,9,0,54800,54800,0,37465,2024.02.01
98,I Like Big Trucks,Alli Walker,16,1,15,1,0,52100,10600,41500,0,2024.02.01
99,Holy Water,Michael Ray,8,2,6,2,0,51700,-1300,53000,218918,2024.02.01
100,The Star-Spangled Banner,Chris Stapleton,12,-2,14,10,0,50300,-9200,59500,95539,2024.02.01
101,3 Feet Tall,Cole Swindell,8,-3,11,1,0,49700,-15300,65000,355327,2024.02.01
102,Pray All The Way Home,Austin Snell,68,33,35,17,0,49200,22000,27200,1052101,2024.02.01
103,This Town's Been Too Good To Us,Dylan Scott,12,7,5,4,0,46400,29300,17100,3310503,2024.02.01
104,No Caller Id,Megan Moroney,9,6,3,3,0,45100,25300,19800,5786279,2024.02.01
105,Wild Ones,Jessie Murph & Jelly Roll,24,14,10,2,0,44800,23500,21300,13824247,2024.02.01
106,No Present LIke The Time,Jay Allen,71,4,67,12,0,40200,11700,28500,0,2024.02.01
107,My Bar,Priscilla Block,3,-2,5,2,0,37000,-600,37600,135995,2024.02.01
108,Stop Coming Over,Chris Lane,12,12,0,6,0,36800,36800,0,25827,2024.02.01
109,Make You Mine,Marynn Taylor,12,0,12,6,0,36800,0,36800,20152,2024.02.01
110,Walk Away Slow,Austin English,49,49,0,17,0,36000,36000,0,647,2024.02.01
111,Sayin' What I'm Thinkin',Lainey Wilson,17,7,10,1,0,34900,16600,18300,158604,2024.02.01
112,Tulsa,Elle King,12,2,10,1,0,33600,-5200,38800,41617,2024.02.01
113,One Two Step,Gunnar Latham,45,45,0,17,0,32600,32600,0,1054,2024.02.01
114,Trouble,Josh Ross,52,-1,53,7,0,32600,-13600,46200,2189545,2024.02.01
115,The Star-Spangled Banner,Carly Pearce,4,0,4,4,0,32000,17200,14800,0,2024.02.01
116,I'M Not For Everyone,Brothers Osborne,17,9,8,15,0,31500,-12300,43800,401646,2024.02.01
117,When My Baby's In Boots,Randall King,3,3,0,1,0,30800,30800,0,0,2024.02.01
118,Let's Go Fishing,Aaron Lewis,16,-1,17,2,0,30600,1100,29500,0,2024.02.01
119,Can'T Pass The Bar,Scotty McCreery,6,1,5,5,0,30100,-600,30700,454691,2024.02.01
120,Must Be The Whiskey,Cody Jinks,7,-1,8,2,0,29200,12800,16400,1318065,2024.02.01
121,Holy Roller,Zach Bryan,13,0,13,1,0,28300,2100,26200,1230744,2024.02.01
122,Goodbye Looks Good On You,Alana Springsteen Feat. Mitchell Tenpenny,17,3,14,1,0,28100,8800,19300,872348,2024.02.01
123,Hey Driver,Zach Bryan Feat. The War and Treaty,19,0,19,2,0,27600,-1200,28800,7032160,2024.02.01
124,Strangers,Kameron Marlowe & Ella Langley,5,5,0,1,0,27100,27100,0,2342563,2024.02.01
125,If I Had A Bar,Jon Wolfe,6,5,1,2,0,27000,24500,2500,7929,2024.02.01
126,Cowgirls,Morgan Wallen,9,-6,15,4,0,26300,-16400,42700,5933736,2024.02.01
127,How 'Bout Those Chiefs,Blane Howard,5,4,1,2,0,25800,20900,4900,6326,2024.02.01
128,Seven Minutes In Heaven,Reba Mcentire,4,-4,8,4,0,25500,-27600,53100,114626,2024.02.01
129,Always You,Trey Lewis,34,-17,51,17,0,24600,-12300,36900,137617,2024.02.01
130,National Anthem From Battle At Bristol,Jennifer Nettles,3,1,2,3,0,22800,17900,4900,0,2024.02.01
131,Leave You Alone,Kane Brown,5,4,1,5,0,22600,16200,6400,315712,2024.02.01
132,Heart Attack,Boy Named Banjo,12,1,11,1,0,22400,6700,15700,3348,2024.02.01
133,If It Wasn't For Trucks,Riley Green,8,-3,11,3,0,21500,12900,8600,529512,2024.02.01
134,Star Spangled Banner,Abby Anderson,4,-1,5,3,0,19200,3200,16000,0,2024.02.01
135,I GOT AWAY WITH YOU,Luke Combs,9,1,8,1,0,18500,-300,18800,292617,2024.02.01
136,Just Drive,Erin Kinsey,6,6,0,6,0,18400,18400,0,87395,2024.02.01
136,When Will I Be Loved,"Ashley McBryde, Caylee Hammack & Pillbox Patti",6,6,0,6,0,18400,18400,0,27451,2024.02.01
136,Polaroid,Keith Urban,6,6,0,6,0,18400,18400,0,11557,2024.02.01
139,You In A Honky Tonk,Randall King,2,1,1,2,0,18300,3200,15100,312793,2024.02.01
140,Give Me A Sunrise,Braxton Keith,4,-4,8,1,0,18000,-800,18800,27003,2024.02.01
141,"Houston, We Got A Problem",Luke Combs,6,-4,10,1,0,17900,-8300,26200,1056271,2024.02.01
142,God Moments,Conner Smith,4,4,0,2,0,17300,17300,0,125124,2024.02.01
143,What Else Is New,Cody Jinks,9,1,8,1,0,16800,100,16700,78403,2024.02.01
144,Star Spangled Banner,Mickey Guyton,2,-1,3,2,0,16800,3700,13100,0,2024.02.01
145,Wreckage,Nate Smith,11,4,7,1,0,15600,800,14800,680890,2024.02.01
146,Classic,Ernest,8,3,5,1,0,15200,12200,3000,29695,2024.02.01
147,Way Down Yonder,Chase Rice,2,2,0,1,0,15200,15200,0,59067,2024.02.01
148,Any Given Friday Night,Luke Combs,2,0,2,1,0,15200,0,15200,186286,2024.02.01
149,Lovin' Where It's Goin',Josh Ward,1,1,0,1,0,15100,15100,0,36590,2024.02.01
149,Four Minutes,Chad Cooke Band,1,1,0,1,0,15100,15100,0,2044,2024.02.01
149,We Ain't The Only Ones,Randy Rogers & Wade Bowen,1,1,0,1,0,15100,15100,0,0,2024.02.01
149,A Life Where We Work Out,Flatland Cavalry,1,1,0,1,0,15100,15100,0,945071,2024.02.01
153,Open The Gate,Zach Bryan,1,0,1,1,0,15100,0,15100,1083041,2024.02.01
153,Work Boots,Cody Johnson,1,0,1,1,0,15100,0,15100,439678,2024.02.01
155,Days That End In Why,Morgan Wallen,8,1,7,2,0,14700,800,13900,1076449,2024.02.01
156,Three Little Birds,Kacey Musgraves,2,2,0,2,0,14600,14600,0,2960886,2024.02.01
156,Three Little Birds,Kacey Musgraves,2,2,0,2,0,14600,14600,0,0,2024.02.01
158,Roulette On The Heart,Conner Smith,3,3,0,3,0,13900,13900,0,1017204,2024.02.01
159,In Love With My Problems,Larry Fleet Feat. Jon Pardi,8,3,5,1,0,13400,9200,4200,87913,2024.02.01
160,Up In Texas,Midland,2,1,1,1,0,13300,-1800,15100,273050,2024.02.01
161,Bad Man,Twinnie,17,17,0,17,0,12300,12300,0,948,2024.02.01
162,But A Beer Can,Eric Burgett,17,0,17,17,0,12300,0,12300,5080,2024.02.01
163,Two Woman Man,Randall Fowler,17,-34,51,17,0,12300,-24600,36900,460,2024.02.01
164,Silverado,Caleb Lee Hutchinson,17,-51,68,17,0,12300,-36900,49200,13402,2024.02.01
164,She's Gotta Know,Conner Sweet,17,-51,68,17,0,12300,-36900,49200,840,2024.02.01
166,Raise The Roof,Christian Beck,7,0,7,1,0,11800,-1800,13600,141,2024.02.01
167,Dirty Looks,Lainey Wilson,3,-1,4,2,0,11700,-4200,15900,912935,2024.02.01
168,Sun To Me,Zach Bryan,8,-1,9,1,0,11600,-5600,17200,4537569,2024.02.01
169,Fake Id,Sydney Mack,7,0,7,1,0,11000,3200,7800,1016,2024.02.01
170,Don't Think Jesus,Morgan Wallen,2,-7,9,2,0,10900,-18000,28900,1033924,2024.02.01
171,The Ending,Jake Owen,2,2,0,1,0,10800,10800,0,2878,2024.02.01
172,Tennessee Love Song,Anella Herim,2,0,2,1,0,10800,3700,7100,261754,2024.02.01
173,How Do You Miss Me,Dallas Smith,2,0,2,1,0,10800,0,10800,14720,2024.02.01
174,Whatever Gets You Through It,Morgan Gruber,7,0,7,1,0,10700,-2300,13000,351,2024.02.01
175,Red Kingdom,Tech N9ne,3,2,1,1,0,10500,5600,4900,498572,2024.02.01
176,Narcissist,Avery Anna,2,-1,3,1,0,10400,-9700,20100,476108,2024.02.01
177,Mountain With A View,Kelsea Ballerini,8,3,5,1,0,10300,4900,5400,934190,2024.02.01
178,BELLS,Rachelle Garniez,1,0,1,1,0,10200,0,10200,0,2024.02.01
179,Transit,James Forest,2,2,0,1,0,10000,10000,0,1,2024.02.01
180,I Could Be That Rain,Randall King,4,4,0,4,0,9900,9900,0,629257,2024.02.01
181,Pay Me Back In Change,MacKenzie Porter,1,1,0,1,0,9900,9900,0,63652,2024.02.01
182,Ain't Missin' You,Dylan Schneider,13,-3,16,2,0,9800,1400,8400,748304,2024.02.01
183,Holy Smoke,Frank Vieira,11,2,9,1,0,8800,2300,6500,236,2024.02.01
184,Love Can Build A Bridge,"Jelly Roll, K. Michelle & The Fisk Jubilee Singers",1,1,0,1,0,8700,8700,0,34829,2024.02.01
185,I'Ve Seen Me Do It,Joe Peters,2,1,1,1,0,8700,2500,6200,308,2024.02.01
186,I'M Not Blonde,Meredith Foster,8,-1,9,1,0,8700,-8900,17600,21,2024.02.01
187,"1, 2 Many",Luke Combs & Brooks & Dunn,1,1,0,1,0,8600,8600,0,1087966,2024.02.01
188,Heart To Break,Ryan Griffin,19,1,18,1,0,8400,-3600,12000,114922,2024.02.01
189,Arkansas,Chris Stapleton,6,0,6,1,0,8400,0,8400,449867,2024.02.01
190,Rub A Little Dirt On It,Randy Houser,1,1,0,1,0,8300,8300,0,197763,2024.02.01
191,Buckles And Broken Hearts,Joe Peters,1,0,1,1,0,8300,6200,2100,1346,2024.02.01
192,National Anthem,Pryor & Lee,2,1,1,2,0,8000,-2700,10700,0,2024.02.01
193,Loud and Heavy,Cody Jinks,4,-2,6,1,0,8000,-2200,10200,1510707,2024.02.01
194,Like A Cowboy,Parker Mccollum,2,2,0,2,0,7800,7800,0,418713,2024.02.01
195,"Jesus, Won't You Come By Here",Hank Williams Jr.,1,1,0,1,0,7800,7800,0,4934,2024.02.01
195,Star Spangled Banner,Demi Lovato,1,1,0,1,0,7800,7800,0,115,2024.02.01
195,Safe Haven,Hillary Scott & The Scott Family,1,1,0,1,0,7800,7800,0,5804,2024.02.01
198,Run It Back,Blane Howard,2,1,1,2,0,7700,2800,4900,29403,2024.02.01
199,John Deere Green,"HIXTAPE Feat. HARDY, Morgan Wallen, Joe Diffie",1,-1,2,1,0,7700,-8600,16300,0,2024.02.01
200,Burns Like Her,Randall King,2,2,0,2,0,7600,7600,0,1170129,2024.02.01
1,World On Fire,Nate Smith,7385,-139,7524,144,0,31372500,-764600,32137100,5518901,2024.02.08
2,Different 'Round Here,Riley Green,7759,1076,6683,144,0,28135900,3346700,24789200,2846778,2024.02.08
3,Pretty Little Poison,Warren Zeiders,7158,384,6774,143,0,26970500,2838100,24132400,9901370,2024.02.08
4,The Painter,Cody Johnson,6555,242,6313,144,0,24922800,980300,23942500,8123451,2024.02.08
5,Save Me,Jelly Roll & Lainey Wilson,5503,-370,5873,139,0,24207000,-473800,24680800,6473507,2024.02.08
6,Where The Wild Things Are,Luke Combs,6173,62,6111,144,0,23216700,589300,22627400,8983113,2024.02.08
7,Truck Bed,Hardy,5752,355,5397,142,0,21318300,1156900,20161400,7156315,2024.02.08
8,I Can Feel It,Kane Brown,5526,318,5208,144,0,20493600,849100,19644500,3402174,2024.02.08
9,Mamaw's House,Thomas Rhett,5290,712,4578,143,0,19791900,3232700,16559200,3116505,2024.02.08
10,Burn It Down,Parker Mccollum,4409,434,3975,143,0,16042600,1852700,14189900,6477630,2024.02.08
11,All I Need Is You,Chris Janson,4093,-3498,7591,144,0,15963100,-10661700,26624800,363225,2024.02.08
12,23,Chayce Beckham,4591,182,4409,144,0,15901200,1061500,14839700,4389704,2024.02.08
13,Man Made A Bar,Morgan Wallen,3709,649,3060,143,0,14738700,2450300,12288400,5833434,2024.02.08
14,Creek Will Rise,Conner Smith,4243,210,4033,144,0,14400000,1079700,13320300,2280353,2024.02.08
15,Tucson Too Late,Jordan Davis,3398,199,3199,143,0,11558800,1173200,10385600,1816224,2024.02.08
16,Cab In A Solo,Scotty McCreery,3383,238,3145,144,0,11118600,808200,10310400,652551,2024.02.08
17,Wildflowers And Wild Horses,Lainey Wilson,3159,83,3076,144,0,10827500,567700,10259800,3331358,2024.02.08
18,Back Then Right Now,Tyler Hubbard,3007,270,2737,144,0,9623400,1325300,8298100,1994609,2024.02.08
19,Fearless,Jackson Dean,3197,7,3190,142,0,9515000,281400,9233600,945287,2024.02.08
20,We Don'T Fight Anymore,Carly Pearce,2946,193,2753,142,0,9144600,614300,8530300,4803801,2024.02.08
21,Glory Days,Gabby Barrett,2774,-111,2885,143,0,7788600,5000,7783600,1796221,2024.02.08
22,Take Her Home,Kenny Chesney,2520,221,2299,144,0,7743200,526600,7216600,1063076,2024.02.08
23,Your Place,Ashley Cooke,2140,251,1889,132,0,7245300,847900,6397400,1541656,2024.02.08
24,Outskirts,Sam Hunt,2092,326,1766,137,0,6410200,1153300,5256900,1541184,2024.02.08
25,I'M Not Pretty,Megan Moroney,2062,228,1834,139,0,6323200,853800,5469400,2183144,2024.02.08
26,Out Of That Truck,Carrie Underwood,2148,7,2141,138,0,6228100,-357100,6585200,1085274,2024.02.08
27,Let Your Boys Be Country,Jason Aldean,1707,62,1645,133,0,5887800,364300,5523500,1686777,2024.02.08
28,Where It Ends,Bailey Zimmerman,1897,205,1692,138,0,5753700,752000,5001700,4426798,2024.02.08
29,I Remember Everything,Zach Bryan Feat. Kacey Musgraves,1812,10,1802,136,0,5444300,-26100,5470400,22497879,2024.02.08
30,Halfway To Hell,Jelly Roll,1480,211,1269,121,0,5361000,758000,4603000,2213120,2024.02.08
31,Can't Break Up Now,Old Dominion,1933,53,1880,143,0,5237600,176000,5061600,1429806,2024.02.08
32,We Ride,Bryan Martin,1403,173,1230,96,0,4824300,535200,4289100,3584766,2024.02.08
33,Love You Again,Chase Matthew,1683,90,1593,136,0,4358500,583400,3775100,2135381,2024.02.08
34,Young Love & Saturday Nights,Chris Young,1273,150,1123,110,0,3857800,260500,3597300,908605,2024.02.08
35,Cowboys And Plowboys,Jon Pardi Feat. Luke Bryan,1082,111,971,116,0,3091300,421500,2669800,445975,2024.02.08
36,Gonna Love You,Parmalee,1116,85,1031,101,0,2682200,221100,2461100,256378,2024.02.08
37,Spirits And Demons,Michael Ray With Meghan Patrick,958,-39,997,106,0,2590200,11200,2579000,208052,2024.02.08
38,Drinkin' Problems,Dillon Carmichael,1303,45,1258,131,0,2531400,23200,2508200,33150,2024.02.08
39,This Is My Dirt,Justin Moore,982,94,888,103,0,2237300,591500,1645800,358872,2024.02.08
40,Rodeo Man,Garth Brooks & Ronnie Dunn,1276,122,1154,138,0,2143400,-68200,2211600,1483062,2024.02.08
41,Dance With You,Brett Young,878,-14,892,84,0,2042000,-67000,2109000,1667455,2024.02.08
42,Sounds Like The Radio,Zach Top,723,111,612,78,0,1783700,265500,1518200,252346,2024.02.08
43,In Your Love,Tyler Childers,814,39,775,82,0,1755600,233100,1522500,4149335,2024.02.08
44,Chevrolet,Dustin Lynch Feat. Jelly Roll,644,13,631,71,0,1633800,-71300,1705100,2037461,2024.02.08
45,Find Another Bar,Chris Lane,674,18,656,71,0,1345800,56000,1289800,221531,2024.02.08
46,Pickup Man (Feat. Post Malone),Hixtape & Joe Diffie,282,-27,309,57,0,1315400,-11600,1327000,541847,2024.02.08
47,Love You Back,Lady A,684,89,595,111,0,1242900,299800,943100,153558,2024.02.08
48,One Bad Habit,Tim McGraw,603,82,521,80,0,1220800,281100,939700,110830,2024.02.08
49,I'm In Love,Hailey Whitters,540,84,456,69,0,1205300,298600,906700,405852,2024.02.08
50,She's Somebody's Daughter,Drew Baldridge,608,32,576,75,0,1066200,155100,911100,433751,2024.02.08
51,Brokenhearted,Joe Nichols,644,47,597,66,0,1049400,87900,961500,9478,2024.02.08
52,Boys Back Home,Dylan Marlowe Feat. Dylan Scott,474,87,387,66,0,915400,264200,651200,2991317,2024.02.08
53,Ain'T About You,Huntergirl,584,14,570,74,0,892500,36200,856300,17209,2024.02.08
54,Bigger Houses,Dan + Shay,341,232,109,69,0,792500,587900,204600,588540,2024.02.08
55,King Of Country Music,Ryan Larkins,358,28,330,49,0,709100,88300,620800,27420,2024.02.08
56,Breakin' In Boots,Matt Stell,437,20,417,66,0,622600,36400,586200,508241,2024.02.08
57,Dirt Cheap,Cody Johnson,107,34,73,10,0,621900,99300,522600,3353233,2024.02.08
58,Long Live Cowgirls,Ian Munsick & Cody Johnson,265,-40,305,33,0,600100,-123200,723300,862681,2024.02.08
59,Make Me Wanna Smoke,Runaway June,368,10,358,41,0,544300,79000,465300,19307,2024.02.08
60,I Tried A Ring On,Tigirlily Gold,297,6,291,45,0,515400,-140700,656100,302342,2024.02.08
61,Wondering Why,Red Clay Strays,50,5,45,4,0,402600,-12100,414700,5144629,2024.02.08
62,Cancel,Randy Houser,315,14,301,43,0,395300,105600,289700,52766,2024.02.08
63,Last Rodeo,Restless Road,239,129,110,41,0,332900,146300,186600,1890415,2024.02.08
64,No News,A Thousand Horses,57,57,0,56,0,303800,303800,0,32865,2024.02.08
65,This Side Of The Dirt,Neon Union,294,-25,319,41,0,290800,-95700,386500,31899,2024.02.08
66,Neon Baby,Annie Bosko,170,25,145,34,0,273400,78800,194600,25605,2024.02.08
67,Rain In The Rearview,Anne Wilson,273,7,266,40,0,243700,-1400,245100,968146,2024.02.08
68,Beauty Queen,Jd Clayton,52,52,0,37,0,231300,231300,0,2983,2024.02.08
69,Million Little Bandaids,Caroline Jones,230,13,217,33,0,224400,3000,221400,18773,2024.02.08
70,Heart They Didn'T Break,Maddie & Tae,185,-12,197,26,0,205500,-82400,287900,512793,2024.02.08
71,No Caller Id,Megan Moroney,53,44,9,5,0,195300,150200,45100,5221708,2024.02.08
72,It's A Great Day To Be Alive (Live From The Ryman),Ben Rector,41,41,0,33,0,186200,186200,0,203161,2024.02.08
73,Coal,Dylan Gossett,30,10,20,18,0,185900,96500,89400,5913669,2024.02.08
74,Life With You,Kelsey Hart,178,42,136,31,0,181300,79700,101600,2146195,2024.02.08
75,Outlaws And Mustangs,Cody Jinks,35,8,27,4,0,175000,51800,123200,186324,2024.02.08
76,Spin You Around (1/24),Morgan Wallen,61,-59,120,7,0,172000,-438600,610600,9614437,2024.02.08
77,Love Can Build A Bridge,"Jelly Roll, K. Michelle & The Fisk Jubilee Singers",16,15,1,16,0,146900,138200,8700,36715,2024.02.08
78,Think I’m In Love With You,Chris Stapleton,54,31,23,7,0,140700,66700,74000,2585942,2024.02.08
79,Sarah's Place,Zach Bryan,17,1,16,1,0,126000,9600,116400,3221088,2024.02.08
80,How Is She,Cole Swindell,14,-5,19,1,0,106800,-17600,124400,48060,2024.02.08
81,Things I Take For Granted,Larry Fleet,41,10,31,5,0,99200,23100,76100,1314684,2024.02.08
82,Don'T Know Myself,Smithfield,49,49,0,48,0,99000,99000,0,44753,2024.02.08
82,Jealous Of Jane,Lauren Watkins,49,49,0,48,0,99000,99000,0,7017,2024.02.08
82,Evolution,Sheryl Crow,49,49,0,48,0,99000,99000,0,39409,2024.02.08
85,Jack And Diet Coke,Redferrin,30,-2,32,2,0,95100,-4300,99400,1402894,2024.02.08
86,This Town's Been Too Good To Us,Dylan Scott,19,7,12,7,0,94400,48000,46400,3380626,2024.02.08
87,Colorado,Florida Georgia Line,13,0,13,2,0,77700,1500,76200,44347,2024.02.08
88,Forever Bound,12/Oc,30,3,27,1,0,76500,8600,67900,2075,2024.02.08
89,Hey Driver,Zach Bryan Feat. The War and Treaty,26,7,19,3,0,73300,45700,27600,7431982,2024.02.08
90,With You I Am,Cody Johnson,8,0,8,2,0,71500,-4500,76000,1728929,2024.02.08
91,How You Get To Heaven,Ty Herndon,6,0,6,1,0,63900,-3900,67800,543,2024.02.08
92,Wild Ones,Jessie Murph & Jelly Roll,30,6,24,4,0,63300,18500,44800,13166609,2024.02.08
93,Thicc As Thieves,Lauren Alaina,67,-20,87,15,0,57900,-27200,85100,772880,2024.02.08
94,West Of Tulsa,Wyatt Flores,21,0,21,2,0,57300,-14700,72000,259927,2024.02.08
95,Broadway Girls,Lil Durk Feat. Morgan Wallen,14,-4,18,2,0,57100,-10000,67100,3888410,2024.02.08
96,This Heart,Corey Kent,20,18,2,4,0,56300,51200,5100,2398912,2024.02.08
97,25-8,Larry Fleet,12,-1,13,1,0,53400,-13300,66700,42797,2024.02.08
98,Straight Line,Keith Urban,12,12,0,9,0,50700,50700,0,1598332,2024.02.08
99,Thinkin Bout Cheatin,Mae Estes,68,68,0,17,0,49200,49200,0,24259,2024.02.08
100,I Need You,Frontmen,14,-9,23,3,0,48000,-14800,62800,768,2024.02.08
101,I Like Big Trucks,Alli Walker,16,0,16,1,0,47400,-4700,52100,0,2024.02.08
102,When My Baby's In Boots,Randall King,4,1,3,1,0,47000,16200,30800,0,2024.02.08
103,Up In Texas,Midland,5,3,2,2,0,46000,32700,13300,233481,2024.02.08
104,Holy Water,Michael Ray,8,0,8,3,0,44200,-7500,51700,227267,2024.02.08
105,Pray All The Way Home,Austin Snell,55,-13,68,18,0,44200,-5000,49200,1087652,2024.02.08
106,No Present LIke The Time,Jay Allen,63,-8,71,12,0,39100,-1100,40200,0,2024.02.08
107,Wine Country,Hannah Ellis,28,-9,37,11,0,37400,-36600,74000,17804,2024.02.08
108,She's Gotta Know,Conner Sweet,51,34,17,17,0,36900,24600,12300,1337,2024.02.08
109,Always You,Trey Lewis,51,17,34,17,0,36900,12300,24600,146178,2024.02.08
110,Walk Away Slow,Austin English,51,2,49,17,0,36900,900,36000,1253,2024.02.08
111,Hungover You,Emily Brooke,12,12,0,6,0,36800,36800,0,669,2024.02.08
112,Make You Mine,Marynn Taylor,12,0,12,6,0,36800,0,36800,19684,2024.02.08
113,Quittin' Time,Morgan Wallen,12,12,0,12,0,35900,35900,0,905627,2024.02.08
114,Trouble,Josh Ross,41,-11,52,6,0,35100,2500,32600,1896822,2024.02.08
115,The Star-Spangled Banner,Chris Stapleton,8,-4,12,8,0,34400,-15900,50300,97649,2024.02.08
116,The Star-Spangled Banner,Carly Pearce,3,-1,4,3,0,33600,1600,32000,0,2024.02.08
117,Tulsa,Elle King,10,-2,12,1,0,29400,-4200,33600,40401,2024.02.08
118,God Moments,Conner Smith,6,2,4,1,0,28700,11400,17300,66896,2024.02.08
119,Sayin' What I'm Thinkin',Lainey Wilson,17,0,17,1,0,27300,-7600,34900,167401,2024.02.08
120,Star Spangled Banner,Abby Anderson,5,1,4,4,0,27200,8000,19200,0,2024.02.08
121,What Good Am I,Zack Dyer,5,4,1,1,0,27000,21600,5400,8232,2024.02.08
122,If It Wasn't For Trucks,Riley Green,9,1,8,8,0,25900,4400,21500,502215,2024.02.08
123,Outrunnin' Your Memory,Luke Combs & Miranda Lambert,7,7,0,6,0,24800,24800,0,400882,2024.02.08
124,Black Magic,Rachel Lipsky,34,34,0,17,0,24600,24600,0,60,2024.02.08
125,Silverado,Caleb Lee Hutchinson,34,17,17,17,0,24600,12300,12300,15434,2024.02.08
126,A Cowboy Who Would,Chancey Williams,34,-33,67,17,0,24600,-73800,98400,107777,2024.02.08
127,Red Kingdom,Tech N9ne,5,2,3,1,0,24500,14000,10500,374762,2024.02.08
128,Holy Roller,Zach Bryan,13,0,13,1,0,23400,-4900,28300,1249106,2024.02.08
129,Let's Go Fishing,Aaron Lewis,16,0,16,1,0,23300,-7300,30600,0,2024.02.08
130,'98 Braves,Morgan Wallen,3,2,1,2,0,23000,19100,3900,1953198,2024.02.08
131,I'M Not For Everyone,Brothers Osborne,4,-13,17,3,0,23000,-8500,31500,429312,2024.02.08
132,Amy's Back In Austin,Eli Young Band & George Birge,10,-46,56,9,0,22300,-283300,305600,14647,2024.02.08
133,"Salt, Lime & Tequila",Ryan Griffin,6,6,0,2,0,22100,22100,0,59408,2024.02.08
134,Fake Names,Priscilla Block,6,-14,20,1,0,21900,-33400,55300,78760,2024.02.08
135,Cowgirls,Morgan Wallen,10,1,9,3,0,20700,-5600,26300,6037820,2024.02.08
136,I'M Not Blonde,Meredith Foster,9,1,8,1,0,20600,11900,8700,26,2024.02.08
137,Ain't Missin' You,Dylan Schneider,16,3,13,3,0,20000,10200,9800,775069,2024.02.08
138,Blackout Betty,Ashley McBryde,3,1,2,1,0,19800,15100,4700,40154,2024.02.08
139,Playboys,Midland,9,9,0,1,0,19600,19600,0,70261,2024.02.08
140,Strangers,Kameron Marlowe & Ella Langley,5,0,5,2,0,19300,-7800,27100,2063554,2024.02.08
141,San Antone,Randy Rogers Band,2,0,2,2,0,18900,16400,2500,20073,2024.02.08
142,21 Forever,Chris Janson,6,6,0,6,0,18400,18400,0,9825,2024.02.08
142,Raised Up Right,Riley Green,6,6,0,6,0,18400,18400,0,142055,2024.02.08
142,Damn Country Music,Riley Green,6,6,0,6,0,18400,18400,0,193256,2024.02.08
142,Mississippi Or Me,Riley Green,6,6,0,6,0,18400,18400,0,1075781,2024.02.08
146,Just Drive,Erin Kinsey,6,0,6,6,0,18400,0,18400,91423,2024.02.08
146,When Will I Be Loved,"Ashley McBryde, Caylee Hammack & Pillbox Patti",6,0,6,6,0,18400,0,18400,29367,2024.02.08
148,How 'Bout Those Chiefs,Blane Howard,5,0,5,2,0,18200,-7600,25800,5304,2024.02.08
149,Heartless,Diplo & Julia Michaels Feat. Morgan Wallen,5,3,2,4,0,17300,11500,5800,5053342,2024.02.08
150,I GOT AWAY WITH YOU,Luke Combs,7,-2,9,1,0,17300,-1200,18500,300671,2024.02.08
151,Must Be The Whiskey,Cody Jinks,8,1,7,2,0,16600,-12600,29200,1375871,2024.02.08
152,Songs We Used To Sing,Ernest,7,1,6,1,0,16600,10800,5800,46542,2024.02.08
153,Codigo,George Strait,1,1,0,1,0,16400,16400,0,26647,2024.02.08
154,If I Had A Bar,Jon Wolfe,4,-2,6,2,0,16400,-10600,27000,8276,2024.02.08
155,Quittin' Time,Zach Bryan,3,2,1,1,0,16300,15700,600,911644,2024.02.08
156,You'Re Gonna Love Me,Tim Dugger,3,1,2,1,0,16300,16300,0,5157,2024.02.08
157,How Do You Miss Me,Dallas Smith,3,1,2,1,0,16200,5400,10800,14660,2024.02.08
158,My Bar,Priscilla Block,3,0,3,2,0,16200,-20800,37000,129336,2024.02.08
159,National Anthem From Battle At Bristol,Jennifer Nettles,3,0,3,3,0,16000,-6800,22800,0,2024.02.08
160,Goodbye Looks Good On You,Alana Springsteen Feat. Mitchell Tenpenny,10,-7,17,1,0,16000,-12100,28100,897824,2024.02.08
161,Pop Goes The Whiskey (Feat. Ernest),Jake Worthington,2,2,0,1,0,15700,15700,0,2404,2024.02.08
162,What Else Is New,Cody Jinks,7,-2,9,1,0,15600,-1200,16800,83216,2024.02.08
163,Any Given Friday Night,Luke Combs,2,0,2,1,0,15200,0,15200,200853,2024.02.08
164,Young Man's Blues,Parker Mccollum,1,1,0,1,0,15100,15100,0,517652,2024.02.08
164,Like A Hurricane,Cody Jinks,1,1,0,1,0,15100,15100,0,89044,2024.02.08
164,Leave Her Wild,Sundance Head,1,1,0,1,0,15100,15100,0,2380,2024.02.08
164,If You Can Dance,Jon Stork,1,1,0,1,0,15100,15100,0,1162,2024.02.08
168,We Ain't The Only Ones,Randy Rogers & Wade Bowen,1,0,1,1,0,15100,0,15100,0,2024.02.08
169,Giving You Up,Kameron Marlowe,3,-1,4,2,0,14900,14900,0,903662,2024.02.08
170,"Houston, We Got A Problem",Luke Combs,7,1,6,2,0,14700,-3200,17900,1153860,2024.02.08
171,Oklahoma Sun,Koe Wetzel,3,2,1,1,0,14500,13400,1100,97954,2024.02.08
172,National Anthem,Pryor & Lee,3,1,2,3,0,14200,6200,8000,0,2024.02.08
173,When It Comes To Loving You,Jon Langston,4,1,3,1,0,14200,11600,2600,94023,2024.02.08
174,Hits me,Lindsay Ell,5,5,0,5,0,14000,14000,0,1269,2024.02.08
175,Give Me A Sunrise,Braxton Keith,3,-1,4,1,0,13900,-4100,18000,27886,2024.02.08
176,This Is The Church,Steeles,2,2,0,2,0,13700,13700,0,251,2024.02.08
177,Raise The Roof,Christian Beck,7,0,7,1,0,13600,1800,11800,188,2024.02.08
178,The Great Divide,Luke Combs & Billy Strings,6,2,4,1,0,13400,7100,6300,191915,2024.02.08
179,Open The Gate,Zach Bryan,2,1,1,1,0,13300,-1800,15100,1068884,2024.02.08
180,Devil You Know,Tyler Braden,2,2,0,2,0,13000,13000,0,1618566,2024.02.08
181,Better Off,Trace Adkins,3,1,2,1,0,12900,12900,0,15463,2024.02.08
182,Loud and Heavy,Cody Jinks,6,2,4,1,0,12700,4700,8000,1562815,2024.02.08
183,Think About There,Greater Vision,2,1,1,2,0,12700,6300,6400,18326,2024.02.08
184,Country A$$ Shit,Morgan Wallen,2,2,0,1,0,12600,12600,0,509615,2024.02.08
185,But A Beer Can,Eric Burgett,17,0,17,17,0,12300,0,12300,5134,2024.02.08
186,One Two Step,Gunnar Latham,17,-28,45,17,0,12300,-20300,32600,949,2024.02.08
187,Heart Attack,Boy Named Banjo,10,-2,12,1,0,12200,-10200,22400,3866,2024.02.08
188,Stop Coming Over,Chris Lane,5,-7,12,5,0,12000,-24800,36800,26371,2024.02.08
189,Narcissist,Avery Anna,3,1,2,1,0,11900,1500,10400,453471,2024.02.08
190,Bulletproof,Nate Smith,3,3,0,2,0,11800,11800,0,597,2024.02.08
191,Whatever Gets You Through It,Morgan Gruber,6,-1,7,1,0,11200,500,10700,320,2024.02.08
192,Wild as You,Cody Johnson,4,4,0,2,0,10900,10900,0,1478007,2024.02.08
193,Days That End In Why,Morgan Wallen,6,-2,8,1,0,10900,-3800,14700,990410,2024.02.08
194,Somewhere Cool With You,Adam Doleac,2,2,0,1,0,10800,10800,0,25925,2024.02.08
195,BELLS,Rachelle Garniez,1,0,1,1,0,10200,0,10200,0,2024.02.08
196,The Star Spangled Banner,Brad Paisley,2,1,1,2,0,10000,9600,400,0,2024.02.08
197,Sun To Me,Zach Bryan,6,-2,8,2,0,9900,-1700,11600,4695937,2024.02.08
198,Come Back,November Blue,6,-1,7,1,0,9800,2300,7500,878,2024.02.08
199,Mama's Rocking Chair,Ivan Parker,1,1,0,1,0,9500,9500,0,288,2024.02.08
199,First Church Of Mercy,Sound,1,1,0,1,0,9500,9500,0,2423,2024.02.08
199,When They Ring The Bells Of Heaven,Goodman Revival,1,1,0,1,0,9500,9500,0,10810,2024.02.08
1,Pretty Little Poison,Warren Zeiders,7464,306,7158,144,0,28899700,1929200,26970500,9628296,2024.02.15
2,Where The Wild Things Are,Luke Combs,7714,1541,6173,144,0,28146700,4930000,23216700,8803690,2024.02.15
3,The Painter,Cody Johnson,6755,200,6555,144,0,26161900,1239100,24922800,8305300,2024.02.15
4,I Can Feel It,Kane Brown,6045,519,5526,144,0,22548200,2054600,20493600,3241587,2024.02.15
5,Truck Bed,Hardy,6058,306,5752,143,0,22505900,1187600,21318300,6800173,2024.02.15
6,Save Me,Jelly Roll & Lainey Wilson,5181,-322,5503,140,0,22403000,-1804000,24207000,6784263,2024.02.15
7,Mamaw's House,Thomas Rhett,5919,629,5290,143,0,22247900,2456000,19791900,3139132,2024.02.15
8,Different 'Round Here,Riley Green,4988,-2771,7759,144,0,19145100,-8990800,28135900,2826491,2024.02.15
9,Burn It Down,Parker Mccollum,4592,183,4409,144,0,17103700,1061100,16042600,6222110,2024.02.15
10,23,Chayce Beckham,4738,147,4591,144,0,16954200,1053000,15901200,4979703,2024.02.15
11,Man Made A Bar,Morgan Wallen,4261,552,3709,143,0,16540900,1802200,14738700,5566433,2024.02.15
12,Creek Will Rise,Conner Smith,4278,35,4243,144,0,14902900,502900,14400000,2142104,2024.02.15
13,Tucson Too Late,Jordan Davis,3544,146,3398,143,0,13031600,1472800,11558800,1627919,2024.02.15
14,Cab In A Solo,Scotty McCreery,3618,235,3383,144,0,12114900,996300,11118600,656840,2024.02.15
15,Wildflowers And Wild Horses,Lainey Wilson,3562,403,3159,144,0,11819400,991900,10827500,3448172,2024.02.15
16,Back Then Right Now,Tyler Hubbard,3410,403,3007,143,0,11293300,1669900,9623400,1972621,2024.02.15
17,Fearless,Jackson Dean,3269,72,3197,142,0,10233700,718700,9515000,905471,2024.02.15
18,We Don'T Fight Anymore,Carly Pearce,2963,17,2946,142,0,9732600,588000,9144600,4569147,2024.02.15
19,Take Her Home,Kenny Chesney,2793,273,2520,144,0,8891300,1148100,7743200,1064228,2024.02.15
20,Glory Days,Gabby Barrett,2720,-54,2774,143,0,7984000,195400,7788600,1314790,2024.02.15
21,Your Place,Ashley Cooke,2383,243,2140,136,0,7743700,498400,7245300,1579056,2024.02.15
22,Outskirts,Sam Hunt,2329,237,2092,137,0,7630300,1220100,6410200,1385087,2024.02.15
23,Where It Ends,Bailey Zimmerman,2170,273,1897,138,0,6740900,987200,5753700,4383403,2024.02.15
24,I'M Not Pretty,Megan Moroney,2065,3,2062,140,0,6657500,334300,6323200,1911909,2024.02.15
25,Halfway To Hell,Jelly Roll,1805,325,1480,140,0,6607500,1246500,5361000,2195085,2024.02.15
26,Out Of That Truck,Carrie Underwood,2186,38,2148,138,0,6398200,170100,6228100,1083121,2024.02.15
27,Let Your Boys Be Country,Jason Aldean,1773,66,1707,139,0,5784100,-103700,5887800,1638492,2024.02.15
28,Can't Break Up Now,Old Dominion,2070,137,1933,143,0,5643600,406000,5237600,1417157,2024.02.15
29,I Remember Everything,Zach Bryan Feat. Kacey Musgraves,1775,-37,1812,135,0,5273500,-170800,5444300,21770746,2024.02.15
30,We Ride,Bryan Martin,1471,68,1403,129,0,5045700,221400,4824300,3396292,2024.02.15
31,Love You Again,Chase Matthew,1626,-57,1683,134,0,4238500,-120000,4358500,1997619,2024.02.15
32,Young Love & Saturday Nights,Chris Young,1323,50,1273,115,0,3905500,47700,3857800,774822,2024.02.15
33,Cowboys And Plowboys,Jon Pardi Feat. Luke Bryan,1073,-9,1082,116,0,2801800,-289500,3091300,550402,2024.02.15
34,Purple Irises,Gwen Stefani & Blake Shelton,730,730,0,88,0,2732100,2732100,0,1682337,2024.02.15
35,Spirits And Demons,Michael Ray With Meghan Patrick,969,11,958,106,0,2690400,100200,2590200,188767,2024.02.15
36,Drinkin' Problems,Dillon Carmichael,1279,-24,1303,133,0,2645800,114400,2531400,30279,2024.02.15
37,Gonna Love You,Parmalee,1138,22,1116,103,0,2592500,-89700,2682200,242257,2024.02.15
38,Dance With You,Brett Young,1046,168,878,86,0,2514200,472200,2042000,1624507,2024.02.15
39,Bulletproof,Nate Smith,536,533,3,51,0,2497100,2485300,11800,3598713,2024.02.15
40,This Is My Dirt,Justin Moore,1008,26,982,109,0,2300800,63500,2237300,318265,2024.02.15
41,Rodeo Man,Garth Brooks & Ronnie Dunn,1254,-22,1276,138,0,2087600,-55800,2143400,1325455,2024.02.15
42,Sounds Like The Radio,Zach Top,766,43,723,91,0,1908400,124700,1783700,232605,2024.02.15
43,Chevrolet,Dustin Lynch Feat. Jelly Roll,715,71,644,78,0,1859000,225200,1633800,1938961,2024.02.15
44,In Your Love,Tyler Childers,776,-38,814,81,0,1653800,-101800,1755600,3573740,2024.02.15
45,One Bad Habit,Tim McGraw,743,140,603,106,0,1622700,401900,1220800,115519,2024.02.15
46,Bigger Houses,Dan + Shay,587,246,341,82,0,1483000,690500,792500,579886,2024.02.15
47,Find Another Bar,Chris Lane,693,19,674,79,0,1455400,109600,1345800,251667,2024.02.15
48,Pickup Man (Feat. Post Malone),Hixtape & Joe Diffie,289,7,282,59,0,1426600,111200,1315400,532287,2024.02.15
49,I'm In Love,Hailey Whitters,561,21,540,72,0,1333000,127700,1205300,373404,2024.02.15
50,She's Somebody's Daughter,Drew Baldridge,645,37,608,74,0,1278400,212200,1066200,420515,2024.02.15
51,Brokenhearted,Joe Nichols,628,-16,644,66,0,1194400,145000,1049400,9660,2024.02.15
52,Boys Back Home,Dylan Marlowe Feat. Dylan Scott,513,39,474,62,0,1102000,186600,915400,2766699,2024.02.15
53,Texas Hold 'Em,Beyonce,300,300,0,100,0,1098100,1098100,0,19436170,2024.02.15
54,Love You Back,Lady A,640,-44,684,98,0,1031100,-211800,1242900,145551,2024.02.15
55,Ain'T About You,Huntergirl,574,-10,584,74,0,907100,14600,892500,17468,2024.02.15
56,King Of Country Music,Ryan Larkins,352,-6,358,51,0,682600,-26500,709100,24598,2024.02.15
57,Dirt Cheap,Cody Johnson,130,23,107,14,0,680200,58300,621900,3023126,2024.02.15
58,Make Me Wanna Smoke,Runaway June,382,14,368,40,0,617600,73300,544300,16095,2024.02.15
59,Breakin' In Boots,Matt Stell,430,-7,437,59,0,590200,-32400,622600,690215,2024.02.15
60,I Tried A Ring On,Tigirlily Gold,322,25,297,60,0,575900,60500,515400,223417,2024.02.15
61,Long Live Cowgirls,Ian Munsick & Cody Johnson,220,-45,265,56,0,538100,-62000,600100,805022,2024.02.15
62,Last Rodeo,Restless Road,271,32,239,49,0,438100,105200,332900,1777929,2024.02.15
63,Pay Me Back In Change,MacKenzie Porter,105,104,1,57,0,397800,396100,1700,32970,2024.02.15
64,Think I’m In Love With You,Chris Stapleton,166,112,54,33,0,379100,238400,140700,2932070,2024.02.15
65,Cancel,Randy Houser,309,-6,315,41,0,357300,-38000,395300,51032,2024.02.15
66,White Buffalo,Ian Munsick,80,80,0,46,0,339100,339100,0,118673,2024.02.15
67,This Side Of The Dirt,Neon Union,283,-11,294,40,0,326200,35400,290800,27134,2024.02.15
68,Wondering Why,Red Clay Strays,40,-10,50,3,0,319700,-82900,402600,5064467,2024.02.15
69,Heartbreak King,Ian Munsick,70,70,0,37,0,316800,316800,0,0,2024.02.15
70,Spin You Around (1/24),Morgan Wallen,87,26,61,7,0,315700,143700,172000,7915443,2024.02.15
71,Life With You,Kelsey Hart,200,22,178,38,0,295600,114300,181300,2269610,2024.02.15
72,Rain In The Rearview,Anne Wilson,305,32,273,43,0,293000,49300,243700,872949,2024.02.15
73,Million Little Bandaids,Caroline Jones,263,33,230,36,0,285800,61400,224400,15690,2024.02.15
74,No Caller Id,Megan Moroney,81,28,53,4,0,236800,41500,195300,5044985,2024.02.15
75,Neon Baby,Annie Bosko,163,-7,170,30,0,208200,-65200,273400,16030,2024.02.15
76,Outlaws And Mustangs,Cody Jinks,37,2,35,4,0,192000,17000,175000,193828,2024.02.15
77,Heart They Didn'T Break,Maddie & Tae,131,-54,185,22,0,148300,-57200,205500,499512,2024.02.15
78,This Town's Been Too Good To Us,Dylan Scott,137,118,19,34,0,138400,44000,94400,3133340,2024.02.15
79,Sarah's Place,Zach Bryan,16,-1,17,1,0,133100,7100,126000,2947677,2024.02.15
80,How Is She,Cole Swindell,14,0,14,1,0,110900,4100,106800,45472,2024.02.15
81,I Need You,Frontmen,15,1,14,2,0,104200,56200,48000,837,2024.02.15
82,Fine Wine,Runaway June,48,48,0,48,0,95700,95700,0,84402,2024.02.15
83,The Reason I Stay,Abby Anderson,48,47,1,48,0,95700,91000,4700,183498,2024.02.15
84,Wild Ones,Jessie Murph & Jelly Roll,45,15,30,3,0,89500,26200,63300,12385153,2024.02.15
85,Colorado,Florida Georgia Line,14,1,13,2,0,84800,7100,77700,43480,2024.02.15
86,With You I Am,Cody Johnson,10,2,8,5,0,84400,12900,71500,1575172,2024.02.15
87,Jack And Diet Coke,Redferrin,30,0,30,4,0,81400,-13700,95100,1425664,2024.02.15
88,How You Get To Heaven,Ty Herndon,6,0,6,1,0,77100,13200,63900,575,2024.02.15
89,Hey Driver,Zach Bryan Feat. The War and Treaty,43,17,26,2,0,77000,3700,73300,6788396,2024.02.15
90,The Finger,Bryce Leatherwood,17,16,1,16,0,71700,68000,3700,35594,2024.02.15
91,Forever Bound,12/Oc,26,-4,30,1,0,67500,-9000,76500,2162,2024.02.15
92,Things I Take For Granted,Larry Fleet,31,-10,41,4,0,61200,-38000,99200,1395088,2024.02.15
93,I Like Big Trucks,Alli Walker,17,1,16,1,0,58000,10600,47400,0,2024.02.15
94,Broadway Girls,Lil Durk Feat. Morgan Wallen,14,0,14,2,0,53200,-3900,57100,3599573,2024.02.15
95,Pray All The Way Home,Austin Snell,70,15,55,18,0,52600,8400,44200,984289,2024.02.15
96,When My Baby's In Boots,Randall King,5,1,4,1,0,50000,3000,47000,0,2024.02.15
97,One Two Step,Gunnar Latham,68,51,17,17,0,49200,36900,12300,797,2024.02.15
98,The Star-Spangled Banner,Chris Stapleton,12,4,8,10,0,49000,14600,34400,116899,2024.02.15
99,West Of Tulsa,Wyatt Flores,17,-4,21,2,0,49000,-8300,57300,271961,2024.02.15
100,Devil You Know,Tyler Braden,16,14,2,2,0,47000,34000,13000,1768233,2024.02.15
101,Tulsa,Elle King,12,2,10,1,0,46200,16800,29400,38706,2024.02.15
102,Coal,Dylan Gossett,7,-23,30,2,0,45300,-140600,185900,6066481,2024.02.15
103,'98 Braves,Morgan Wallen,5,2,3,3,0,41900,18900,23000,1920242,2024.02.15
104,Silverado For Sale,Morgan Wallen,10,10,0,9,0,40400,40400,0,1260621,2024.02.15
105,25-8,Larry Fleet,9,-3,12,1,0,39400,-14000,53400,42972,2024.02.15
106,Up In Texas,Midland,6,1,5,2,0,39100,-6900,46000,252646,2024.02.15
107,Man Upstairs,Tim Dugger,9,9,0,1,0,37400,37400,0,0,2024.02.15
108,Holy Water,Michael Ray,4,-4,8,1,0,37300,-6900,44200,212965,2024.02.15
109,Silverado,Caleb Lee Hutchinson,51,17,34,17,0,36900,12300,24600,14346,2024.02.15
110,Always You,Trey Lewis,51,0,51,17,0,36900,0,36900,133779,2024.02.15
110,Walk Away Slow,Austin English,51,0,51,17,0,36900,0,36900,928,2024.02.15
112,This Heart,Corey Kent,17,-3,20,1,0,36200,-20100,56300,2038101,2024.02.15
113,Outrunnin' Your Memory,Luke Combs & Miranda Lambert,12,5,7,6,0,35400,10600,24800,402945,2024.02.15
114,16 Carriages,Beyonce,3,3,0,2,0,34700,34700,0,10542595,2024.02.15
115,If I Had A Bar,Jon Wolfe,4,0,4,2,0,33300,16900,16400,7373,2024.02.15
116,Wine Country,Hannah Ellis,23,-5,28,9,0,31700,-5700,37400,16468,2024.02.15
117,Damn Good Day To Leave,Riley Green,4,4,0,3,0,27900,27900,0,134633,2024.02.15
118,I Can'T Breathe,Parker Mccollum,2,-1,3,1,0,27800,24100,3700,948966,2024.02.15
119,No Present LIke The Time,Jay Allen,56,-7,63,11,0,26400,-12700,39100,0,2024.02.15
120,Star Spangled Banner,Abby Anderson,5,0,5,4,0,26200,-1000,27200,0,2024.02.15
121,A Cowboy Who Would,Chancey Williams,34,0,34,17,0,24600,0,24600,86801,2024.02.15
122,She's Gotta Know,Conner Sweet,34,-17,51,17,0,24600,-12300,36900,2143,2024.02.15
123,Thinkin Bout Cheatin,Mae Estes,34,-34,68,17,0,24600,-24600,49200,22673,2024.02.15
124,Cowgirls,Morgan Wallen,10,0,10,3,0,24100,3400,20700,6102604,2024.02.15
125,Heart Of A Small Town,Tim Dugger,4,3,1,1,0,23400,14200,9200,9998,2024.02.15
126,Think About There,Greater Vision,3,1,2,3,0,20000,7300,12700,16643,2024.02.15
127,Star Spangled Banner,Maren Morris,1,1,0,1,0,19500,19500,0,0,2024.02.15
128,Certified,Laura Bryna,26,17,9,2,0,19400,12700,6700,7793,2024.02.15
129,Heart Attack,Boy Named Banjo,9,-1,10,1,0,19400,7200,12200,3532,2024.02.15
130,Work Boots,Cody Johnson,2,2,0,1,0,19200,19200,0,387594,2024.02.15
131,Night Time Is My Time,Jake Worthington,2,0,2,1,0,19200,14500,4700,1199,2024.02.15
132,How 'Bout Those Chiefs,Blane Howard,4,-1,5,2,0,19000,800,18200,14438,2024.02.15
133,Denim & Rhinestones,Carrie Underwood,6,6,0,6,0,18400,18400,0,33513,2024.02.15
133,Hell Of A Way To Go,Riley Green,6,6,0,6,0,18400,18400,0,30566,2024.02.15
133,Along For The Ride,Jordan Harvey,6,6,0,6,0,18400,18400,0,14931,2024.02.15
136,Hungover You,Emily Brooke,6,-6,12,6,0,18400,-18400,36800,737,2024.02.15
137,Sayin' What I'm Thinkin',Lainey Wilson,14,-3,17,1,0,18300,-9000,27300,148251,2024.02.15
138,Loud and Heavy,Cody Jinks,7,1,6,1,0,18000,5300,12700,1468049,2024.02.15
139,Better Off,Trace Adkins,4,1,3,2,0,17700,4800,12900,17723,2024.02.15
140,Damn Good Time,Jordan Davis,1,1,0,1,0,17500,17500,0,143196,2024.02.15
141,Way Back When,Wayland,24,12,12,12,0,17200,8600,8600,1167,2024.02.15
142,Bayou Boy,Graham Barham,3,3,0,2,0,17200,17200,0,28571,2024.02.15
143,You'Re Gonna Love Me,Tim Dugger,2,-1,3,1,0,16500,200,16300,5248,2024.02.15
144,wAnt me back,Lindsay Ell,5,5,0,5,0,16300,16300,0,24254,2024.02.15
145,The Star-Spangled Banner,Carly Pearce,4,1,3,2,0,15700,-17900,33600,0,2024.02.15
146,How Do You Miss Me,Dallas Smith,3,0,3,1,0,15700,-500,16200,11916,2024.02.15
147,Holy Roller,Zach Bryan,12,-1,13,1,0,15400,-8000,23400,1177657,2024.02.15
148,Red Kingdom,Tech N9ne,4,-1,5,1,0,15400,-9100,24500,1059799,2024.02.15
149,National Anthem From Battle At Bristol,Jennifer Nettles,3,0,3,3,0,15300,-700,16000,0,2024.02.15
150,Any Given Friday Night,Luke Combs,2,0,2,1,0,15200,0,15200,201462,2024.02.15
151,If You Ever Get Lonely,Jake Bush,1,1,0,1,0,15100,15100,0,751,2024.02.15
151,Rhinestoned,"Randy Rogers ,Wade Bowen",1,1,0,1,0,15100,15100,0,19561,2024.02.15
151,Little Rain,Morgan Wallen,1,1,0,1,0,15100,15100,0,478461,2024.02.15
151,That's Texas,Cody Johnson,1,1,0,1,0,15100,15100,0,312660,2024.02.15
155,Oklahoma Sun,Koe Wetzel,4,1,3,1,0,15100,600,14500,97687,2024.02.15
156,When It Comes To Loving You,Jon Langston,3,-1,4,2,0,14900,700,14200,94735,2024.02.15
157,Giving You Up,Kameron Marlowe,4,1,3,2,0,14500,-400,14900,802286,2024.02.15
158,Sun To Me,Zach Bryan,7,1,6,2,0,14300,4400,9900,4324638,2024.02.15
159,Wings Of A Dove,Jonathan Wilburn,2,2,0,2,0,13600,13600,0,0,2024.02.15
160,Quittin' Time,Zach Bryan,2,-1,3,1,0,13300,-3000,16300,860922,2024.02.15
161,Halfway Up The Mountain,Tribute Quartet,2,1,1,2,0,12700,6300,6400,6378,2024.02.15
162,Songs We Used To Sing,Ernest,6,-1,7,1,0,12700,-3900,16600,46091,2024.02.15
163,Raise The Roof,Christian Beck,7,0,7,1,0,12500,-1100,13600,139,2024.02.15
164,Thicc As Thieves,Lauren Alaina,42,-25,67,7,0,12400,-45500,57900,720334,2024.02.15
165,But A Beer Can,Eric Burgett,17,0,17,17,0,12300,0,12300,4745,2024.02.15
166,Let's Go Fishing,Aaron Lewis,9,-7,16,1,0,12300,-11000,23300,0,2024.02.15
167,Greener Pasture,Carter Faith,8,8,0,1,0,12200,12200,0,43030,2024.02.15
168,The Devil I Know,Ashley McBryde,10,9,1,3,0,12000,10800,1200,113621,2024.02.15
169,"Houston, We Got A Problem",Luke Combs,6,-1,7,1,0,12000,-2700,14700,1155705,2024.02.15
170,That Ain'T Country,Aaron Lewis,4,-1,5,1,0,11800,3000,8800,122737,2024.02.15
171,Old School,Toby Keith,5,3,2,3,0,11400,2400,9000,264031,2024.02.15
172,Watch You Burn,Chris Stapleton,2,2,0,1,0,11300,11300,0,134366,2024.02.15
173,Heartless,Diplo & Julia Michaels Feat. Morgan Wallen,3,-2,5,3,0,10800,-6500,17300,4739226,2024.02.15
174,My Bar,Priscilla Block,1,-2,3,1,0,10700,-5500,16200,129017,2024.02.15
175,If It Wasn't For Trucks,Riley Green,3,-6,9,1,0,10700,-15200,25900,476622,2024.02.15
176,The Star Spangled Banner,Brad Paisley,3,1,2,3,0,10500,500,10000,0,2024.02.15
177,George Strait Jr.,Dustin Lynch,2,2,0,1,0,10300,10300,0,20816,2024.02.15
178,Neon Star (Country Boy Lullaby),Morgan Wallen,2,1,1,1,0,10300,4900,5400,1364353,2024.02.15
179,What Good Am I,Zack Dyer,2,-3,5,1,0,10300,-16700,27000,9837,2024.02.15
180,Lucky,Megan Moroney,1,1,0,1,0,10200,10200,0,203840,2024.02.15
181,Dirty Looks,Lainey Wilson,3,0,3,1,0,10200,2100,8100,868097,2024.02.15
182,On And On,Wes Hampton,2,2,0,2,0,10000,10000,0,207,2024.02.15
183,No Yesterday,Jeremy McComb,5,0,5,1,0,10000,600,9400,625,2024.02.15
184,Fake Id,Sydney Mack,7,0,7,1,0,9800,800,9000,1050,2024.02.15
185,Like A Cowboy,Parker Mccollum,2,1,1,2,0,9600,3700,5900,428931,2024.02.15
186,Give Me A Sunrise,Braxton Keith,3,0,3,1,0,9600,-4300,13900,25581,2024.02.15
187,He Grew The Tree,Guardians Quartet,1,1,0,1,0,9500,9500,0,3715,2024.02.15
187,He Bought Me,Old Paths,1,1,0,1,0,9500,9500,0,152,2024.02.15
187,In God's Time,Jordan Family Band,1,1,0,1,0,9500,9500,0,2041,2024.02.15
190,Single At The Same Time,Jake Worthington,4,3,1,1,0,9400,8800,600,7401,2024.02.15
191,God Only Knows,for King & Country,1,0,1,1,0,9200,0,9200,1070848,2024.02.15
192,What Else Is New,Cody Jinks,7,0,7,1,0,9000,-6600,15600,76729,2024.02.15
193,National Anthem,Pryor & Lee,2,-1,3,2,0,9000,-5200,14200,0,2024.02.15
194,Holy Smoke,Frank Vieira,11,2,9,1,0,8800,1200,7600,143,2024.02.15
195,Saltwater Gospel,Eli Young Band & Jimmy Buffett,5,3,2,1,0,8700,6000,2700,95362,2024.02.15
196,Wreckage,Nate Smith,6,0,6,1,0,8700,-700,9400,705976,2024.02.15
197,The Great Divide,Luke Combs & Billy Strings,4,-2,6,1,0,8700,-4700,13400,169653,2024.02.15
198,Arkansas,Chris Stapleton,6,0,6,1,0,8400,0,8400,444809,2024.02.15
199,Decoration,Jillian Riscoe,3,-1,4,1,0,8400,300,8100,6,2024.02.15
200,Deeper Well,Kacey Musgraves,4,3,1,2,0,8100,7300,800,5087066,2024.02.15
201,Love Drunk And Happy,Old Dominion,1,1,0,1,0,8100,8100,0,46858,2024.02.15
1,Pretty Little Poison,Warren Zeiders,8479,1015,7464,144,0,33146700,4247000,28899700,10124401,2024.02.22
2,World On Fire,Nate Smith,6888,-214,7102,144,0,30015700,-774600,30790300,4369464,2024.02.22
3,The Painter,Cody Johnson,7081,326,6755,144,0,27814000,1652100,26161900,8345170,2024.02.22
4,I Can Feel It,Kane Brown,6419,374,6045,144,0,24626500,2078300,22548200,2972198,2024.02.22
5,Truck Bed,Hardy,6222,164,6058,143,0,23624100,1118200,22505900,8405842,2024.02.22
6,Mamaw's House,Thomas Rhett,6252,333,5919,143,0,23538500,1290600,22247900,2894678,2024.02.22
7,Where The Wild Things Are,Luke Combs,5611,-2103,7714,144,0,22594100,-5552600,28146700,9394489,2024.02.22
8,Save Me,Jelly Roll & Lainey Wilson,4957,-224,5181,137,0,21813500,-589500,22403000,6766686,2024.02.22
9,Man Made A Bar,Morgan Wallen,4573,312,4261,144,0,18041200,1500300,16540900,5594812,2024.02.22
10,Burn It Down,Parker Mccollum,4840,248,4592,144,0,17912800,809100,17103700,6155620,2024.02.22
11,23,Chayce Beckham,5073,335,4738,144,0,17508000,553800,16954200,5240728,2024.02.22
12,Creek Will Rise,Conner Smith,4204,-74,4278,144,0,14430100,-472800,14902900,2079178,2024.02.22
13,Tucson Too Late,Jordan Davis,3926,382,3544,144,0,14101600,1070000,13031600,1715394,2024.02.22
14,Wildflowers And Wild Horses,Lainey Wilson,4040,478,3562,144,0,13643800,1824400,11819400,4056936,2024.02.22
15,Back Then Right Now,Tyler Hubbard,3807,397,3410,144,0,13508800,2215500,11293300,2007187,2024.02.22
16,Cab In A Solo,Scotty McCreery,3980,362,3618,144,0,13484700,1369800,12114900,632406,2024.02.22
17,Fearless,Jackson Dean,3473,204,3269,142,0,10898500,664800,10233700,925825,2024.02.22
18,Take Her Home,Kenny Chesney,3036,243,2793,144,0,10148600,1257300,8891300,1090832,2024.02.22
19,Outskirts,Sam Hunt,2833,504,2329,140,0,10146100,2515800,7630300,1557847,2024.02.22
20,We Don'T Fight Anymore,Carly Pearce,2966,3,2963,142,0,9744100,11500,9732600,2699138,2024.02.22
21,Your Place,Ashley Cooke,2558,175,2383,134,0,8472900,729200,7743700,1566611,2024.02.22
22,Where It Ends,Bailey Zimmerman,2548,378,2170,140,0,8002300,1261400,6740900,4297113,2024.02.22
23,Glory Days,Gabby Barrett,2808,88,2720,143,0,7878900,-105100,7984000,1041134,2024.02.22
24,Halfway To Hell,Jelly Roll,2122,317,1805,142,0,7826000,1218500,6607500,2161873,2024.02.22
25,I'M Not Pretty,Megan Moroney,2083,18,2065,140,0,6506200,-151300,6657500,2100937,2024.02.22
26,Out Of That Truck,Carrie Underwood,2214,28,2186,138,0,6499900,101700,6398200,1141677,2024.02.22
27,Let Your Boys Be Country,Jason Aldean,1918,145,1773,137,0,6167200,383100,5784100,1688804,2024.02.22
28,Can't Break Up Now,Old Dominion,2236,166,2070,143,0,6163000,519400,5643600,1432480,2024.02.22
29,We Ride,Bryan Martin,1612,141,1471,132,0,5473200,427500,5045700,3369654,2024.02.22
30,Love You Again,Chase Matthew,1803,177,1626,131,0,4822400,583900,4238500,2031353,2024.02.22
31,Young Love & Saturday Nights,Chris Young,1385,62,1323,121,0,3935000,29500,3905500,843554,2024.02.22
32,Cowboys And Plowboys,Jon Pardi Feat. Luke Bryan,1196,123,1073,128,0,2933000,131200,2801800,463333,2024.02.22
33,Gonna Love You,Parmalee,1220,82,1138,102,0,2871100,278600,2592500,243024,2024.02.22
34,Texas Hold 'Em,Beyonce,939,639,300,121,0,2808800,1710700,1098100,29817125,2024.02.22
35,Spirits And Demons,Michael Ray With Meghan Patrick,996,27,969,105,0,2745800,55400,2690400,197018,2024.02.22
36,This Is My Dirt,Justin Moore,1091,83,1008,110,0,2636000,335200,2300800,330763,2024.02.22
37,Dance With You,Brett Young,1099,53,1046,101,0,2617200,103000,2514200,1698371,2024.02.22
38,Bulletproof,Nate Smith,665,129,536,68,0,2581700,84600,2497100,3511153,2024.02.22
39,Drinkin' Problems,Dillon Carmichael,1265,-14,1279,134,0,2476000,-169800,2645800,30207,2024.02.22
40,Rodeo Man,Garth Brooks & Ronnie Dunn,1330,76,1254,139,0,2463900,376300,2087600,1149143,2024.02.22
41,Chevrolet,Dustin Lynch Feat. Jelly Roll,858,143,715,87,0,2385400,526400,1859000,1992419,2024.02.22
42,Sounds Like The Radio,Zach Top,822,56,766,86,0,2076000,167600,1908400,244772,2024.02.22
43,One Bad Habit,Tim McGraw,888,145,743,111,0,1975600,352900,1622700,129740,2024.02.22
44,Bigger Houses,Dan + Shay,677,90,587,87,0,1726700,243700,1483000,596183,2024.02.22
45,In Your Love,Tyler Childers,780,4,776,82,0,1661300,7500,1653800,3328030,2024.02.22
46,Find Another Bar,Chris Lane,734,41,693,79,0,1541300,85900,1455400,211861,2024.02.22
47,Pickup Man (Feat. Post Malone),Hixtape & Joe Diffie,306,17,289,59,0,1447400,20800,1426600,549582,2024.02.22
48,She's Somebody's Daughter,Drew Baldridge,722,77,645,102,0,1393500,115100,1278400,410528,2024.02.22
49,Brokenhearted,Joe Nichols,664,36,628,65,0,1367700,173300,1194400,10123,2024.02.22
50,I'm In Love,Hailey Whitters,586,25,561,68,0,1352000,19000,1333000,377295,2024.02.22
51,Boys Back Home,Dylan Marlowe Feat. Dylan Scott,539,26,513,60,0,1263400,161400,1102000,3350014,2024.02.22
52,Love You Back,Lady A,723,83,640,98,0,1226700,195600,1031100,142212,2024.02.22
53,Ain'T About You,Huntergirl,553,-21,574,75,0,846500,-60600,907100,20971,2024.02.22
54,Dirt Cheap,Cody Johnson,163,33,130,20,0,841600,161400,680200,2772253,2024.02.22
55,Breakin' In Boots,Matt Stell,489,59,430,71,0,821400,231200,590200,692642,2024.02.22
56,King Of Country Music,Ryan Larkins,367,15,352,47,0,760200,77600,682600,24823,2024.02.22
57,I Tried A Ring On,Tigirlily Gold,368,46,322,55,0,707100,131200,575900,442180,2024.02.22
58,Wondering Why,Red Clay Strays,133,93,40,39,0,651500,331800,319700,4998332,2024.02.22
59,Think I’m In Love With You,Chris Stapleton,307,141,166,44,0,648000,268900,379100,3221383,2024.02.22
60,Make Me Wanna Smoke,Runaway June,378,-4,382,43,0,499800,-117800,617600,16254,2024.02.22
61,Last Rodeo,Restless Road,318,47,271,43,0,491100,53000,438100,2005785,2024.02.22
62,This Town's Been Too Good To Us,Dylan Scott,299,162,137,47,0,445400,307000,138400,3109556,2024.02.22
63,Purple Irises,Gwen Stefani & Blake Shelton,235,-495,730,49,0,410900,-2321200,2732100,969773,2024.02.22
64,Cancel,Randy Houser,315,6,309,39,0,351100,-6200,357300,46850,2024.02.22
65,Spin You Around (1/24),Morgan Wallen,110,23,87,8,0,334700,19000,315700,7265665,2024.02.22
66,No One Else Like Me,Red Clay Strays,70,70,0,37,0,316800,316800,0,0,2024.02.22
67,No Caller Id,Megan Moroney,107,26,81,5,0,303800,67000,236800,5378198,2024.02.22
68,We Didn't Start The Fire,Fall Out Boy,66,66,0,34,0,300200,300200,0,1361598,2024.02.22
69,This Side Of The Dirt,Neon Union,264,-19,283,36,0,279700,-46500,326200,25791,2024.02.22
70,Rain In The Rearview,Anne Wilson,277,-28,305,41,0,265700,-27300,293000,953807,2024.02.22
71,Million Little Bandaids,Caroline Jones,262,-1,263,36,0,256900,-28900,285800,19862,2024.02.22
72,White Buffalo,Ian Munsick,47,-33,80,46,0,243400,-95700,339100,117119,2024.02.22
73,Life With You,Kelsey Hart,226,26,200,40,0,240300,-55300,295600,2367176,2024.02.22
74,Neon Baby,Annie Bosko,172,9,163,32,0,227600,19400,208200,16324,2024.02.22
75,Long Live Cowgirls,Ian Munsick & Cody Johnson,122,-98,220,20,0,206600,-331500,538100,844051,2024.02.22
76,Heartbreak King,Ian Munsick,33,-37,70,33,0,201900,-114900,316800,82,2024.02.22
77,Outlaws And Mustangs,Cody Jinks,37,0,37,4,0,195700,3700,192000,258717,2024.02.22
78,Sarah's Place,Zach Bryan,15,-1,16,1,0,122600,-10500,133100,2866294,2024.02.22
79,Bayou Boy,Graham Barham,35,32,3,2,0,118300,101100,17200,125276,2024.02.22
80,How Is She,Cole Swindell,17,3,14,1,0,118200,7300,110900,45622,2024.02.22
81,Coal,Dylan Gossett,25,18,7,3,0,116600,71300,45300,6091755,2024.02.22
82,Colorado,Florida Georgia Line,16,2,14,2,0,109800,25000,84800,45779,2024.02.22
83,With You I Am,Cody Johnson,10,0,10,2,0,107200,22800,84400,1563147,2024.02.22
84,Man Upstairs,Tim Dugger,18,9,9,1,0,103500,66100,37400,0,2024.02.22
85,Country's Cool Again,Lainey Wilson,29,29,0,6,0,98800,98800,0,1986191,2024.02.22
86,Damn Good Day To Leave,Riley Green,27,23,4,4,0,97200,69300,27900,140558,2024.02.22
87,True Love,Laci Kaye Booth,48,48,0,48,0,95700,95700,0,31229,2024.02.22
88,God & Country,Anne Wilson,48,46,2,48,0,95700,92300,3400,276598,2024.02.22
89,Heart They Didn'T Break,Maddie & Tae,84,-47,131,13,0,85600,-62700,148300,494884,2024.02.22
90,I Need You,Frontmen,24,9,15,15,0,82300,-21900,104200,692,2024.02.22
91,Jack And Diet Coke,Redferrin,24,-6,30,3,0,76500,-4900,81400,1772022,2024.02.22
92,Devil You Know,Tyler Braden,23,7,16,1,0,76100,29100,47000,2110363,2024.02.22
93,Things I Take For Granted,Larry Fleet,33,2,31,3,0,74200,13000,61200,1239967,2024.02.22
94,Take Forever (Hally's Song),Cooper Alan,17,17,0,16,0,73900,73900,0,1247001,2024.02.22
95,The Star-Spangled Banner,Chris Stapleton,16,4,12,14,0,72500,23500,49000,97373,2024.02.22
96,Hey Driver,Zach Bryan Feat. The War and Treaty,39,-4,43,2,0,69000,-8000,77000,6861239,2024.02.22
97,I Like Big Trucks,Alli Walker,18,1,17,1,0,64500,6500,58000,0,2024.02.22
98,How You Get To Heaven,Ty Herndon,5,-1,6,1,0,63100,-14000,77100,573,2024.02.22
99,Broadway Girls,Lil Durk Feat. Morgan Wallen,16,2,14,2,0,60400,7200,53200,3557779,2024.02.22
100,Wild Ones,Jessie Murph & Jelly Roll,26,-19,45,2,0,57300,-32200,89500,12158652,2024.02.22
101,This Heart,Corey Kent,19,2,17,4,0,55300,19100,36200,1582884,2024.02.22
102,That's What I Love About Sunday,Craig Morgan & Gary Levox,9,9,0,9,0,54400,54400,0,7010,2024.02.22
103,Holy Water,Michael Ray,7,3,4,1,0,51000,13700,37300,219938,2024.02.22
104,Pray All The Way Home,Austin Snell,56,-14,70,18,0,47600,-5000,52600,998312,2024.02.22
105,When My Baby's In Boots,Randall King,4,-1,5,1,0,38700,-11300,50000,0,2024.02.22
106,Tulsa,Elle King,9,-3,12,1,0,38000,-8200,46200,41385,2024.02.22
107,Thinkin Bout Cheatin,Mae Estes,51,17,34,17,0,36900,12300,24600,23593,2024.02.22
108,Stop Coming Over,Chris Lane,12,12,0,6,0,36800,36800,0,23954,2024.02.22
109,Always You,Trey Lewis,50,-1,51,17,0,36600,-300,36900,126049,2024.02.22
110,The Star-Spangled Banner,Carly Pearce,4,0,4,4,0,34600,18900,15700,0,2024.02.22
111,Thicc As Thieves,Lauren Alaina,35,-7,42,6,0,33100,20700,12400,781819,2024.02.22
112,Up In Texas,Midland,4,-2,6,2,0,30900,-8200,39100,123948,2024.02.22
113,Open The Gate,Zach Bryan,4,3,1,2,0,30800,26700,4100,1054592,2024.02.22
114,Give Me A Sunrise,Braxton Keith,3,0,3,1,0,30800,21200,9600,28627,2024.02.22
115,Just Drive,Erin Kinsey,11,11,0,6,0,30400,30400,0,93096,2024.02.22
116,'98 Braves,Morgan Wallen,4,-1,5,2,0,30000,-11900,41900,1895559,2024.02.22
117,Hold On To Me,Nathan Merovich,42,42,0,17,0,29900,29900,0,0,2024.02.22
118,Sayin' What I'm Thinkin',Lainey Wilson,13,-1,14,1,0,28600,10300,18300,150059,2024.02.22
119,Star Spangled Banner,Mickey Guyton,3,2,1,3,0,27500,24900,2600,0,2024.02.22
120,Keep Your Radio On,Wyatt McCubbin,5,4,1,1,0,27000,21600,5400,7197,2024.02.22
121,Way Back When,Wayland,36,12,24,12,0,25800,8600,17200,687,2024.02.22
122,Cowgirls,Morgan Wallen,11,1,10,2,0,25800,1700,24100,5890611,2024.02.22
123,Dance Like No One's Watching,Gabby Barrett,2,2,0,1,0,24600,24600,0,0,2024.02.22
124,Walk Away Slow,Austin English,34,-17,51,17,0,24600,-12300,36900,526,2024.02.22
125,One Two Step,Gunnar Latham,34,-34,68,17,0,24600,-24600,49200,1098,2024.02.22
126,25-8,Larry Fleet,9,0,9,1,0,23400,-16000,39400,45442,2024.02.22
127,Single Again,Josh Ross,4,4,0,3,0,23200,23200,0,1159773,2024.02.22
128,Hungover In A Church Pew,Jelly Roll,4,4,0,1,0,22300,22300,0,166277,2024.02.22
129,How Do You Miss Me,Dallas Smith,4,1,3,1,0,21600,5900,15700,9383,2024.02.22
130,Outrunnin' Your Memory,Luke Combs & Miranda Lambert,7,-5,12,6,0,21400,-14000,35400,554100,2024.02.22
131,"Houston, We Got A Problem",Luke Combs,9,3,6,2,0,21200,9200,12000,1127860,2024.02.22
132,No Present LIke The Time,Jay Allen,49,-7,56,9,0,20700,-5700,26400,0,2024.02.22
133,Holy Roller,Zach Bryan,11,-1,12,1,0,20500,5100,15400,1224140,2024.02.22
134,Good On You,Priscilla Block,3,3,0,3,0,20000,20000,0,986383,2024.02.22
135,State You Left Me In,Jake Worthington,3,1,2,1,0,19800,15100,4700,16067,2024.02.22
136,Quittin' Time,Zach Bryan,3,1,2,1,0,19800,6500,13300,883241,2024.02.22
137,Heart Of A Small Town,Tim Dugger,3,-1,4,1,0,19800,-3600,23400,8426,2024.02.22
138,The Star Spangled Banner,Locash,1,1,0,1,0,19500,19500,0,0,2024.02.22
139,Wine Country,Hannah Ellis,15,-8,23,4,0,19200,-12500,31700,16709,2024.02.22
140,Giving You Up,Kameron Marlowe,3,-1,4,1,0,18500,4000,14500,810525,2024.02.22
141,Polaroid,Keith Urban,6,6,0,6,0,18400,18400,0,12798,2024.02.22
141,When Will I Be Loved,"Ashley McBryde, Caylee Hammack & Pillbox Patti",6,6,0,6,0,18400,18400,0,29424,2024.02.22
143,My Bar,Priscilla Block,6,5,1,6,0,18400,7700,10700,140072,2024.02.22
144,Winter Wonderland,Jon Pardi,1,1,0,1,0,18200,18200,0,321,2024.02.22
145,Trouble,Josh Ross,13,-9,22,3,0,18200,11000,7200,2026721,2024.02.22
146,What Else Is New,Cody Jinks,7,0,7,1,0,17300,8300,9000,78870,2024.02.22
147,The Devil I Know,Ashley McBryde,10,0,10,2,0,16100,4100,12000,135357,2024.02.22
148,I GOT AWAY WITH YOU,Luke Combs,6,3,3,1,0,15800,7900,7900,313572,2024.02.22
149,Meet Me At The Cross,Brian Free & Assurance,2,1,1,2,0,15800,9500,6300,3874,2024.02.22
150,That's Texas,Cody Johnson,2,1,1,1,0,15700,600,15100,306940,2024.02.22
151,Single At The Same Time,Jake Worthington,2,-2,4,1,0,15700,6300,9400,8078,2024.02.22
152,Any Given Friday Night,Luke Combs,2,0,2,1,0,15200,0,15200,209004,2024.02.22
153,Dancin' With The Devil,Josh Ward,1,1,0,1,0,15100,15100,0,11867,2024.02.22
153,Another Town,Jon Stork,1,1,0,1,0,15100,15100,0,1914,2024.02.22
153,One I Want,Flatland Cavalry,1,1,0,1,0,15100,15100,0,172533,2024.02.22
156,Playboys,Midland,9,1,8,1,0,15100,7700,7400,73275,2024.02.22
157,Six Pack State Of Mind,Grant Gilbert,1,0,1,1,0,15100,12600,2500,0,2024.02.22
158,Forever Bound,12/Oc,7,-19,26,1,0,14900,-52600,67500,2315,2024.02.22
159,I'M Not For Everyone,Brothers Osborne,5,1,4,3,0,14800,6900,7900,434239,2024.02.22
160,Heart Attack,Boy Named Banjo,5,-4,9,1,0,14600,-4800,19400,3298,2024.02.22
161,Leave You Alone,Kane Brown,5,5,0,5,0,14400,14400,0,228786,2024.02.22
162,Greener Pasture,Carter Faith,7,-1,8,1,0,14200,2000,12200,45027,2024.02.22
163,Better Off,Trace Adkins,3,-1,4,1,0,14200,-3500,17700,16353,2024.02.22
164,Must Be The Whiskey,Cody Jinks,8,0,8,2,0,14100,6300,7800,1341659,2024.02.22
165,Older People,Greater Vision,2,2,0,2,0,13700,13700,0,4820,2024.02.22
166,Be The Reason,Steeles,2,1,1,2,0,13600,7300,6300,108,2024.02.22
166,We Are The Church,Ernie Haase & Signature Sound,2,1,1,2,0,13600,7300,6300,29945,2024.02.22
166,Means Something To Me,Tate Emmons,2,1,1,2,0,13600,7300,6300,516,2024.02.22
169,In God's Time,Jordan Family Band,2,1,1,2,0,13600,4100,9500,1644,2024.02.22
170,I Can'T Breathe,Parker Mccollum,2,0,2,1,0,13300,-14500,27800,935039,2024.02.22
171,"Trucks, Ducks, Bucks & Beer",Brian Kelley,2,1,1,1,0,13200,6600,6600,186800,2024.02.22
172,What I Couldn'T Forget,Drake Milligan,2,2,0,2,0,13000,13000,0,145448,2024.02.22
173,When It Comes To Loving You,Jon Langston,3,0,3,2,0,12900,-2000,14900,91885,2024.02.22
174,Darlin',Chase Matthew,17,17,0,17,0,12300,12300,0,871108,2024.02.22
175,Silverado,Caleb Lee Hutchinson,17,-34,51,17,0,12300,-24600,36900,15116,2024.02.22
176,I'M Not Blonde,Meredith Foster,8,3,5,1,0,11300,4300,7000,41,2024.02.22
177,Certified,Laura Bryna,24,-2,26,2,0,11200,-8200,19400,7587,2024.02.22
178,Star Spangled Banner,Maren Morris,1,0,1,1,0,11000,-8500,19500,0,2024.02.22
179,The Great Divide,Luke Combs & Billy Strings,3,-1,4,1,0,11000,2300,8700,242995,2024.02.22
180,Love You A Little Bit,Tanner Adell,4,4,0,1,0,10900,10900,0,141663,2024.02.22
181,Good Girl Gone Missin',Morgan Wallen,2,2,0,1,0,10800,10800,0,1322856,2024.02.22
182,Neon Star (Country Boy Lullaby),Morgan Wallen,2,0,2,1,0,10800,500,10300,1442150,2024.02.22
183,No Yesterday,Jeremy McComb,7,2,5,1,0,10700,700,10000,284,2024.02.22
184,Heartless,Diplo & Julia Michaels Feat. Morgan Wallen,3,0,3,1,0,10600,-200,10800,4855826,2024.02.22
185,Martha Divine,Ashley McBryde,6,2,4,2,0,10500,6700,3800,72079,2024.02.22
186,That Ain'T Country,Aaron Lewis,5,1,4,1,0,10500,-1300,11800,127811,2024.02.22
187,Dirty Looks,Lainey Wilson,3,0,3,1,0,10100,-100,10200,869231,2024.02.22
188,Born Lonely,Matt Stell,1,1,0,1,0,9900,9900,0,393256,2024.02.22
189,Whatever Gets You Through It,Morgan Gruber,7,2,5,1,0,9700,1800,7900,402,2024.02.22
190,You In A Honky Tonk,Randall King,2,1,1,2,0,9600,5000,4600,297437,2024.02.22
191,Living Water Bread Of Life,Ben Rochester Family,1,1,0,1,0,9500,9500,0,252,2024.02.22
191,His Name Is Jesus (Live),Cody Johnson,1,1,0,1,0,9500,9500,0,46588,2024.02.22
191,Because He Lives,Carrie Underwood,1,1,0,1,0,9500,9500,0,52685,2024.02.22
191,Healer,Casting Crowns,1,1,0,1,0,9500,9500,0,130007,2024.02.22
195,There Was Jesus,Zach Williams & Dolly Parton,1,0,1,1,0,9500,3200,6300,1154876,2024.02.22
196,Soundtrack To A Small Town Sundown,Tyler Farr,1,0,1,1,0,9500,2200,7300,5997,2024.02.22
197,Oklahoma Smokeshow,Zach Bryan,2,0,2,1,0,9200,4800,4400,5947276,2024.02.22
198,In Love With My Problems,Larry Fleet Feat. Jon Pardi,6,2,4,1,0,8900,1200,7700,87072,2024.02.22
199,Loud and Heavy,Cody Jinks,5,-2,7,1,0,8800,-9200,18000,1466623,2024.02.22
200,Amazed,Frontmen,1,0,1,1,0,8700,3200,5500,0,2024.02.22
1,The Painter,Cody Johnson,8213,1132,7081,144,0,31182600,3368600,27814000,8660421,2024.02.29
2,Pretty Little Poison,Warren Zeiders,7733,-746,8479,144,0,30629100,-2517600,33146700,10124709,2024.02.29
3,World On Fire,Nate Smith,6587,-301,6888,144,0,28696600,-1319100,30015700,4351985,2024.02.29
4,I Can Feel It,Kane Brown,6767,348,6419,144,0,26023900,1397400,24626500,3710309,2024.02.29
5,Truck Bed,Hardy,6522,300,6222,143,0,24745100,1121000,23624100,8616142,2024.02.29
6,Mamaw's House,Thomas Rhett,6390,138,6252,143,0,23688000,149500,23538500,3099071,2024.02.29
7,Save Me,Jelly Roll & Lainey Wilson,4833,-124,4957,140,0,21226000,-587500,21813500,7433030,2024.02.29
8,Man Made A Bar,Morgan Wallen,5125,552,4573,144,0,19499900,1458700,18041200,6472909,2024.02.29
9,Burn It Down,Parker Mccollum,5162,322,4840,144,0,18772600,859800,17912800,6530257,2024.02.29
10,23,Chayce Beckham,5360,287,5073,144,0,18387900,879900,17508000,5183549,2024.02.29
11,Cab In A Solo,Scotty McCreery,4177,197,3980,144,0,15040200,1555500,13484700,656368,2024.02.29
12,Creek Will Rise,Conner Smith,4342,138,4204,144,0,14766300,336200,14430100,1984473,2024.02.29
13,Tucson Too Late,Jordan Davis,3932,6,3926,144,0,14632100,530500,14101600,2038606,2024.02.29
14,Wildflowers And Wild Horses,Lainey Wilson,4182,142,4040,144,0,14465400,821600,13643800,4038308,2024.02.29
15,Back Then Right Now,Tyler Hubbard,4110,303,3807,144,0,14423600,914800,13508800,2178103,2024.02.29
16,Outskirts,Sam Hunt,3486,653,2833,140,0,12652000,2505900,10146100,1655481,2024.02.29
17,Fearless,Jackson Dean,3579,106,3473,143,0,11139400,240900,10898500,929202,2024.02.29
18,Take Her Home,Kenny Chesney,3176,140,3036,144,0,11010000,861400,10148600,1799095,2024.02.29
19,We Don'T Fight Anymore,Carly Pearce,3080,114,2966,142,0,9777400,33300,9744100,2893668,2024.02.29
20,Where It Ends,Bailey Zimmerman,2988,440,2548,141,0,9622500,1620200,8002300,4670096,2024.02.29
21,Your Place,Ashley Cooke,2603,45,2558,136,0,8671500,198600,8472900,1713393,2024.02.29
22,Halfway To Hell,Jelly Roll,2302,180,2122,142,0,8217800,391800,7826000,2314521,2024.02.29
23,Out Of That Truck,Carrie Underwood,2418,204,2214,138,0,7389200,889300,6499900,1188252,2024.02.29
24,Glory Days,Gabby Barrett,2570,-238,2808,143,0,7233800,-645100,7878900,1098785,2024.02.29
25,American Girl,Dierks Bentley,1480,1479,1,133,0,7102300,7096400,5900,1362686,2024.02.29
26,I'M Not Pretty,Megan Moroney,2155,72,2083,141,0,6957400,451200,6506200,1984024,2024.02.29
27,Can't Break Up Now,Old Dominion,2208,-28,2236,143,0,6498800,335800,6163000,1490072,2024.02.29
28,Let Your Boys Be Country,Jason Aldean,1882,-36,1918,137,0,6191500,24300,6167200,1678529,2024.02.29
29,We Ride,Bryan Martin,1740,128,1612,135,0,6028700,555500,5473200,3565150,2024.02.29
30,Love You Again,Chase Matthew,1788,-15,1803,130,0,4945600,123200,4822400,2207765,2024.02.29
31,Young Love & Saturday Nights,Chris Young,1546,161,1385,132,0,4448400,513400,3935000,873366,2024.02.29
32,Bulletproof,Nate Smith,842,177,665,82,0,3251000,669300,2581700,4279565,2024.02.29
33,Rodeo Man,Garth Brooks & Ronnie Dunn,1504,174,1330,139,0,2993400,529500,2463900,1265623,2024.02.29
34,Gonna Love You,Parmalee,1272,52,1220,103,0,2919900,48800,2871100,266012,2024.02.29
35,Cowboys And Plowboys,Jon Pardi Feat. Luke Bryan,1177,-19,1196,129,0,2895900,-37100,2933000,399352,2024.02.29
36,This Is My Dirt,Justin Moore,1142,51,1091,108,0,2835900,199900,2636000,342782,2024.02.29
37,Dance With You,Brett Young,1173,74,1099,102,0,2674200,57000,2617200,1904443,2024.02.29
38,Texas Hold 'Em,Beyonce,1026,87,939,117,0,2628500,-180300,2808800,27069034,2024.02.29
39,Spirits And Demons,Michael Ray With Meghan Patrick,977,-19,996,105,0,2544400,-201400,2745800,196659,2024.02.29
40,Chevrolet,Dustin Lynch Feat. Jelly Roll,882,24,858,92,0,2534000,148600,2385400,2076089,2024.02.29
41,Drinkin' Problems,Dillon Carmichael,1287,22,1265,134,0,2460400,-15600,2476000,31276,2024.02.29
42,Sounds Like The Radio,Zach Top,852,30,822,92,0,2412400,336400,2076000,453596,2024.02.29
43,One Bad Habit,Tim McGraw,961,73,888,119,0,2293500,317900,1975600,192862,2024.02.29
44,Bigger Houses,Dan + Shay,741,64,677,97,0,1960000,233300,1726700,632297,2024.02.29
45,Find Another Bar,Chris Lane,793,59,734,82,0,1662300,121000,1541300,248947,2024.02.29
46,In Your Love,Tyler Childers,769,-11,780,82,0,1661000,-300,1661300,3219818,2024.02.29
47,She's Somebody's Daughter,Drew Baldridge,780,58,722,104,0,1488200,94700,1393500,427105,2024.02.29
48,I'm In Love,Hailey Whitters,580,-6,586,70,0,1461500,109500,1352000,262843,2024.02.29
49,Brokenhearted,Joe Nichols,648,-16,664,66,0,1337100,-30600,1367700,9824,2024.02.29
50,Pickup Man (Feat. Post Malone),Hixtape & Joe Diffie,291,-15,306,60,0,1306500,-140900,1447400,536889,2024.02.29
51,Boys Back Home,Dylan Marlowe Feat. Dylan Scott,572,33,539,67,0,1293900,30500,1263400,3209596,2024.02.29
52,Love You Back,Lady A,707,-16,723,99,0,1087700,-139000,1226700,205468,2024.02.29
53,Breakin' In Boots,Matt Stell,532,43,489,71,0,897600,76200,821400,641685,2024.02.29
54,Ain'T About You,Huntergirl,529,-24,553,75,0,845400,-1100,846500,22914,2024.02.29
55,Cowboy Songs,George Birge,166,165,1,48,0,826400,825700,700,292539,2024.02.29
56,Think I’m In Love With You,Chris Stapleton,340,33,307,48,0,748700,100700,648000,3470688,2024.02.29
57,King Of Country Music,Ryan Larkins,357,-10,367,50,0,742800,-17400,760200,14363,2024.02.29
58,Dirt Cheap,Cody Johnson,164,1,163,17,0,736000,-105600,841600,3562807,2024.02.29
59,I Tried A Ring On,Tigirlily Gold,409,41,368,67,0,698800,-8300,707100,385721,2024.02.29
60,Last Rodeo,Restless Road,334,16,318,45,0,667500,176400,491100,1653006,2024.02.29
61,Make Me Wanna Smoke,Runaway June,397,19,378,44,0,584000,84200,499800,17930,2024.02.29
62,This Town's Been Too Good To Us,Dylan Scott,363,64,299,53,0,507000,61600,445400,3652310,2024.02.29
63,Purple Irises,Gwen Stefani & Blake Shelton,248,13,235,35,0,446300,35400,410900,997344,2024.02.29
64,Cancel,Randy Houser,331,16,315,43,0,414400,63300,351100,48662,2024.02.29
65,Spin You Around (1/24),Morgan Wallen,108,-2,110,6,0,343200,8500,334700,6634481,2024.02.29
66,Rain In The Rearview,Anne Wilson,291,14,277,44,0,309800,44100,265700,963220,2024.02.29
67,No Caller Id,Megan Moroney,113,6,107,5,0,300600,-3200,303800,4785801,2024.02.29
68,It's A Great Day To Be Alive (Live From The Ryman),Ben Rector,56,56,0,55,0,296200,296200,0,54483,2024.02.29
69,Neon Baby,Annie Bosko,200,28,172,36,0,287300,59700,227600,29154,2024.02.29
70,This Side Of The Dirt,Neon Union,260,-4,264,34,0,280400,700,279700,28467,2024.02.29
71,Life With You,Kelsey Hart,245,19,226,47,0,276900,36600,240300,2216556,2024.02.29
72,Million Little Bandaids,Caroline Jones,256,-6,262,36,0,235900,-21000,256900,20044,2024.02.29
73,With You I Am,Cody Johnson,23,13,10,19,0,220700,113500,107200,1515764,2024.02.29
74,Wondering Why,Red Clay Strays,30,-103,133,3,0,178100,-473400,651500,4699648,2024.02.29
75,Long Live Cowgirls,Ian Munsick & Cody Johnson,90,-32,122,13,0,177300,-29300,206600,873054,2024.02.29
76,Outlaws And Mustangs,Cody Jinks,32,-5,37,4,0,162100,-33600,195700,213145,2024.02.29
77,Hobby Lobby Bobby,Bobby Bones & The Raging Idiots,52,52,0,37,0,159100,159100,0,0,2024.02.29
78,Long Live Country Music,Cody Johnson,16,16,0,16,0,152700,152700,0,253589,2024.02.29
79,Coal,Dylan Gossett,34,9,25,3,0,147400,30800,116600,6602579,2024.02.29
80,Bayou Boy,Graham Barham,35,0,35,1,0,122500,4200,118300,87487,2024.02.29
81,How Is She,Cole Swindell,18,1,17,1,0,121200,3000,118200,48421,2024.02.29
82,Damn Good Day To Leave,Riley Green,34,7,27,9,0,118500,21300,97200,270997,2024.02.29
83,Deeper Well,Kacey Musgraves,58,55,3,48,0,108600,105200,3400,3790290,2024.02.29
84,Jack And Diet Coke,Redferrin,32,8,24,7,0,107700,31200,76500,1716806,2024.02.29
85,Sarah's Place,Zach Bryan,13,-2,15,1,0,104100,-18500,122600,3033349,2024.02.29
86,Fine Wine,Runaway June,48,48,0,48,0,95700,95700,0,56087,2024.02.29
86,Cowboy Kind Of Love,Castellows,48,48,0,48,0,95700,95700,0,410818,2024.02.29
88,Space In My Heart,Enrique Iglesias & Miranda Lambert,19,19,0,19,0,90800,90800,0,1446894,2024.02.29
89,Man Upstairs,Tim Dugger,16,-2,18,1,0,88200,-15300,103500,0,2024.02.29
90,Colorado,Florida Georgia Line,15,-1,16,2,0,86500,-23300,109800,48580,2024.02.29
91,Heart They Didn'T Break,Maddie & Tae,76,-8,84,10,0,78600,-7000,85600,521596,2024.02.29
92,How You Get To Heaven,Ty Herndon,6,1,5,1,0,77100,14000,63100,496,2024.02.29
93,This Heart,Corey Kent,24,5,19,4,0,72900,17600,55300,1524549,2024.02.29
94,Hey Driver,Zach Bryan Feat. The War and Treaty,36,-3,39,3,0,72700,3700,69000,7394666,2024.02.29
95,All Dogs Go To Heaven,Chris Young,17,17,0,16,0,71400,71400,0,17500,2024.02.29
96,Dance Like No One's Watching,Gabby Barrett,5,3,2,1,0,68300,43700,24600,0,2024.02.29
97,Country's Cool Again,Lainey Wilson,13,-16,29,2,0,62700,-36100,98800,1269792,2024.02.29
98,Devil You Know,Tyler Braden,21,-2,23,1,0,57000,-19100,76100,2844189,2024.02.29
99,Try Jesus,Elle King,9,9,0,9,0,54400,54400,0,20075,2024.02.29
100,Holy Water,Michael Ray,7,0,7,2,0,53000,2000,51000,227553,2024.02.29
101,The Star-Spangled Banner,Chris Stapleton,11,-5,16,10,0,51200,-21300,72500,92306,2024.02.29
102,Broadway Girls,Lil Durk Feat. Morgan Wallen,14,-2,16,2,0,50700,-9700,60400,3804240,2024.02.29
103,I Like Big Trucks,Alli Walker,14,-4,18,1,0,50300,-14200,64500,0,2024.02.29
104,Things I Take For Granted,Larry Fleet,28,-5,33,2,0,48600,-25600,74200,1261932,2024.02.29
105,I Need You,Frontmen,11,-13,24,2,0,48100,-34200,82300,697,2024.02.29
106,The Devil I Know,Ashley McBryde,19,9,10,4,0,47600,31500,16100,154887,2024.02.29
107,Must Be The Whiskey,Cody Jinks,11,3,8,2,0,46500,32400,14100,1356034,2024.02.29
108,Wild Ones,Jessie Murph & Jelly Roll,23,-3,26,4,0,44300,-13000,57300,12908668,2024.02.29
109,Walk Away Slow,Austin English,51,17,34,17,0,36900,12300,24600,1289,2024.02.29
109,One Two Step,Gunnar Latham,51,17,34,17,0,36900,12300,24600,1019,2024.02.29
111,Thinkin Bout Cheatin,Mae Estes,51,0,51,17,0,36900,0,36900,23630,2024.02.29
112,Work Boots,Cody Johnson,3,0,3,1,0,36200,30900,5300,360591,2024.02.29
113,I Can'T Breathe,Parker Mccollum,4,2,2,1,0,34900,21600,13300,998963,2024.02.29
114,Certified,Laura Bryna,49,25,24,7,0,31900,20700,11200,6309,2024.02.29
115,25-8,Larry Fleet,9,0,9,1,0,31400,8000,23400,43931,2024.02.29
116,Pray All The Way Home,Austin Snell,38,-18,56,18,0,31400,-16200,47600,1020641,2024.02.29
117,Always You,Trey Lewis,35,-15,50,18,0,30800,-5800,36600,134943,2024.02.29
118,Up In Texas,Midland,3,-1,4,2,0,30300,-600,30900,110541,2024.02.29
119,Hippies & Cowboys,Cody Jinks,3,1,2,1,0,28400,23200,5200,1552267,2024.02.29
120,I'M Not For Everyone,Brothers Osborne,6,1,5,3,0,27700,12900,14800,492026,2024.02.29
121,'98 Braves,Morgan Wallen,5,1,4,2,0,26800,-3200,30000,2047622,2024.02.29
122,Cowgirls,Morgan Wallen,9,-2,11,4,0,25400,-400,25800,6347718,2024.02.29
123,Tulsa,Elle King,9,0,9,1,0,23400,-14600,38000,41238,2024.02.29
124,National Anthem From Battle At Bristol,Jennifer Nettles,4,3,1,4,0,22600,22300,300,0,2024.02.29
125,What Else Is New,Cody Jinks,10,3,7,1,0,22100,4800,17300,83434,2024.02.29
126,Better Off,Trace Adkins,3,0,3,1,0,20700,6500,14200,16875,2024.02.29
127,You In A Honky Tonk,Randall King,4,2,2,1,0,20400,10800,9600,316505,2024.02.29
128,Thicc As Thieves,Lauren Alaina,34,-1,35,5,0,20400,-12700,33100,715564,2024.02.29
129,Sayin' What I'm Thinkin',Lainey Wilson,11,-2,13,1,0,20100,-8500,28600,144374,2024.02.29
130,State You Left Me In,Jake Worthington,3,0,3,1,0,19800,0,19800,17295,2024.02.29
131,Star Spangled Banner,Maren Morris,1,0,1,1,0,19500,8500,11000,0,2024.02.29
132,National Anthem,Pryor & Lee,3,3,0,3,0,19100,19100,0,0,2024.02.29
133,All American,Mickey Guyton,4,4,0,4,0,18900,18900,0,14786,2024.02.29
134,Holy Roller,Zach Bryan,8,-3,11,1,0,18800,-1700,20500,1161768,2024.02.29
135,Growin' Up And Gettin' Old,Luke Combs,6,6,0,6,0,18400,18400,0,966797,2024.02.29
136,Just Drive,Erin Kinsey,6,-5,11,6,0,18400,-12000,30400,94468,2024.02.29
137,That's Texas,Cody Johnson,3,1,2,2,0,18200,2500,15700,263198,2024.02.29
138,No Present LIke The Time,Jay Allen,39,-10,49,7,0,18100,-2600,20700,0,2024.02.29
139,Bury Me In This Bar,Dalton Dover,3,2,1,1,0,17500,15400,2100,0,2024.02.29
140,Wine Country,Hannah Ellis,15,0,15,3,0,17500,-1700,19200,17572,2024.02.29
141,Damn Good Time,Jordan Davis,1,0,1,1,0,17500,11700,5800,183562,2024.02.29
142,Quittin' Time,Zach Bryan,2,-1,3,1,0,16800,-3000,19800,909238,2024.02.29
143,Give Me A Sunrise,Braxton Keith,2,-1,3,1,0,16800,-14000,30800,32021,2024.02.29
144,Heartless,Diplo & Julia Michaels Feat. Morgan Wallen,4,1,3,3,0,16500,5900,10600,4949667,2024.02.29
145,Buckles And Broken Hearts,Joe Peters,2,1,1,1,0,16000,8300,7700,1123,2024.02.29
146,God's Been Good,LeFevre Quartet,2,2,0,2,0,15900,15900,0,1286,2024.02.29
147,Single At The Same Time,Jake Worthington,2,0,2,1,0,15700,0,15700,8665,2024.02.29
148,When My Baby's In Boots,Randall King,2,-2,4,1,0,15700,-23000,38700,0,2024.02.29
149,"Houston, We Got A Problem",Luke Combs,7,-2,9,2,0,15500,-5700,21200,1187234,2024.02.29
150,Single Again,Josh Ross,11,7,4,2,0,15400,-7800,23200,1386099,2024.02.29
151,Days That End In Why,Morgan Wallen,7,2,5,2,0,15300,7100,8200,961988,2024.02.29
152,Any Given Friday Night,Luke Combs,2,0,2,1,0,15200,0,15200,215220,2024.02.29
153,Messed Around,Huser Brother Band,1,1,0,1,0,15100,15100,0,1650,2024.02.29
153,"Mirror, Mirror",Randall King,1,1,0,1,0,15100,15100,0,166702,2024.02.29
153,Rhinestoned,"Randy Rogers ,Wade Bowen",1,1,0,1,0,15100,15100,0,20822,2024.02.29
153,We Ain't The Only Ones,Randy Rogers & Wade Bowen,1,1,0,1,0,15100,15100,0,0,2024.02.29
157,Ain't It Baby (Live at Billy Bob's Texas),Josh Ward,1,0,1,1,0,15100,14500,600,836,2024.02.29
158,Other Side Of The Radio,Mike Ryan,1,0,1,1,0,15100,11000,4100,89851,2024.02.29
159,Playboys,Midland,9,0,9,1,0,15100,0,15100,74860,2024.02.29
160,Star Spangled Banner,Abby Anderson,3,1,2,3,0,14400,9100,5300,0,2024.02.29
161,Whiskey's Fine,Adam Doleac,5,5,0,5,0,14000,14000,0,21791,2024.02.29
162,Cover Me Up,Morgan Wallen,7,3,4,4,0,14000,8300,5700,4203855,2024.02.29
163,Fake Id,Sydney Mack,7,1,6,1,0,13900,5500,8400,1002,2024.02.29
164,Luke Combs,Tanner Adell,7,7,0,1,0,13500,13500,0,70556,2024.02.29
165,The Star Spangled Banner,Brad Paisley,3,3,0,3,0,13100,13100,0,0,2024.02.29
166,Sunrise Tells The Story,Midland,1,1,0,1,0,12700,12700,0,164050,2024.02.29
167,Songs We Used To Sing,Ernest,6,-2,8,1,0,12700,4300,8400,42801,2024.02.29
168,Sun To Me,Zach Bryan,7,2,5,2,0,12400,5400,7000,4271862,2024.02.29
169,A Cowboy Who Would,Chancey Williams,17,17,0,17,0,12300,12300,0,96066,2024.02.29
169,Make You Mine,Marynn Taylor,17,17,0,17,0,12300,12300,0,17003,2024.02.29
169,She's Gotta Know,Conner Sweet,17,17,0,17,0,12300,12300,0,1992,2024.02.29
172,God Only Knows,for King & Country,2,1,1,1,0,12200,10500,1700,1179970,2024.02.29
173,I GOT AWAY WITH YOU,Luke Combs,6,0,6,1,0,12000,-3800,15800,309649,2024.02.29
174,Whatever Gets You Through It,Morgan Gruber,6,-1,7,1,0,11300,1600,9700,362,2024.02.29
175,Greener Pasture,Carter Faith,6,-1,7,1,0,11300,-2900,14200,45251,2024.02.29
176,Heart Of A Small Town,Tim Dugger,2,-1,3,1,0,11200,-8600,19800,9400,2024.02.29
177,Heart Attack,Boy Named Banjo,4,-1,5,1,0,11100,-3500,14600,3718,2024.02.29
178,Loud and Heavy,Cody Jinks,6,1,5,1,0,11000,2200,8800,1547048,2024.02.29
179,Star Spangled Banner,Mickey Guyton,2,-1,3,2,0,11000,-16500,27500,0,2024.02.29
180,"The Father, My Son, And The Holy Ghost",Craig Morgan,2,1,1,1,0,10900,7900,3000,59355,2024.02.29
181,What Good Am I,Zack Dyer,2,1,1,1,0,10800,5400,5400,3964,2024.02.29
181,Good Day (2021),Brett Eldredge,2,1,1,1,0,10800,5400,5400,88751,2024.02.29
183,Raise The Roof,Christian Beck,8,1,7,1,0,10800,3300,7500,102,2024.02.29
184,Neon Star (Country Boy Lullaby),Morgan Wallen,2,0,2,1,0,10800,0,10800,1435449,2024.02.29
185,How Do You Miss Me,Dallas Smith,2,-2,4,1,0,10800,-10800,21600,9793,2024.02.29
186,Keep Your Radio On,Wyatt McCubbin,2,-3,5,1,0,10800,-16200,27000,6443,2024.02.29
187,Love You A Little Bit,Tanner Adell,6,2,4,1,0,10500,-400,10900,154284,2024.02.29
188,That Ain'T Country,Aaron Lewis,4,-1,5,1,0,10400,-100,10500,150506,2024.02.29
189,Behind Bars,Jelly Roll,1,1,0,1,0,10200,10200,0,227921,2024.02.29
190,House Fire,Tyler Childers,5,1,4,1,0,10200,5300,4900,983357,2024.02.29
191,Good On You,Priscilla Block,2,-1,3,2,0,10000,-10000,20000,865247,2024.02.29
192,As You Are,Tenille Townes,1,1,0,1,0,9900,9900,0,131440,2024.02.29
192,Holy Smokes,Bailey Zimmerman,1,1,0,1,0,9900,9900,0,8295925,2024.02.29
194,Nothin' On You,Cody Johnson,2,2,0,2,0,9800,9800,0,1212477,2024.02.29
195,Answer Is Jesus,Karen Peck & New River,1,1,0,1,0,9500,9500,0,1612,2024.02.29
195,Scars In Heaven,Casting Crowns,1,1,0,1,0,9500,9500,0,546178,2024.02.29
197,His Name Is Jesus (Live),Cody Johnson,1,0,1,1,0,9500,0,9500,48268,2024.02.29
198,The Great Divide,Luke Combs & Billy Strings,4,1,3,1,0,9400,-1600,11000,232508,2024.02.29
199,Mountain With A View,Kelsea Ballerini,6,1,5,1,0,9200,3400,5800,831443,2024.02.29
200,Holy Smoke,Frank Vieira,8,0,8,1,0,9200,1100,8100,118,2024.02.29
201,Giving You Up,Kameron Marlowe,1,-2,3,1,0,9200,-9300,18500,843101,2024.02.29
1,I Can Feel It,Kane Brown,8143,1376,6767,144,0,32061900,6038000,26023900,3487548,2024.03.07
2,Pretty Little Poison,Warren Zeiders,6991,-742,7733,144,0,28596400,-2032700,30629100,9416051,2024.03.07
3,World On Fire,Nate Smith,6388,-199,6587,144,0,27964500,-732100,28696600,4754321,2024.03.07
4,Truck Bed,Hardy,6745,223,6522,143,0,26279200,1534100,24745100,8710817,2024.03.07
5,Mamaw's House,Thomas Rhett,6959,569,6390,143,0,25927000,2239000,23688000,3438035,2024.03.07
6,The Painter,Cody Johnson,6545,-1668,8213,144,0,25533300,-5649300,31182600,8485473,2024.03.07
7,Man Made A Bar,Morgan Wallen,5630,505,5125,144,0,21415900,1916000,19499900,6226181,2024.03.07
8,Save Me,Jelly Roll & Lainey Wilson,4583,-250,4833,139,0,19955200,-1270800,21226000,7905152,2024.03.07
9,Burn It Down,Parker Mccollum,5477,315,5162,144,0,19903000,1130400,18772600,6689765,2024.03.07
10,23,Chayce Beckham,5624,264,5360,144,0,19341100,953200,18387900,5523306,2024.03.07
11,Tucson Too Late,Jordan Davis,4388,456,3932,144,0,16345700,1713600,14632100,2720266,2024.03.07
12,Cab In A Solo,Scotty McCreery,4497,320,4177,144,0,16082200,1042000,15040200,820569,2024.03.07
13,Back Then Right Now,Tyler Hubbard,4444,334,4110,144,0,16054000,1630400,14423600,1964599,2024.03.07
14,Outskirts,Sam Hunt,4092,606,3486,141,0,15464100,2812100,12652000,1683323,2024.03.07
15,Wildflowers And Wild Horses,Lainey Wilson,4487,305,4182,144,0,15267800,802400,14465400,4188203,2024.03.07
16,Creek Will Rise,Conner Smith,4396,54,4342,144,0,15192600,426300,14766300,2102937,2024.03.07
17,Take Her Home,Kenny Chesney,3505,329,3176,144,0,12102400,1092400,11010000,1527662,2024.03.07
18,Fearless,Jackson Dean,3563,-16,3579,143,0,11576600,437200,11139400,926933,2024.03.07
19,Where It Ends,Bailey Zimmerman,3294,306,2988,141,0,10973300,1350800,9622500,4425187,2024.03.07
20,We Don'T Fight Anymore,Carly Pearce,3044,-36,3080,143,0,10108300,330900,9777400,3303942,2024.03.07
21,Your Place,Ashley Cooke,2922,319,2603,137,0,9883500,1212000,8671500,2052422,2024.03.07
22,Halfway To Hell,Jelly Roll,2546,244,2302,144,0,9366200,1148400,8217800,2304253,2024.03.07
23,Out Of That Truck,Carrie Underwood,2420,2,2418,138,0,7676000,286800,7389200,1214222,2024.03.07
24,I'M Not Pretty,Megan Moroney,2206,51,2155,141,0,7187000,229600,6957400,2242503,2024.03.07
25,Messed Up As Me,Keith Urban,1482,1482,0,117,0,6792200,6792200,0,1958285,2024.03.07
26,We Ride,Bryan Martin,1885,145,1740,136,0,6687800,659100,6028700,3739409,2024.03.07
27,Can't Break Up Now,Old Dominion,2386,178,2208,143,0,6602900,104100,6498800,1524611,2024.03.07
28,Let Your Boys Be Country,Jason Aldean,1993,111,1882,138,0,6441600,250100,6191500,1636461,2024.03.07
29,Love You Again,Chase Matthew,1933,145,1788,134,0,5426700,481100,4945600,2203973,2024.03.07
30,Young Love & Saturday Nights,Chris Young,1810,264,1546,134,0,5361700,913300,4448400,915214,2024.03.07
31,Bulletproof,Nate Smith,994,152,842,84,0,3655600,404600,3251000,4086676,2024.03.07
32,Rodeo Man,Garth Brooks & Ronnie Dunn,1447,-57,1504,139,0,3141100,147700,2993400,1304587,2024.03.07
33,This Is My Dirt,Justin Moore,1217,75,1142,119,0,3048500,212600,2835900,402117,2024.03.07
34,Cowboys And Plowboys,Jon Pardi Feat. Luke Bryan,1242,65,1177,139,0,2927400,31500,2895900,392748,2024.03.07
35,Dance With You,Brett Young,1195,22,1173,106,0,2896400,222200,2674200,1683114,2024.03.07
36,Gonna Love You,Parmalee,1228,-44,1272,103,0,2895700,-24200,2919900,271067,2024.03.07
37,Chevrolet,Dustin Lynch Feat. Jelly Roll,1005,123,882,112,0,2892500,358500,2534000,2079009,2024.03.07
38,One Bad Habit,Tim McGraw,1018,57,961,126,0,2645400,351900,2293500,260401,2024.03.07
39,Drinkin' Problems,Dillon Carmichael,1415,128,1287,138,0,2609000,148600,2460400,30532,2024.03.07
40,Sounds Like The Radio,Zach Top,921,69,852,89,0,2593500,181100,2412400,456825,2024.03.07
41,Bigger Houses,Dan + Shay,902,161,741,113,0,2268300,308300,1960000,655392,2024.03.07
42,Texas Hold 'Em,Beyonce,987,-39,1026,119,0,2257300,-371200,2628500,20827963,2024.03.07
43,American Girl,Dierks Bentley,551,-929,1480,84,0,1710300,-5392000,7102300,684305,2024.03.07
44,In Your Love,Tyler Childers,839,70,769,87,0,1681800,20800,1661000,3721921,2024.03.07
45,She's Somebody's Daughter,Drew Baldridge,826,46,780,104,0,1677800,189600,1488200,423910,2024.03.07
46,Find Another Bar,Chris Lane,799,6,793,86,0,1598500,-63800,1662300,217728,2024.03.07
47,Boys Back Home,Dylan Marlowe Feat. Dylan Scott,644,72,572,74,0,1499300,205400,1293900,2851633,2024.03.07
48,I'm In Love,Hailey Whitters,614,34,580,69,0,1398200,-63300,1461500,218936,2024.03.07
49,Brokenhearted,Joe Nichols,639,-9,648,68,0,1311300,-25800,1337100,9924,2024.03.07
50,Love You Back,Lady A,729,22,707,98,0,1207800,120100,1087700,252580,2024.03.07
51,Pickup Man (Feat. Post Malone),Hixtape & Joe Diffie,269,-22,291,59,0,1132900,-173600,1306500,476873,2024.03.07
52,Dirt Cheap,Cody Johnson,223,59,164,30,0,1051900,315900,736000,3857748,2024.03.07
53,Breakin' In Boots,Matt Stell,541,9,532,75,0,983700,86100,897600,954553,2024.03.07
54,Think I’m In Love With You,Chris Stapleton,380,40,340,59,0,867300,118600,748700,3204772,2024.03.07
55,I Tried A Ring On,Tigirlily Gold,439,30,409,63,0,764200,65400,698800,375133,2024.03.07
56,Ain'T About You,Huntergirl,525,-4,529,75,0,761600,-83800,845400,25084,2024.03.07
57,Last Rodeo,Restless Road,385,51,334,48,0,738900,71400,667500,1645954,2024.03.07
58,King Of Country Music,Ryan Larkins,349,-8,357,53,0,736900,-5900,742800,14031,2024.03.07
59,Make Me Wanna Smoke,Runaway June,396,-1,397,46,0,662900,78900,584000,21353,2024.03.07
60,This Town's Been Too Good To Us,Dylan Scott,388,25,363,55,0,585900,78900,507000,3255638,2024.03.07
61,Cowboy Songs,George Birge,147,-19,166,53,0,577100,-249300,826400,289161,2024.03.07
62,Life With You,Kelsey Hart,333,88,245,66,0,452300,175400,276900,2163879,2024.03.07
63,Cancel,Randy Houser,332,1,331,42,0,408000,-6400,414400,48323,2024.03.07
64,Purple Irises,Gwen Stefani & Blake Shelton,229,-19,248,34,0,371300,-75000,446300,755608,2024.03.07
65,Spin You Around (1/24),Morgan Wallen,118,10,108,7,0,370000,26800,343200,6691778,2024.03.07
66,Rain In The Rearview,Anne Wilson,303,12,291,43,0,351400,41600,309800,1051930,2024.03.07
67,No Caller Id,Megan Moroney,124,11,113,7,0,327600,27000,300600,4785162,2024.03.07
68,Born Lonely,Matt Stell,57,56,1,56,0,304400,302700,1700,219693,2024.03.07
69,Country's Cool Again,Lainey Wilson,28,15,13,3,0,263100,200400,62700,1418720,2024.03.07
70,Neon Baby,Annie Bosko,197,-3,200,37,0,246100,-41200,287300,13885,2024.03.07
71,Million Little Bandaids,Caroline Jones,240,-16,256,36,0,246100,10200,235900,19488,2024.03.07
72,This Side Of The Dirt,Neon Union,262,2,260,32,0,240700,-39700,280400,30548,2024.03.07
73,Outlaws And Mustangs,Cody Jinks,36,4,32,4,0,180000,17900,162100,206211,2024.03.07
74,This Heart,Corey Kent,73,49,24,19,0,178300,105400,72900,1379973,2024.03.07
75,Wondering Why,Red Clay Strays,46,16,30,12,0,176100,-2000,178100,4610274,2024.03.07
76,Wild Ones,Jessie Murph & Jelly Roll,64,41,23,15,0,174600,130300,44300,13109063,2024.03.07
77,Long Haired Country Boy,Cody Johnson,17,17,0,15,0,160900,160900,0,147729,2024.03.07
78,Sarah's Place,Zach Bryan,18,5,13,1,0,136600,32500,104100,3136238,2024.03.07
79,Long Live Cowgirls,Ian Munsick & Cody Johnson,77,-13,90,12,0,133400,-43900,177300,856889,2024.03.07
80,How Is She,Cole Swindell,16,-2,18,1,0,123900,2700,121200,46920,2024.03.07
81,Coal,Dylan Gossett,30,-4,34,3,0,116700,-30700,147400,6241019,2024.03.07
82,Bayou Boy,Graham Barham,35,0,35,1,0,113500,-9000,122500,80184,2024.03.07
83,Dance Like No One's Watching,Gabby Barrett,9,4,5,3,0,103800,35500,68300,0,2024.03.07
84,Colorado,Florida Georgia Line,16,1,15,2,0,103000,16500,86500,49476,2024.03.07
85,The Star-Spangled Banner,Chris Stapleton,18,7,11,15,0,101900,50700,51200,95265,2024.03.07
86,Jack And Diet Coke,Redferrin,40,8,32,3,0,98800,-8900,107700,1726284,2024.03.07
87,While We'Re Still Friends (Feat. Lee Brice),Allie Colleen,48,48,0,48,0,95700,95700,0,20436,2024.03.07
88,Fine Wine,Runaway June,48,0,48,48,0,95700,0,95700,44958,2024.03.07
89,The Devil I Know,Ashley McBryde,51,32,19,12,0,95600,48000,47600,299341,2024.03.07
90,Man Upstairs,Tim Dugger,16,0,16,1,0,86000,-2200,88200,0,2024.03.07
91,Damn Good Day To Leave,Riley Green,32,-2,34,5,0,84100,-34400,118500,292543,2024.03.07
92,With You I Am,Cody Johnson,7,-16,23,2,0,78700,-142000,220700,1551392,2024.03.07
93,Broadway Girls,Lil Durk Feat. Morgan Wallen,18,4,14,2,0,77500,26800,50700,3718039,2024.03.07
94,Heart Of Exes,Griffen Palmer,17,17,0,16,0,72400,72400,0,2256,2024.03.07
95,Devil You Know,Tyler Braden,22,1,21,1,0,68800,11800,57000,2615609,2024.03.07
96,Things I Take For Granted,Larry Fleet,31,3,28,3,0,61200,12600,48600,1285882,2024.03.07
97,Lift Me Up,Darius Rucker,9,9,0,9,0,54400,54400,0,22964,2024.03.07
97,Jesus At The Taco Truck,"Shy Carter, Frank Ray",9,9,0,9,0,54400,54400,0,3274,2024.03.07
97,Jesus Got A Tight Grip,Blake Shelton,9,9,0,9,0,54400,54400,0,11287,2024.03.07
100,Holy Water,Michael Ray,6,-1,7,1,0,53100,100,53000,229502,2024.03.07
101,Cowgirls,Morgan Wallen,16,7,9,3,0,51800,26400,25400,6335405,2024.03.07
102,Straight Line,Keith Urban,18,18,0,17,0,51700,51700,0,659801,2024.03.07
103,Heart They Didn'T Break,Maddie & Tae,65,-11,76,8,0,49000,-29600,78600,458189,2024.03.07
104,How You Get To Heaven,Ty Herndon,4,-2,6,1,0,45200,-31900,77100,451,2024.03.07
105,Pray All The Way Home,Austin Snell,39,1,38,18,0,42800,11400,31400,1058753,2024.03.07
106,I Like Big Trucks,Alli Walker,14,0,14,1,0,40300,-10000,50300,7,2024.03.07
107,Thinkin Bout Cheatin,Mae Estes,51,0,51,18,0,39100,2200,36900,23732,2024.03.07
108,The Star-Spangled Banner,Carly Pearce,3,2,1,3,0,38900,37900,1000,0,2024.03.07
109,Hey Driver,Zach Bryan Feat. The War and Treaty,17,-19,36,3,0,38100,-34600,72700,6747872,2024.03.07
110,Longneck Way To Go,Midland Feat. Jon Pardi,5,5,0,2,0,37100,37100,0,148146,2024.03.07
111,A Cowboy Who Would,Chancey Williams,51,34,17,17,0,36900,24600,12300,86665,2024.03.07
112,One Two Step,Gunnar Latham,50,-1,51,17,0,36600,-300,36900,1000,2024.03.07
113,I Need You,Frontmen,9,-2,11,2,0,36100,-12000,48100,679,2024.03.07
114,'98 Braves,Morgan Wallen,7,2,5,3,0,35000,8200,26800,1956225,2024.03.07
115,Bury Me In This Bar,Dalton Dover,7,4,3,1,0,33000,15500,17500,0,2024.03.07
116,Ain'T No Better Place,Niko Moon,5,5,0,1,0,32800,32800,0,93616,2024.03.07
117,Certified,Laura Bryna,50,1,49,7,0,32700,800,31900,5157,2024.03.07
118,Cover Me Up,Morgan Wallen,12,5,7,3,0,31600,17600,14000,4266887,2024.03.07
119,Always You,Trey Lewis,35,0,35,18,0,30800,0,30800,129343,2024.03.07
120,Austin,Dasha,6,6,0,1,0,30600,30600,0,4114991,2024.03.07
121,Must Be The Whiskey,Cody Jinks,9,-2,11,2,0,30400,-16100,46500,1401361,2024.03.07
122,Called Crazy,Kassi Ashton,12,12,0,2,0,29700,29700,0,294091,2024.03.07
123,Narcissist,Avery Anna,4,3,1,1,0,29300,23100,6200,440755,2024.03.07
124,Give Me A Sunrise,Braxton Keith,3,1,2,1,0,28400,11600,16800,30086,2024.03.07
125,Tulsa,Elle King,9,0,9,1,0,28200,4800,23400,43854,2024.03.07
126,Kiss My Boots,Brian Kelley,4,4,0,3,0,28100,28100,0,37731,2024.03.07
127,Single Again,Josh Ross,25,14,11,6,0,24800,9400,15400,1226399,2024.03.07
128,Walk Away Slow,Austin English,34,-17,51,17,0,24600,-12300,36900,470,2024.03.07
129,Silverado,Caleb Lee Hutchinson,33,33,0,17,0,24300,24300,0,12519,2024.03.07
130,That's Texas,Cody Johnson,3,0,3,1,0,24100,5900,18200,273585,2024.03.07
131,25-8,Larry Fleet,9,0,9,1,0,23400,-8000,31400,45266,2024.03.07
132,Up In Texas,Midland,5,2,3,2,0,22900,-7400,30300,107455,2024.03.07
133,Heartbreak King,Ian Munsick,10,10,0,9,0,22300,22300,0,309741,2024.03.07
134,You In A Honky Tonk,Randall King,4,0,4,2,0,20600,200,20400,315241,2024.03.07
135,Holy Roller,Zach Bryan,10,2,8,1,0,19700,900,18800,1170306,2024.03.07
136,No Present LIke The Time,Jay Allen,45,6,39,8,0,19600,1500,18100,0,2024.03.07
137,Heart Of A Small Town,Tim Dugger,3,1,2,1,0,19500,8300,11200,10502,2024.03.07
138,State You Left Me In,Jake Worthington,2,-1,3,1,0,19200,-600,19800,16484,2024.03.07
139,Sayin' What I'm Thinkin',Lainey Wilson,8,-3,11,1,0,18800,-1300,20100,147550,2024.03.07
140,Love Can Build A Bridge,"Jelly Roll, K. Michelle & The Fisk Jubilee Singers",1,1,0,1,0,18200,18200,0,19914,2024.03.07
141,We Ain't The Only Ones,Randy Rogers & Wade Bowen,2,1,1,2,0,17600,2500,15100,0,2024.03.07
142,Way Back When,Wayland,24,24,0,12,0,17200,17200,0,843,2024.03.07
143,Better Off,Trace Adkins,3,0,3,1,0,16300,-4400,20700,17294,2024.03.07
144,Hold On To Me,Nathan Merovich,23,11,12,12,0,16200,7600,8600,0,2024.03.07
145,Neon Star (Country Boy Lullaby),Morgan Wallen,3,1,2,1,0,16200,5400,10800,1447566,2024.03.07
146,Meet Me At The Cross,Brian Free & Assurance,2,1,1,2,0,15800,9500,6300,4295,2024.03.07
147,When My Baby's In Boots,Randall King,2,0,2,1,0,15700,0,15700,0,2024.03.07
148,Open The Gate,Zach Bryan,2,-1,3,1,0,15700,10400,5300,1219832,2024.03.07
149,Thicc As Thieves,Lauren Alaina,34,0,34,5,0,15500,-4900,20400,749153,2024.03.07
150,Any Given Friday Night,Luke Combs,2,0,2,1,0,15200,0,15200,212865,2024.03.07
151,She,Jelly Roll,1,1,0,1,0,15100,15100,0,1283846,2024.03.07
151,Whiskey Bent,Cody Johnson,1,1,0,1,0,15100,15100,0,688936,2024.03.07
151,Church,Jelly Roll,1,1,0,1,0,15100,15100,0,490308,2024.03.07
151,Dancing With The Devil,Jelly Roll,1,1,0,1,0,15100,15100,0,1029847,2024.03.07
151,Copenhagen In A Cadillac,Riley Green,1,1,0,1,0,15100,15100,0,357560,2024.03.07
156,If I Had A Bar,Jon Wolfe,1,0,1,1,0,15100,12600,2500,9433,2024.03.07
157,Quittin' Time,Zach Bryan,1,-1,2,1,0,15100,-1700,16800,1009941,2024.03.07
158,House Fire,Tyler Childers,8,3,5,1,0,15000,4800,10200,1048223,2024.03.07
159,Good On You,Priscilla Block,2,0,2,1,0,14900,4900,10000,787652,2024.03.07
160,Lies Lies Lies,Morgan Wallen,5,5,0,3,0,14700,14700,0,4181,2024.03.07
161,Songs We Used To Sing,Ernest,6,0,6,1,0,14100,1400,12700,43938,2024.03.07
162,The Great Divide,Luke Combs & Billy Strings,5,1,4,1,0,14000,4600,9400,210956,2024.03.07
163,God's Been Good,LeFevre Quartet,2,0,2,2,0,13700,-2200,15900,1417,2024.03.07
164,Heart Attack,Boy Named Banjo,4,0,4,1,0,13700,2600,11100,3631,2024.03.07
165,Playboys,Midland,9,0,9,1,0,13700,-1400,15100,74890,2024.03.07
166,In God's Time,Jordan Family Band,2,1,1,2,0,13600,7300,6300,2267,2024.03.07
166,Make The Morning Worth The Midnight,Gaither Vocal Band,2,1,1,2,0,13600,7300,6300,15755,2024.03.07
166,Here Comes Jesus,Jeff & Sheri Easter,2,1,1,2,0,13600,7300,6300,26118,2024.03.07
169,That Ain'T Country,Aaron Lewis,6,2,4,1,0,13400,3000,10400,136412,2024.03.07
170,I GOT AWAY WITH YOU,Luke Combs,5,-1,6,1,0,13300,1300,12000,312334,2024.03.07
171,Star Spangled Banner,Abby Anderson,3,0,3,2,0,13000,-1400,14400,0,2024.03.07
172,Fake Id,Sydney Mack,7,0,7,1,0,12900,-1000,13900,932,2024.03.07
173,Wine Country,Hannah Ellis,12,-3,15,2,0,12800,-4700,17500,17763,2024.03.07
174,Think About There,Greater Vision,2,1,1,2,0,12700,6300,6400,15081,2024.03.07
175,Loud and Heavy,Cody Jinks,5,-1,6,1,0,12600,1600,11000,1465392,2024.03.07
176,Love You A Little Bit,Tanner Adell,6,0,6,1,0,12500,2000,10500,143312,2024.03.07
177,No Yesterday,Jeremy McComb,7,2,5,1,0,12400,5000,7400,302,2024.03.07
178,"Houston, We Got A Problem",Luke Combs,6,-1,7,2,0,12400,-3100,15500,1140996,2024.03.07
179,Deeper Well,Kacey Musgraves,5,-53,58,2,0,12400,-96200,108600,3897284,2024.03.07
180,She's Gotta Know,Conner Sweet,16,-1,17,16,0,12000,-300,12300,915,2024.03.07
181,Paying For It,Levi Hummon,16,16,0,3,0,11800,11800,0,74507,2024.03.07
182,Saltwater Gospel,Eli Young Band & Jimmy Buffett,6,5,1,1,0,11800,11800,0,107806,2024.03.07
183,Use Me,Zach Top,8,8,0,3,0,11400,11400,0,346035,2024.03.07
184,Holy Smoke,Frank Vieira,8,0,8,1,0,11400,2200,9200,145,2024.03.07
185,I'M Not For Everyone,Brothers Osborne,4,-2,6,3,0,11400,-16300,27700,469421,2024.03.07
186,Wild as You,Cody Johnson,4,4,0,2,0,11100,11100,0,1372933,2024.03.07
187,Star Spangled Banner,Maren Morris,1,0,1,1,0,11000,-8500,19500,0,2024.03.07
188,How Do You Miss Me,Dallas Smith,2,0,2,1,0,10800,0,10800,9530,2024.03.07
189,Wreckage,Nate Smith,8,4,4,1,0,10700,5300,5400,800230,2024.03.07
190,You'Re Gonna Love Me,Tim Dugger,2,-1,3,1,0,10300,3900,6400,5342,2024.03.07
191,What Else Is New,Cody Jinks,6,-4,10,1,0,10300,-11800,22100,82806,2024.03.07
192,Quittin' Time,Morgan Wallen,4,4,0,1,0,10100,10100,0,920787,2024.03.07
193,Wine Into Whiskey,Tucker Wetmore,2,1,1,2,0,10000,5300,4700,4767696,2024.03.07
194,Come Back,November Blue,5,-1,6,1,0,9900,2600,7300,948,2024.03.07
195,Raise The Roof,Christian Beck,7,-1,8,1,0,9800,-1000,10800,128,2024.03.07
196,Whatever Gets You Through It,Morgan Gruber,5,-1,6,1,0,9800,-1500,11300,401,2024.03.07
197,The Building,Emily Ann Roberts,1,1,0,1,0,9500,9500,0,34695,2024.03.07
198,The River (Come On Down),Hillary Scott & The Scott Family,1,0,1,1,0,9500,1700,7800,8157,2024.03.07
199,Soundtrack To A Small Town Sundown,Tyler Farr,2,2,0,1,0,9000,9000,0,5876,2024.03.07
200,Heartless,Diplo & Julia Michaels Feat. Morgan Wallen,2,-2,4,2,0,9000,-7500,16500,5009187,2024.03.07
1,Mamaw's House,Thomas Rhett,7951,992,6959,144,0,29367900,3440900,25927000,4023433,2024.03.14
2,Truck Bed,Hardy,7014,269,6745,143,0,27428000,1148800,26279200,8739847,2024.03.14
3,Pretty Little Poison,Warren Zeiders,6346,-645,6991,144,0,27129400,-1467000,28596400,7343629,2024.03.14
4,World On Fire,Nate Smith,6070,-318,6388,144,0,26200800,-1763700,27964500,4895807,2024.03.14
5,I Can Feel It,Kane Brown,6219,-1924,8143,144,0,25868000,-6193900,32061900,5236429,2024.03.14
6,Man Made A Bar,Morgan Wallen,6124,494,5630,144,0,23743700,2327800,21415900,6054319,2024.03.14
7,Burn It Down,Parker Mccollum,5861,384,5477,144,0,21297000,1394000,19903000,6326869,2024.03.14
8,23,Chayce Beckham,5849,225,5624,144,0,21247100,1906000,19341100,6605450,2024.03.14
9,The Painter,Cody Johnson,5095,-1450,6545,143,0,19786800,-5746500,25533300,7486051,2024.03.14
10,Outskirts,Sam Hunt,4828,736,4092,141,0,18810700,3346600,15464100,1494489,2024.03.14
11,Tucson Too Late,Jordan Davis,4573,185,4388,144,0,17403900,1058200,16345700,2125996,2024.03.14
12,Cab In A Solo,Scotty McCreery,4755,258,4497,144,0,17337400,1255200,16082200,1163079,2024.03.14
13,Back Then Right Now,Tyler Hubbard,4557,113,4444,144,0,17125600,1071600,16054000,2078531,2024.03.14
14,Wildflowers And Wild Horses,Lainey Wilson,4582,95,4487,144,0,16540700,1272900,15267800,6272919,2024.03.14
15,Creek Will Rise,Conner Smith,4026,-370,4396,144,0,13793000,-1399600,15192600,2003824,2024.03.14
16,Take Her Home,Kenny Chesney,3870,365,3505,144,0,13550700,1448300,12102400,1604192,2024.03.14
17,Where It Ends,Bailey Zimmerman,3616,322,3294,143,0,12901300,1928000,10973300,4851183,2024.03.14
18,Fearless,Jackson Dean,3527,-36,3563,143,0,12050700,474100,11576600,946286,2024.03.14
19,Your Place,Ashley Cooke,3187,265,2922,138,0,11290400,1406900,9883500,1662618,2024.03.14
20,Halfway To Hell,Jelly Roll,2897,351,2546,144,0,10917100,1550900,9366200,2352280,2024.03.14
21,We Don'T Fight Anymore,Carly Pearce,3146,102,3044,144,0,10627500,519200,10108300,2763204,2024.03.14
22,Out Of That Truck,Carrie Underwood,2476,56,2420,139,0,8485000,809000,7676000,1080962,2024.03.14
23,I'M Not Pretty,Megan Moroney,2350,144,2206,141,0,7858000,671000,7187000,2298533,2024.03.14
24,Let Your Boys Be Country,Jason Aldean,2239,246,1993,141,0,7751600,1310000,6441600,1670733,2024.03.14
25,We Ride,Bryan Martin,2032,147,1885,134,0,7285500,597700,6687800,3817416,2024.03.14
26,Can't Break Up Now,Old Dominion,2443,57,2386,144,0,6824500,221600,6602900,1362701,2024.03.14
27,Young Love & Saturday Nights,Chris Young,1854,44,1810,138,0,5911100,549400,5361700,876470,2024.03.14
28,Love You Again,Chase Matthew,2034,101,1933,137,0,5710900,284200,5426700,2117452,2024.03.14
29,Whatcha See Is Whatcha Get,Chris Janson,996,994,2,107,0,4186200,4185100,1100,677002,2024.03.14
30,Bulletproof,Nate Smith,1140,146,994,108,0,3985900,330300,3655600,3619185,2024.03.14
31,Chevrolet,Dustin Lynch Feat. Jelly Roll,1176,171,1005,110,0,3364600,472100,2892500,2362131,2024.03.14
32,Dance With You,Brett Young,1339,144,1195,106,0,3363500,467100,2896400,1805600,2024.03.14
33,This Is My Dirt,Justin Moore,1297,80,1217,134,0,3119100,70600,3048500,384101,2024.03.14
34,Rodeo Man,Garth Brooks & Ronnie Dunn,1484,37,1447,140,0,3094600,-46500,3141100,1285023,2024.03.14
35,Cowboys And Plowboys,Jon Pardi Feat. Luke Bryan,1248,6,1242,137,0,2943300,15900,2927400,387581,2024.03.14
36,One Bad Habit,Tim McGraw,1127,109,1018,131,0,2918700,273300,2645400,262708,2024.03.14
37,Gonna Love You,Parmalee,1240,12,1228,104,0,2879700,-16000,2895700,261425,2024.03.14
38,Drinkin' Problems,Dillon Carmichael,1418,3,1415,137,0,2697000,88000,2609000,30630,2024.03.14
39,Sounds Like The Radio,Zach Top,943,22,921,105,0,2529600,-63900,2593500,506582,2024.03.14
40,Texas Hold 'Em,Beyonce,1184,197,987,122,0,2516600,259300,2257300,17101947,2024.03.14
41,Bigger Houses,Dan + Shay,973,71,902,127,0,2496800,228500,2268300,690982,2024.03.14
42,American Girl,Dierks Bentley,717,166,551,103,0,2270200,559900,1710300,648261,2024.03.14
43,Messed Up As Me,Keith Urban,765,-717,1482,99,0,2214800,-4577400,6792200,1054885,2024.03.14
44,She's Somebody's Daughter,Drew Baldridge,912,86,826,113,0,1966000,288200,1677800,408000,2024.03.14
45,Dirt Cheap,Cody Johnson,432,209,223,55,0,1909500,857600,1051900,4188220,2024.03.14
46,Find Another Bar,Chris Lane,832,33,799,86,0,1700800,102300,1598500,229075,2024.03.14
47,In Your Love,Tyler Childers,887,48,839,104,0,1691800,10000,1681800,3512355,2024.03.14
48,Boys Back Home,Dylan Marlowe Feat. Dylan Scott,687,43,644,85,0,1632100,132800,1499300,3048933,2024.03.14
49,I'm In Love,Hailey Whitters,593,-21,614,72,0,1534400,136200,1398200,216554,2024.03.14
50,Brokenhearted,Joe Nichols,629,-10,639,63,0,1405000,93700,1311300,9807,2024.03.14
51,Think I’m In Love With You,Chris Stapleton,467,87,380,54,0,1329800,462500,867300,4220885,2024.03.14
52,Love You Back,Lady A,719,-10,729,114,0,1236500,28700,1207800,179054,2024.03.14
53,Ain'T About You,Huntergirl,600,75,525,79,0,983200,221600,761600,19144,2024.03.14
54,Cowboy Songs,George Birge,344,197,147,83,0,955300,378200,577100,349441,2024.03.14
55,Breakin' In Boots,Matt Stell,554,13,541,77,0,938300,-45400,983700,822887,2024.03.14
56,I Tried A Ring On,Tigirlily Gold,459,20,439,64,0,902300,138100,764200,388426,2024.03.14
57,Last Rodeo,Restless Road,371,-14,385,48,0,821100,82200,738900,1846698,2024.03.14
58,Spin You Around (1/24),Morgan Wallen,189,71,118,21,0,748800,378800,370000,6656172,2024.03.14
59,Make Me Wanna Smoke,Runaway June,423,27,396,48,0,695600,32700,662900,30032,2024.03.14
60,King Of Country Music,Ryan Larkins,341,-8,349,51,0,674000,-62900,736900,12955,2024.03.14
61,This Town's Been Too Good To Us,Dylan Scott,418,30,388,57,0,593200,7300,585900,3443697,2024.03.14
62,Rain In The Rearview,Anne Wilson,345,42,303,70,0,539700,188300,351400,1079929,2024.03.14
63,No Caller Id,Megan Moroney,145,21,124,8,0,398900,71300,327600,4844786,2024.03.14
64,Life With You,Kelsey Hart,322,-11,333,51,0,374000,-78300,452300,2188474,2024.03.14
65,Cancel,Randy Houser,279,-53,332,40,0,331800,-76200,408000,49476,2024.03.14
66,Neon Baby,Annie Bosko,234,37,197,40,0,314800,68700,246100,16096,2024.03.14
67,Anybody But You,Lauren Watkins,56,56,0,55,0,300100,300100,0,416962,2024.03.14
68,This Heart,Corey Kent,149,76,73,30,0,280300,102000,178300,1256921,2024.03.14
69,Damn Good Day To Leave,Riley Green,110,78,32,19,0,276900,192800,84100,344454,2024.03.14
70,Purple Irises,Gwen Stefani & Blake Shelton,210,-19,229,32,0,256900,-114400,371300,486016,2024.03.14
71,Million Little Bandaids,Caroline Jones,222,-18,240,37,0,226800,-19300,246100,29774,2024.03.14
72,Single Again,Josh Ross,115,90,25,34,0,214900,190100,24800,1258710,2024.03.14
73,The Devil I Know,Ashley McBryde,117,66,51,17,0,212800,117200,95600,348474,2024.03.14
74,Called Crazy,Kassi Ashton,66,54,12,6,0,205500,175800,29700,83869,2024.03.14
75,This Side Of The Dirt,Neon Union,214,-48,262,30,0,201000,-39700,240700,37902,2024.03.14
76,Flowers,Miley Cyrus,37,37,0,19,0,186100,186100,0,8951798,2024.03.14
77,God & Country,Anne Wilson,46,46,0,45,0,181800,181800,0,292049,2024.03.14
78,Dance Like No One's Watching,Gabby Barrett,23,14,9,4,0,174500,70700,103800,0,2024.03.14
79,Deeper Well,Kacey Musgraves,44,39,5,37,0,171900,159500,12400,3715744,2024.03.14
80,Summer,A Thousand Horses,37,37,0,37,0,166000,166000,0,17568,2024.03.14
80,No News,A Thousand Horses,37,37,0,37,0,166000,166000,0,20504,2024.03.14
82,Outlaws And Mustangs,Cody Jinks,33,-3,36,4,0,154300,-25700,180000,205159,2024.03.14
83,Fishin' In The Dark,Niko Moon,21,21,0,2,0,137700,137700,0,158258,2024.03.14
84,Sarah's Place,Zach Bryan,15,-3,18,1,0,129700,-6900,136600,3234676,2024.03.14
85,Wild Ones,Jessie Murph & Jelly Roll,49,-15,64,16,0,128100,-46500,174600,12712556,2024.03.14
86,Cowgirls,Morgan Wallen,25,9,16,4,0,123400,71600,51800,6227138,2024.03.14
87,Long Live Cowgirls,Ian Munsick & Cody Johnson,68,-9,77,10,0,123000,-10400,133400,868442,2024.03.14
88,Wondering Why,Red Clay Strays,33,-13,46,6,0,122900,-53200,176100,4424081,2024.03.14
89,Bayou Boy,Graham Barham,35,0,35,1,0,118200,4700,113500,74083,2024.03.14
90,Jack And Diet Coke,Redferrin,42,2,40,3,0,108400,9600,98800,1707769,2024.03.14
91,How Is She,Cole Swindell,14,-2,16,1,0,105000,-18900,123900,49813,2024.03.14
92,Country's Cool Again,Lainey Wilson,24,-4,28,4,0,102500,-160600,263100,1331985,2024.03.14
93,As You Are,Tenille Townes,48,48,0,48,0,95700,95700,0,42330,2024.03.14
94,Two Night Stands,Kylie Morgan,48,47,1,48,0,95700,91000,4700,216936,2024.03.14
95,Things I Take For Granted,Larry Fleet,52,21,31,9,0,93700,32500,61200,1427282,2024.03.14
96,With You I Am,Cody Johnson,8,1,7,3,0,93000,14300,78700,1611413,2024.03.14
97,Damn Good Time,Jordan Davis,10,10,0,1,0,88900,88900,0,143783,2024.03.14
98,Ain'T No Better Place,Niko Moon,15,10,5,1,0,88900,56100,32800,93838,2024.03.14
99,Colorado,Florida Georgia Line,15,-1,16,2,0,88800,-14200,103000,49006,2024.03.14
100,Pray All The Way Home,Austin Snell,44,5,39,18,0,85400,42600,42800,1060259,2024.03.14
101,Austin,Dasha,26,20,6,3,0,83600,53000,30600,6795616,2024.03.14
102,Coal,Dylan Gossett,19,-11,30,3,0,82000,-34700,116700,5764788,2024.03.14
103,Man Upstairs,Tim Dugger,14,-2,16,1,0,76900,-9100,86000,0,2024.03.14
104,Broadway Girls,Lil Durk Feat. Morgan Wallen,21,3,18,13,0,76400,-1100,77500,3664470,2024.03.14
105,Mighta Met A Girl,Pryor Baird,17,17,0,16,0,72400,72400,0,8005,2024.03.14
106,Devil You Know,Tyler Braden,27,5,22,3,0,69400,600,68800,2867716,2024.03.14
107,How You Get To Heaven,Ty Herndon,5,1,4,1,0,63100,17900,45200,474,2024.03.14
108,'98 Braves,Morgan Wallen,9,2,7,2,0,58600,23600,35000,1998813,2024.03.14
109,Heart They Didn'T Break,Maddie & Tae,60,-5,65,8,0,56500,7500,49000,442519,2024.03.14
110,Hey Driver,Zach Bryan Feat. The War and Treaty,24,7,17,3,0,53000,14900,38100,6926409,2024.03.14
111,Thicc As Thieves,Lauren Alaina,38,4,34,16,0,52200,36700,15500,656313,2024.03.14
112,I Like Big Trucks,Alli Walker,15,1,14,1,0,46800,6500,40300,54300,2024.03.14
113,Holy Water,Michael Ray,5,-1,6,1,0,41000,-12100,53100,224741,2024.03.14
114,A Cowboy Who Would,Chancey Williams,51,0,51,17,0,36900,0,36900,83579,2024.03.14
115,Walk Away Slow,Austin English,49,15,34,17,0,36600,12000,24600,341,2024.03.14
116,Star Spangled Banner,Abby Anderson,7,4,3,5,0,34600,21600,13000,0,2024.03.14
117,I Need You,Frontmen,13,4,9,2,0,33800,-2300,36100,705,2024.03.14
118,Certified,Laura Bryna,46,-4,50,7,0,31400,-1300,32700,2225,2024.03.14
119,Cover Me Up,Morgan Wallen,13,1,12,4,0,30600,-1000,31600,4213907,2024.03.14
120,Star Spangled Banner,Mickey Guyton,4,3,1,4,0,29600,27000,2600,0,2024.03.14
121,That's Texas,Cody Johnson,4,1,3,1,0,29000,4900,24100,277847,2024.03.14
122,Hippies & Cowboys,Cody Jinks,3,-2,5,1,0,28400,-700,29100,1616872,2024.03.14
123,The Star-Spangled Banner,Chris Stapleton,8,-10,18,8,0,27800,-74100,101900,87871,2024.03.14
124,Oklahoma Sooner,Jake Banfield,6,6,0,1,0,26000,26000,0,3634,2024.03.14
125,Way Back When,Wayland,36,12,24,12,0,25800,8600,17200,760,2024.03.14
126,Paying For It,Levi Hummon,30,14,16,6,0,24700,12900,11800,79596,2024.03.14
127,Use Me,Zach Top,14,6,8,1,0,24600,13200,11400,347126,2024.03.14
128,Silverado,Caleb Lee Hutchinson,34,1,33,17,0,24600,300,24300,11790,2024.03.14
129,Always You,Trey Lewis,34,-1,35,17,0,24600,-6200,30800,118481,2024.03.14
130,One Two Step,Gunnar Latham,34,-16,50,17,0,24600,-12000,36600,928,2024.03.14
131,Thinkin Bout Cheatin,Mae Estes,34,-17,51,17,0,24600,-14500,39100,18734,2024.03.14
132,Must Be The Whiskey,Cody Jinks,9,0,9,2,0,24000,-6400,30400,1439479,2024.03.14
133,National Anthem From Battle At Bristol,Jennifer Nettles,3,1,2,2,0,23600,20800,2800,0,2024.03.14
134,Soundtrack To A Small Town Sundown,Tyler Farr,3,1,2,1,0,21700,12700,9000,6538,2024.03.14
135,When It Comes To Loving You,Jon Langston,3,1,2,2,0,21300,16600,4700,90938,2024.03.14
136,25-8,Larry Fleet,8,-1,9,1,0,20800,-2600,23400,44308,2024.03.14
137,My Bar,Priscilla Block,3,3,0,3,0,19800,19800,0,148007,2024.03.14
138,Open The Gate,Zach Bryan,3,1,2,1,0,19800,4100,15700,1421024,2024.03.14
139,Give Me A Sunrise,Braxton Keith,3,0,3,1,0,19800,-8600,28400,29625,2024.03.14
140,Hold On To Me,Nathan Merovich,24,1,23,12,0,19700,3500,16200,0,2024.03.14
141,I'M Not For Everyone,Brothers Osborne,4,0,4,2,0,19700,8300,11400,428591,2024.03.14
142,The Star Spangled Banner,Locash,1,1,0,1,0,19500,19500,0,0,2024.03.14
143,No Present LIke The Time,Jay Allen,42,-3,45,8,0,19400,-200,19600,0,2024.03.14
144,Long Haired Country Boy,Cody Johnson,2,-15,17,1,0,19200,-141700,160900,154651,2024.03.14
145,You In A Honky Tonk,Randall King,3,-1,4,2,0,18200,-2400,20600,317114,2024.03.14
146,"Houston, We Got A Problem",Luke Combs,7,1,6,1,0,18000,5600,12400,1224443,2024.03.14
147,Cowboy's Cowgirl,Chad Cooke Band,2,2,0,2,0,17600,17600,0,5720,2024.03.14
148,Honky Tonk In Heaven,Kin Faux,2,1,1,2,0,17600,15100,2500,2014,2024.03.14
149,Wine Country,Hannah Ellis,11,-1,12,3,0,17100,4300,12800,20271,2024.03.14
150,I Can'T Breathe,Parker Mccollum,3,2,1,2,0,16800,14300,2500,1032449,2024.03.14
151,The Weight Of The Badge,George Strait,1,0,1,1,0,16400,11500,4900,49745,2024.03.14
152,Grease,Lainey Wilson,1,1,0,1,0,15900,15900,0,150345,2024.03.14
153,Be The Reason,Steeles,2,1,1,2,0,15800,8500,7300,137,2024.03.14
154,Here Comes Jesus,Jeff & Sheri Easter,2,0,2,2,0,15800,2200,13600,25615,2024.03.14
155,Single At The Same Time,Jake Worthington,2,1,1,1,0,15700,15100,600,8431,2024.03.14
156,When My Baby's In Boots,Randall King,2,0,2,1,0,15700,0,15700,0,2024.03.14
157,Heart Attack,Boy Named Banjo,5,1,4,1,0,15400,1700,13700,3785,2024.03.14
158,Any Given Friday Night,Luke Combs,2,0,2,1,0,15200,0,15200,220948,2024.03.14
159,John Wayne,Whiskey Myers,1,1,0,1,0,15100,15100,0,198420,2024.03.14
159,She's Gonna Leave A Mark,Darrin Morris Band,1,1,0,1,0,15100,15100,0,0,2024.03.14
159,Neon Diamonds,Lainey Wilson,1,1,0,1,0,15100,15100,0,69858,2024.03.14
159,Bad Medicine,Whiskey Myers,1,1,0,1,0,15100,15100,0,18368,2024.03.14
159,Hillbilly Hippie,Lainey Wilson,1,1,0,1,0,15100,15100,0,123086,2024.03.14
159,Over Drinkin' Under Thinkin',Drake Milligan,1,1,0,1,0,15100,15100,0,73089,2024.03.14
165,Tuggin' On My Heartstrings,Randall King,1,0,1,1,0,15100,14500,600,30118,2024.03.14
166,We Ain't The Only Ones,Randy Rogers & Wade Bowen,1,-1,2,1,0,15100,-2500,17600,0,2024.03.14
167,I'Ve Seen Me Do It,Joe Peters,2,0,2,1,0,14500,10300,4200,494,2024.03.14
168,Playboys,Midland,9,0,9,1,0,14400,700,13700,77464,2024.03.14
169,Heartless,Diplo & Julia Michaels Feat. Morgan Wallen,3,1,2,3,0,14100,5100,9000,5006689,2024.03.14
170,Outro,Mica Levi,5,5,0,1,0,13600,13600,0,46,2024.03.14
171,Loud and Heavy,Cody Jinks,6,1,5,2,0,13600,1000,12600,1585227,2024.03.14
172,Meet Me At The Cross,Brian Free & Assurance,2,0,2,2,0,13600,-2200,15800,4292,2024.03.14
173,Fake Id,Sydney Mack,7,0,7,1,0,13400,500,12900,726,2024.03.14
174,House Fire,Tyler Childers,6,-2,8,1,0,13400,-1600,15000,1046808,2024.03.14
175,Like A Cowboy,Parker Mccollum,4,4,0,3,0,13200,13200,0,409444,2024.03.14
176,Better Off,Trace Adkins,2,-1,3,1,0,12500,-3800,16300,16091,2024.03.14
177,Back At The Bar,Landon Parker,17,17,0,17,0,12300,12300,0,1230,2024.03.14
178,She's Gotta Know,Conner Sweet,17,1,16,17,0,12300,300,12000,1173,2024.03.14
179,The Good I'Ll Do,Zach Bryan,3,3,0,1,0,11400,11400,0,2531479,2024.03.14
180,The Star-Spangled Banner,Carly Pearce,2,-1,3,2,0,11300,-27600,38900,0,2024.03.14
181,Good On You,Priscilla Block,1,-1,2,1,0,11200,-3700,14900,851219,2024.03.14
182,What Else Is New,Cody Jinks,8,2,6,1,0,10800,500,10300,87628,2024.03.14
183,Oklahoma Smokeshow,Zach Bryan,4,0,4,2,0,10800,3200,7600,6596695,2024.03.14
184,Holy Roller,Zach Bryan,7,-3,10,1,0,10400,-9300,19700,1181884,2024.03.14
185,No Yesterday,Jeremy McComb,5,-2,7,1,0,10000,-2400,12400,825,2024.03.14
186,God Only Knows,for King & Country,1,1,0,1,0,9500,9500,0,1124234,2024.03.14
186,His Grave Wrote The Song,Greater Vision,1,1,0,1,0,9500,9500,0,188,2024.03.14
186,Address Change Notification,Southbound,1,1,0,1,0,9500,9500,0,5425,2024.03.14
186,Sunday Sermons,Anne Wilson,1,1,0,1,0,9500,9500,0,622447,2024.03.14
190,Waiting For Me,Truesong,1,0,1,1,0,9500,2200,7300,516,2024.03.14
190,Means Something To Me,Tate Emmons,1,0,1,1,0,9500,2200,7300,712,2024.03.14
192,Giving You Up,Kameron Marlowe,1,-1,2,1,0,9500,6100,3400,847878,2024.03.14
193,Space In My Heart,Enrique Iglesias & Miranda Lambert,7,7,0,1,0,9400,9400,0,1433051,2024.03.14
194,Strangers,Kameron Marlowe & Ella Langley,2,2,0,1,0,9000,9000,0,944652,2024.03.14
195,Wild as You,Cody Johnson,4,0,4,2,0,8800,-2300,11100,1395110,2024.03.14
196,The Great Divide,Luke Combs & Billy Strings,4,-1,5,1,0,8700,-5300,14000,206790,2024.03.14
197,I Should Have Married You,Old Dominion,1,1,0,1,0,8600,8600,0,459843,2024.03.14
198,Arkansas,Chris Stapleton,6,1,5,1,0,8400,1400,7000,478564,2024.03.14
199,Does Heaven Have A Creek,Elvie Shane,1,1,0,1,0,8300,8300,0,120480,2024.03.14
199,No Tomorrow,Heartland,1,1,0,1,0,8300,8300,0,2821,2024.03.14
1,Truck Bed,Hardy,8112,1098,7014,143,0,31048300,3620300,27428000,8314751,2024.03.21
2,Man Made A Bar,Morgan Wallen,6768,644,6124,144,0,26407600,2663900,23743700,8737606,2024.03.21
3,World On Fire,Nate Smith,6035,-35,6070,144,0,26328000,127200,26200800,5000394,2024.03.21
4,Mamaw's House,Thomas Rhett,6742,-1209,7951,144,0,25935000,-3432900,29367900,4058305,2024.03.21
5,23,Chayce Beckham,6151,302,5849,144,0,23158600,1911500,21247100,6248319,2024.03.21
6,Burn It Down,Parker Mccollum,6187,326,5861,144,0,23110300,1813300,21297000,6511390,2024.03.21
7,Outskirts,Sam Hunt,5582,754,4828,142,0,21637800,2827100,18810700,1355679,2024.03.21
8,Tucson Too Late,Jordan Davis,5056,483,4573,144,0,18873000,1469100,17403900,2624829,2024.03.21
9,Back Then Right Now,Tyler Hubbard,4911,354,4557,144,0,18752700,1627100,17125600,2658134,2024.03.21
10,Cab In A Solo,Scotty McCreery,4881,126,4755,144,0,18270900,933500,17337400,1086231,2024.03.21
11,Wildflowers And Wild Horses,Lainey Wilson,4964,382,4582,144,0,17219500,678800,16540700,6356585,2024.03.21
12,Take Her Home,Kenny Chesney,4319,449,3870,144,0,15557300,2006600,13550700,1307437,2024.03.21
13,Where It Ends,Bailey Zimmerman,4273,657,3616,143,0,15013400,2112100,12901300,4893939,2024.03.21
14,Fearless,Jackson Dean,3743,216,3527,143,0,12998500,947800,12050700,990611,2024.03.21
15,Halfway To Hell,Jelly Roll,3294,397,2897,144,0,12751600,1834500,10917100,2651748,2024.03.21
16,Your Place,Ashley Cooke,3499,312,3187,139,0,12396000,1105600,11290400,1911566,2024.03.21
17,We Don'T Fight Anymore,Carly Pearce,3539,393,3146,144,0,11817700,1190200,10627500,2786216,2024.03.21
18,Let Your Boys Be Country,Jason Aldean,2551,312,2239,142,0,8989100,1237500,7751600,1631784,2024.03.21
19,Out Of That Truck,Carrie Underwood,2627,151,2476,139,0,8849300,364300,8485000,1030093,2024.03.21
20,I'M Not Pretty,Megan Moroney,2552,202,2350,143,0,8280800,422800,7858000,2296743,2024.03.21
21,We Ride,Bryan Martin,2406,374,2032,142,0,8254700,969200,7285500,3975971,2024.03.21
22,Can't Break Up Now,Old Dominion,2588,145,2443,144,0,7311800,487300,6824500,1429520,2024.03.21
23,Young Love & Saturday Nights,Chris Young,2098,244,1854,139,0,7142300,1231200,5911100,1432753,2024.03.21
24,Love You Again,Chase Matthew,2263,229,2034,137,0,6655100,944200,5710900,2201588,2024.03.21
25,Bulletproof,Nate Smith,1427,287,1140,122,0,4717100,731200,3985900,3297796,2024.03.21
26,Chevrolet,Dustin Lynch Feat. Jelly Roll,1297,121,1176,116,0,3730300,365700,3364600,2385557,2024.03.21
27,Cowboys And Plowboys,Jon Pardi Feat. Luke Bryan,1430,182,1248,139,0,3722400,779100,2943300,387299,2024.03.21
28,Rodeo Man,Garth Brooks & Ronnie Dunn,1623,139,1484,142,0,3538700,444100,3094600,1599793,2024.03.21
29,Messed Up As Me,Keith Urban,1074,309,765,117,0,3444300,1229500,2214800,1530218,2024.03.21
30,Dance With You,Brett Young,1341,2,1339,128,0,3379400,15900,3363500,1665016,2024.03.21
31,One Bad Habit,Tim McGraw,1296,169,1127,137,0,3219200,300500,2918700,328298,2024.03.21
32,Texas Hold 'Em,Beyonce,1265,81,1184,123,0,3218600,702000,2516600,15330984,2024.03.21
33,This Is My Dirt,Justin Moore,1348,51,1297,134,0,3218600,99500,3119100,468889,2024.03.21
34,Gonna Love You,Parmalee,1345,105,1240,130,0,3086200,206500,2879700,263699,2024.03.21
35,Dirt Cheap,Cody Johnson,776,344,432,83,0,3011900,1102400,1909500,3736418,2024.03.21
36,Sounds Like The Radio,Zach Top,980,37,943,106,0,2799300,269700,2529600,467092,2024.03.21
37,Drinkin' Problems,Dillon Carmichael,1477,59,1418,138,0,2773200,76200,2697000,34855,2024.03.21
38,Bigger Houses,Dan + Shay,1066,93,973,129,0,2718200,221400,2496800,705378,2024.03.21
39,American Girl,Dierks Bentley,816,99,717,97,0,2615900,345700,2270200,692110,2024.03.21
40,She's Somebody's Daughter,Drew Baldridge,1066,154,912,116,0,2372100,406100,1966000,408772,2024.03.21
41,Find Another Bar,Chris Lane,915,83,832,99,0,1742200,41400,1700800,260271,2024.03.21
42,Boys Back Home,Dylan Marlowe Feat. Dylan Scott,718,31,687,85,0,1738800,106700,1632100,2984274,2024.03.21
43,Cowboy Songs,George Birge,683,339,344,104,0,1733000,777700,955300,448763,2024.03.21
44,In Your Love,Tyler Childers,880,-7,887,100,0,1720700,28900,1691800,3309153,2024.03.21
45,Think I’m In Love With You,Chris Stapleton,517,50,467,58,0,1404100,74300,1329800,3766392,2024.03.21
46,I'm In Love,Hailey Whitters,596,3,593,73,0,1393900,-140500,1534400,219062,2024.03.21
47,Brokenhearted,Joe Nichols,624,-5,629,64,0,1320400,-84600,1405000,10140,2024.03.21
48,Love You Back,Lady A,720,1,719,104,0,1219000,-17500,1236500,174902,2024.03.21
49,Whatcha See Is Whatcha Get,Chris Janson,614,-382,996,81,0,1211700,-2974500,4186200,535631,2024.03.21
50,I Tried A Ring On,Tigirlily Gold,527,68,459,73,0,962300,60000,902300,377516,2024.03.21
51,Breakin' In Boots,Matt Stell,620,66,554,82,0,955800,17500,938300,816255,2024.03.21
52,Last Rodeo,Restless Road,439,68,371,52,0,934600,113500,821100,1403160,2024.03.21
53,Ain'T About You,Huntergirl,593,-7,600,78,0,904300,-78900,983200,18839,2024.03.21
54,This Town's Been Too Good To Us,Dylan Scott,458,40,418,53,0,878400,285200,593200,3470098,2024.03.21
55,Spin You Around (1/24),Morgan Wallen,206,17,189,22,0,865000,116200,748800,6358392,2024.03.21
56,Damn Good Day To Leave,Riley Green,289,179,110,52,0,795000,518100,276900,525592,2024.03.21
57,Make Me Wanna Smoke,Runaway June,419,-4,423,49,0,719500,23900,695600,29737,2024.03.21
58,King Of Country Music,Ryan Larkins,342,1,341,52,0,625800,-48200,674000,12081,2024.03.21
59,Single Again,Josh Ross,296,181,115,47,0,619100,404200,214900,1963795,2024.03.21
60,No Caller Id,Megan Moroney,210,65,145,9,0,593700,194800,398900,4577096,2024.03.21
61,Color Up My World,"Hailey Whitters, Ben Rector",109,109,0,37,0,498300,498300,0,879191,2024.03.21
62,Rain In The Rearview,Anne Wilson,337,-8,345,45,0,481200,-58500,539700,1126246,2024.03.21
63,Wondering Why,Red Clay Strays,117,84,33,59,0,449500,326600,122900,4572484,2024.03.21
64,Life With You,Kelsey Hart,343,21,322,52,0,425000,51000,374000,1995937,2024.03.21
65,The Devil I Know,Ashley McBryde,212,95,117,36,0,422300,209500,212800,340562,2024.03.21
66,Called Crazy,Kassi Ashton,134,68,66,56,0,411100,205600,205500,195740,2024.03.21
67,Neon Baby,Annie Bosko,283,49,234,40,0,366400,51600,314800,18766,2024.03.21
68,Austin,Dasha,98,72,26,9,0,362000,278400,83600,8455047,2024.03.21
69,This Heart,Corey Kent,215,66,149,30,0,352200,71900,280300,2013633,2024.03.21
70,Cancel,Randy Houser,241,-38,279,33,0,310900,-20900,331800,48429,2024.03.21
71,Midwest Rock & Roll,Ryan Hurd,57,57,0,55,0,305100,305100,0,924546,2024.03.21
72,God & Country,Anne Wilson,56,10,46,55,0,302400,120600,181800,255904,2024.03.21
73,No One Else Like Me,Red Clay Strays,56,56,0,55,0,269800,269800,0,0,2024.03.21
74,Wine Into Whiskey,Tucker Wetmore,47,46,1,4,0,268200,262800,5400,5057525,2024.03.21
75,Damn Good Time,Jordan Davis,22,12,10,1,0,257600,168700,88900,160058,2024.03.21
76,Million Little Bandaids,Caroline Jones,245,23,222,37,0,251700,24900,226800,23973,2024.03.21
77,Purple Irises,Gwen Stefani & Blake Shelton,221,11,210,33,0,242700,-14200,256900,282094,2024.03.21
78,Cowgirls,Morgan Wallen,39,14,25,5,0,218600,95200,123400,6407330,2024.03.21
79,Dance Like No One's Watching,Gabby Barrett,35,12,23,7,0,210700,36200,174500,0,2024.03.21
80,Outlaws And Mustangs,Cody Jinks,34,1,33,5,0,167700,13400,154300,192095,2024.03.21
81,Things I Take For Granted,Larry Fleet,139,87,52,31,0,161500,67800,93700,1563260,2024.03.21
82,This Side Of The Dirt,Neon Union,156,-58,214,25,0,132800,-68200,201000,70712,2024.03.21
83,Wild Ones,Jessie Murph & Jelly Roll,43,-6,49,3,0,131300,3200,128100,12175479,2024.03.21
84,Holy Smokes,Bailey Zimmerman,23,23,0,1,0,117100,117100,0,5498508,2024.03.21
85,Bayou Boy,Graham Barham,34,-1,35,1,0,111300,-6900,118200,38477,2024.03.21
86,Devil You Know,Tyler Braden,36,9,27,3,0,109700,40300,69400,2858064,2024.03.21
87,Sarah's Place,Zach Bryan,14,-1,15,1,0,108500,-21200,129700,3157942,2024.03.21
88,How Is She,Cole Swindell,14,0,14,1,0,105300,300,105000,49794,2024.03.21
89,Country's Cool Again,Lainey Wilson,23,-1,24,3,0,101300,-1200,102500,1029235,2024.03.21
90,Jack And Diet Coke,Redferrin,38,-4,42,3,0,98400,-10000,108400,1877348,2024.03.21
91,Ain'T No Better Place,Niko Moon,17,2,15,1,0,98300,9400,88900,87588,2024.03.21
92,Space In My Heart,Enrique Iglesias & Miranda Lambert,21,14,7,1,0,97500,88100,9400,1664547,2024.03.21
93,Pretty Good Living,Sarahbeth Taite,48,48,0,48,0,95700,95700,0,39390,2024.03.21
94,Pray All The Way Home,Austin Snell,60,16,44,18,0,92900,7500,85400,1051013,2024.03.21
95,Fishin' In The Dark,Niko Moon,13,-8,21,1,0,92800,-44900,137700,167432,2024.03.21
96,How You Get To Heaven,Ty Herndon,8,3,5,1,0,90400,27300,63100,565,2024.03.21
97,Coal,Dylan Gossett,19,0,19,2,0,87500,5500,82000,5879562,2024.03.21
98,Colorado,Florida Georgia Line,15,0,15,2,0,86300,-2500,88800,49305,2024.03.21
99,Hey Driver,Zach Bryan Feat. The War and Treaty,36,12,24,4,0,80100,27100,53000,7023094,2024.03.21
100,With You I Am,Cody Johnson,9,1,8,3,0,79300,-13700,93000,1584416,2024.03.21
101,Grew Up Country,Dylan Marlowe,17,17,0,16,0,73900,73900,0,56209,2024.03.21
102,Pride,Sara Evans,27,27,0,14,0,73000,73000,0,15201,2024.03.21
103,Holy Water,Michael Ray,8,3,5,2,0,68900,27900,41000,226596,2024.03.21
104,Man Upstairs,Tim Dugger,13,-1,14,1,0,66500,-10400,76900,0,2024.03.21
105,Long Live Cowgirls,Ian Munsick & Cody Johnson,40,-28,68,7,0,62500,-60500,123000,800305,2024.03.21
106,5 Leaf Clover,Luke Combs,5,5,0,2,0,61000,61000,0,2444723,2024.03.21
107,Oklahoma Sooner,Jake Banfield,14,8,6,1,0,59000,33000,26000,3671,2024.03.21
108,I Like Big Trucks,Alli Walker,18,3,15,1,0,54500,7700,46800,47625,2024.03.21
109,The Star-Spangled Banner,Chris Stapleton,14,6,8,12,0,52100,24300,27800,93330,2024.03.21
110,Paying For It,Levi Hummon,50,20,30,9,0,50600,25900,24700,77424,2024.03.21
111,Thinkin Bout Cheatin,Mae Estes,69,35,34,18,0,50000,25400,24600,18204,2024.03.21
112,Heart They Didn'T Break,Maddie & Tae,61,1,60,6,0,50000,-6500,56500,432769,2024.03.21
113,Broadway Girls,Lil Durk Feat. Morgan Wallen,13,-8,21,2,0,49900,-26500,76400,3643324,2024.03.21
114,Walk Away Slow,Austin English,68,19,49,17,0,49200,12600,36600,954,2024.03.21
115,The Star-Spangled Banner,Carly Pearce,6,4,2,6,0,40600,29300,11300,0,2024.03.21
116,Cover Me Up,Morgan Wallen,10,-3,13,4,0,38800,8200,30600,4041618,2024.03.21
117,Use Me,Zach Top,14,0,14,1,0,37700,13100,24600,286337,2024.03.21
118,Always You,Trey Lewis,51,17,34,17,0,36900,12300,24600,112045,2024.03.21
118,One Two Step,Gunnar Latham,51,17,34,17,0,36900,12300,24600,801,2024.03.21
120,The Architect,Kacey Musgraves,8,8,0,2,0,35200,35200,0,3434669,2024.03.21
121,Strangers,Kameron Marlowe & Ella Langley,13,11,2,1,0,33500,24500,9000,961329,2024.03.21
122,Heart Attack,Boy Named Banjo,12,7,5,1,0,33200,17800,15400,3321,2024.03.21
123,25-8,Larry Fleet,9,1,8,1,0,31400,10600,20800,42939,2024.03.21
124,When My Baby's In Boots,Randall King,4,2,2,2,0,30900,15200,15700,0,2024.03.21
125,Dive,Luke Combs,2,2,0,1,0,30200,30200,0,1491715,2024.03.21
126,We Ain't The Only Ones,Randy Rogers & Wade Bowen,2,1,1,1,0,30200,15100,15100,0,2024.03.21
127,Dive Bar,"Willie Jones, Ben Burgess",17,17,0,1,0,28500,28500,0,15421,2024.03.21
128,Hippies & Cowboys,Cody Jinks,3,0,3,1,0,28400,0,28400,1549111,2024.03.21
129,That's Texas,Cody Johnson,3,-1,4,1,0,28400,-600,29000,265350,2024.03.21
130,Certified,Laura Bryna,45,-1,46,7,0,28100,-3300,31400,2027,2024.03.21
131,Neon Star (Country Boy Lullaby),Morgan Wallen,5,4,1,2,0,27800,22400,5400,2477039,2024.03.21
132,No News,A Thousand Horses,9,-28,37,9,0,25700,-140300,166000,24517,2024.03.21
133,She's Gotta Know,Conner Sweet,34,17,17,17,0,24600,12300,12300,1761,2024.03.21
134,Must Be The Whiskey,Cody Jinks,8,-1,9,3,0,24000,0,24000,1427491,2024.03.21
135,National Anthem From Battle At Bristol,Jennifer Nettles,4,1,3,4,0,23700,100,23600,0,2024.03.21
136,Heartless,Diplo & Julia Michaels Feat. Morgan Wallen,5,2,3,4,0,23400,9300,14100,4871296,2024.03.21
137,House Fire,Tyler Childers,8,2,6,1,0,21900,8500,13400,984004,2024.03.21
138,You In A Honky Tonk,Randall King,4,1,3,2,0,20600,2400,18200,322371,2024.03.21
139,Wings Of A Dove,Jonathan Wilburn,3,2,1,3,0,20000,13700,6300,0,2024.03.21
140,Heart Of A Small Town,Tim Dugger,3,1,2,1,0,19800,15100,4700,10293,2024.03.21
141,Open The Gate,Zach Bryan,3,0,3,1,0,19800,0,19800,1416705,2024.03.21
142,The Star Spangled Banner,Locash,1,0,1,1,0,19500,0,19500,0,2024.03.21
143,State You Left Me In,Jake Worthington,2,1,1,1,0,19200,18600,600,15339,2024.03.21
144,Better Off,Trace Adkins,2,0,2,1,0,19000,6500,12500,15865,2024.03.21
145,Summer,A Thousand Horses,8,-29,37,8,0,18500,-147500,166000,10979,2024.03.21
146,Dig,Ian Munsick,1,1,0,1,0,17900,17900,0,90582,2024.03.21
147,Loud and Heavy,Cody Jinks,8,2,6,2,0,17800,4200,13600,1580433,2024.03.21
148,Thicc As Thieves,Lauren Alaina,24,-14,38,3,0,17300,-34900,52200,297868,2024.03.21
149,Way Back When,Wayland,24,-12,36,12,0,17200,-8600,25800,1632,2024.03.21
150,I Need You,Frontmen,9,-4,13,2,0,16800,-17000,33800,601,2024.03.21
151,Wasteland,Element,2,2,0,1,0,16200,16200,0,1,2024.03.21
152,"Houston, We Got A Problem",Luke Combs,8,1,7,2,0,15800,-2200,18000,1225777,2024.03.21
153,What Good Am I,Zack Dyer,3,3,0,1,0,15700,15700,0,2267,2024.03.21
154,Give Me A Sunrise,Braxton Keith,2,-1,3,1,0,15700,-4100,19800,31203,2024.03.21
155,Greener Pastures,Brothers Osborne,2,2,0,1,0,15200,15200,0,43920,2024.03.21
156,Any Given Friday Night,Luke Combs,2,0,2,1,0,15200,0,15200,226283,2024.03.21
157,Record High,Randall King,2,1,1,2,0,15100,15100,0,23560,2024.03.21
158,A Tornado Warning,Turnpike Troubadours,1,1,0,1,0,15100,15100,0,184673,2024.03.21
158,Beautiful Things,Benson Boone,1,1,0,1,0,15100,15100,0,26645828,2024.03.21
158,A Little Bit Closer,Braxton Keith,1,1,0,1,0,15100,15100,0,67274,2024.03.21
158,Follow,William Beckmann,1,1,0,1,0,15100,15100,0,5723,2024.03.21
162,No Yesterday,Jeremy McComb,6,1,5,1,0,15100,5100,10000,582,2024.03.21
163,Half a Song,Cody Johnson,1,0,1,1,0,15100,11000,4100,454661,2024.03.21
163,Quittin' Time,Zach Bryan,1,0,1,1,0,15100,11000,4100,1142449,2024.03.21
165,I'M Not For Everyone,Brothers Osborne,3,-1,4,3,0,14600,-5100,19700,448599,2024.03.21
166,No Present LIke The Time,Jay Allen,37,-5,42,6,0,14600,-4800,19400,0,2024.03.21
167,Butterflies,Kacey Musgraves,3,1,2,1,0,13400,6400,7000,863794,2024.03.21
168,'98 Braves,Morgan Wallen,3,-6,9,2,0,13200,-45400,58600,2010920,2024.03.21
169,Giving You Up,Kameron Marlowe,3,2,1,1,0,12900,3400,9500,833379,2024.03.21
170,What Else Is New,Cody Jinks,8,0,8,1,0,12900,2100,10800,86354,2024.03.21
171,Justified,John Ritter,2,2,0,2,0,12800,12800,0,0,2024.03.21
172,Stones,Crabb Family,2,2,0,2,0,12700,12700,0,5976,2024.03.21
172,That Is That,Adams Voice,2,2,0,2,0,12700,12700,0,0,2024.03.21
174,He Pilots My Ship,Tribute Quartet,2,1,1,2,0,12700,6400,6300,869,2024.03.21
174,Come On In,Kingdom Heirs,2,1,1,2,0,12700,6400,6300,1894,2024.03.21
176,Work Boots,Cody Johnson,1,-1,2,1,0,12700,8000,4700,373487,2024.03.21
177,Silverado,Caleb Lee Hutchinson,17,-17,34,17,0,12300,-12300,24600,12593,2024.03.21
178,A Cowboy Who Would,Chancey Williams,17,-34,51,17,0,12300,-24600,36900,44815,2024.03.21
179,The Great Divide,Luke Combs & Billy Strings,5,1,4,1,0,11900,3200,8700,206639,2024.03.21
180,Dirt In My Life,Rob Mayes,16,16,0,16,0,11700,11700,0,0,2024.03.21
180,Hollywood Sign,Wayland,16,16,0,16,0,11700,11700,0,0,2024.03.21
180,Other End,Wayland,16,16,0,16,0,11700,11700,0,1331,2024.03.21
183,Trust,Chris Stapleton,2,1,1,1,0,11400,4700,6700,426942,2024.03.21
184,Nothin' On You,Cody Johnson,2,2,0,2,0,11300,11300,0,1123170,2024.03.21
185,White House Road,Tyler Childers & The Highwall,5,4,1,2,0,11100,7500,3600,2582307,2024.03.21
186,If I Was Your Lover,Kip Moore,2,2,0,1,0,10800,10800,0,39298,2024.03.21
186,Ain'T She,Adam Doleac,2,2,0,1,0,10800,10800,0,410287,2024.03.21
188,Days That End In Why,Morgan Wallen,4,1,3,2,0,10600,7600,3000,1123837,2024.03.21
189,Outro,Mica Levi,1,-4,5,1,0,10600,-3000,13600,87,2024.03.21
190,Playboys,Midland,8,-1,9,1,0,10500,-3900,14400,73613,2024.03.21
191,Leave You Alone,Kane Brown,2,2,0,2,0,10400,10400,0,338017,2024.03.21
192,Heartfirst,Kelsea Ballerini,2,1,1,2,0,10000,8400,1600,323245,2024.03.21
193,The Star Spangled Banner,Brad Paisley,2,0,2,2,0,10000,4800,5200,0,2024.03.21
194,The Stone Is Rolled Away,Taranda Greene,1,1,0,1,0,9500,9500,0,448,2024.03.21
194,Never A Time,Perrys,1,1,0,1,0,9500,9500,0,3552,2024.03.21
194,Because He Lives,Carrie Underwood,1,1,0,1,0,9500,9500,0,56699,2024.03.21
194,Sheltered In The Arms Of God,Hillary Scott & The Scott Family,1,1,0,1,0,9500,9500,0,4713,2024.03.21
194,The Refrigerator Door,Mark Bishop,1,1,0,1,0,9500,9500,0,243,2024.03.21
199,Summertime Blues,Zach Bryan,5,2,3,1,0,9300,6300,3000,593839,2024.03.21
200,I Went To College/I Went To Jail,Ernest,3,3,0,2,0,8700,8700,0,1401508,2024.03.21
1,23,Chayce Beckham,7782,1631,6151,144,0,28150900,4992300,23158600,6385072,2024.03.28
2,Truck Bed,Hardy,6819,-1293,8112,143,0,27180800,-3867500,31048300,7790228,2024.03.28
3,Man Made A Bar,Morgan Wallen,6916,148,6768,144,0,26553600,146000,26407600,8834012,2024.03.28
4,World On Fire,Nate Smith,5596,-439,6035,144,0,24750000,-1578000,26328000,4847788,2024.03.28
5,Outskirts,Sam Hunt,6549,967,5582,141,0,24729900,3092100,21637800,1408834,2024.03.28
6,Burn It Down,Parker Mccollum,6318,131,6187,144,0,23522200,411900,23110300,6373515,2024.03.28
7,Back Then Right Now,Tyler Hubbard,5315,404,4911,144,0,19934800,1182100,18752700,2327233,2024.03.28
8,Tucson Too Late,Jordan Davis,5125,69,5056,144,0,19302300,429300,18873000,2487308,2024.03.28
9,Cab In A Solo,Scotty McCreery,5094,213,4881,144,0,19106000,835100,18270900,1012424,2024.03.28
10,Wildflowers And Wild Horses,Lainey Wilson,5170,206,4964,144,0,17487400,267900,17219500,5976368,2024.03.28
11,Take Her Home,Kenny Chesney,4547,228,4319,144,0,16824100,1266800,15557300,2599184,2024.03.28
12,Where It Ends,Bailey Zimmerman,4608,335,4273,143,0,16383800,1370400,15013400,4701805,2024.03.28
13,Fearless,Jackson Dean,3939,196,3743,143,0,13824500,826000,12998500,922865,2024.03.28
14,Halfway To Hell,Jelly Roll,3604,310,3294,144,0,13552500,800900,12751600,2631876,2024.03.28
15,Your Place,Ashley Cooke,3802,303,3499,141,0,12973400,577400,12396000,1803196,2024.03.28
16,We Don'T Fight Anymore,Carly Pearce,3482,-57,3539,144,0,11937800,120100,11817700,2698867,2024.03.28
17,Let Your Boys Be Country,Jason Aldean,2822,271,2551,142,0,9923400,934300,8989100,1616379,2024.03.28
18,I'M Not Pretty,Megan Moroney,2693,141,2552,143,0,9050600,769800,8280800,2307675,2024.03.28
19,Out Of That Truck,Carrie Underwood,2707,80,2627,139,0,8814100,-35200,8849300,935641,2024.03.28
20,We Ride,Bryan Martin,2498,92,2406,141,0,8676300,421600,8254700,3893257,2024.03.28
21,Young Love & Saturday Nights,Chris Young,2286,188,2098,140,0,7647600,505300,7142300,1967142,2024.03.28
22,Can't Break Up Now,Old Dominion,2559,-29,2588,144,0,7529200,217400,7311800,1433326,2024.03.28
23,Tie Up,Zac Brown Band,1618,1616,2,107,0,7324700,7320800,3900,1429656,2024.03.28
24,Love You Again,Chase Matthew,2214,-49,2263,138,0,6502200,-152900,6655100,2187976,2024.03.28
25,Bulletproof,Nate Smith,1745,318,1427,139,0,5698700,981600,4717100,3377085,2024.03.28
26,Cowboys And Plowboys,Jon Pardi Feat. Luke Bryan,1576,146,1430,140,0,4053600,331200,3722400,610660,2024.03.28
27,Dirt Cheap,Cody Johnson,1022,246,776,96,0,3996000,984100,3011900,3725653,2024.03.28
28,Chevrolet,Dustin Lynch Feat. Jelly Roll,1435,138,1297,130,0,3826100,95800,3730300,2278953,2024.03.28
29,Rodeo Man,Garth Brooks & Ronnie Dunn,1583,-40,1623,143,0,3746100,207400,3538700,1389375,2024.03.28
30,Messed Up As Me,Keith Urban,1128,54,1074,110,0,3608200,163900,3444300,1151637,2024.03.28
31,This Is My Dirt,Justin Moore,1411,63,1348,134,0,3570400,351800,3218600,444575,2024.03.28
32,One Bad Habit,Tim McGraw,1433,137,1296,141,0,3529200,310000,3219200,292639,2024.03.28
33,Dance With You,Brett Young,1393,52,1341,130,0,3444000,64600,3379400,1688519,2024.03.28
34,Texas Hold 'Em,Beyonce,1470,205,1265,124,0,3388200,169600,3218600,14950243,2024.03.28
35,Drinkin' Problems,Dillon Carmichael,1533,56,1477,140,0,3340100,566900,2773200,30463,2024.03.28
36,Gonna Love You,Parmalee,1396,51,1345,133,0,3279500,193300,3086200,239413,2024.03.28
37,Sounds Like The Radio,Zach Top,1057,77,980,106,0,2997200,197900,2799300,445909,2024.03.28
38,Bigger Houses,Dan + Shay,1071,5,1066,129,0,2803600,85400,2718200,723918,2024.03.28
39,She's Somebody's Daughter,Drew Baldridge,1106,40,1066,120,0,2697200,325100,2372100,410388,2024.03.28
40,American Girl,Dierks Bentley,817,1,816,96,0,2549900,-66000,2615900,622997,2024.03.28
41,Cowboy Songs,George Birge,773,90,683,106,0,2076900,343900,1733000,451461,2024.03.28
42,Find Another Bar,Chris Lane,960,45,915,97,0,1816700,74500,1742200,195642,2024.03.28
43,Boys Back Home,Dylan Marlowe Feat. Dylan Scott,729,11,718,86,0,1776800,38000,1738800,2732206,2024.03.28
44,In Your Love,Tyler Childers,918,38,880,106,0,1729200,8500,1720700,3455988,2024.03.28
45,Whatcha See Is Whatcha Get,Chris Janson,701,87,614,93,0,1652800,441100,1211700,318505,2024.03.28
46,I'm In Love,Hailey Whitters,636,40,596,73,0,1472600,78700,1393900,205136,2024.03.28
47,Think I’m In Love With You,Chris Stapleton,549,32,517,57,0,1410700,6600,1404100,3501060,2024.03.28
48,Brokenhearted,Joe Nichols,624,0,624,64,0,1393500,73100,1320400,9889,2024.03.28
49,Damn Good Day To Leave,Riley Green,519,230,289,69,0,1352700,557700,795000,606795,2024.03.28
50,Breakin' In Boots,Matt Stell,654,34,620,89,0,1302400,346600,955800,932752,2024.03.28
51,Love You Back,Lady A,719,-1,720,103,0,1205400,-13600,1219000,172799,2024.03.28
52,Called Crazy,Kassi Ashton,236,102,134,72,0,1203200,792100,411100,87493,2024.03.28
53,Austin,Dasha,293,195,98,32,0,1012000,650000,362000,10090865,2024.03.28
54,This Town's Been Too Good To Us,Dylan Scott,488,30,458,58,0,1005200,126800,878400,3474581,2024.03.28
55,I Tried A Ring On,Tigirlily Gold,639,112,527,87,0,918600,-43700,962300,348727,2024.03.28
56,Last Rodeo,Restless Road,423,-16,439,52,0,880500,-54100,934600,1260873,2024.03.28
57,Spin You Around (1/24),Morgan Wallen,227,21,206,21,0,854800,-10200,865000,6450270,2024.03.28
58,Ain'T About You,Huntergirl,535,-58,593,75,0,729700,-174600,904300,17039,2024.03.28
59,Single Again,Josh Ross,352,56,296,52,0,664900,45800,619100,1612411,2024.03.28
60,Life With You,Kelsey Hart,398,55,343,59,0,657900,232900,425000,1925433,2024.03.28
61,King Of Country Music,Ryan Larkins,360,18,342,54,0,630500,4700,625800,12244,2024.03.28
62,Make Me Wanna Smoke,Runaway June,399,-20,419,49,0,605200,-114300,719500,29705,2024.03.28
63,Color Up My World,"Hailey Whitters, Ben Rector",151,42,109,40,0,604400,106100,498300,1019478,2024.03.28
64,No Caller Id,Megan Moroney,186,-24,210,8,0,544200,-49500,593700,4366475,2024.03.28
65,Wine Into Whiskey,Tucker Wetmore,97,50,47,6,0,438900,170700,268200,5468751,2024.03.28
66,The Devil I Know,Ashley McBryde,245,33,212,29,0,438800,16500,422300,321932,2024.03.28
67,Things I Take For Granted,Larry Fleet,268,129,139,46,0,434700,273200,161500,1930788,2024.03.28
68,This Heart,Corey Kent,258,43,215,32,0,415400,63200,352200,2014360,2024.03.28
69,Rain In The Rearview,Anne Wilson,278,-59,337,49,0,408900,-72300,481200,926713,2024.03.28
70,Just To Say We Did,Kenny Chesney,49,49,0,47,0,343300,343300,0,1117775,2024.03.28
71,Neon Baby,Annie Bosko,264,-19,283,40,0,315900,-50500,366400,18666,2024.03.28
72,Cowgirls,Morgan Wallen,70,31,39,9,0,296500,77900,218600,6427204,2024.03.28
73,The Architect,Kacey Musgraves,101,93,8,43,0,295200,260000,35200,2651803,2024.03.28
74,Born,Kenny Chesney,45,45,0,45,0,287300,287300,0,1770438,2024.03.28
75,Million Little Bandaids,Caroline Jones,254,9,245,37,0,278500,26800,251700,27674,2024.03.28
76,Holy Smokes,Bailey Zimmerman,34,11,23,1,0,219600,102500,117100,4974011,2024.03.28
77,Purple Irises,Gwen Stefani & Blake Shelton,204,-17,221,31,0,216800,-25900,242700,278643,2024.03.28
78,Damn Good Time,Jordan Davis,18,-4,22,1,0,206900,-50700,257600,150213,2024.03.28
79,Cancel,Randy Houser,157,-84,241,30,0,183600,-127300,310900,32664,2024.03.28
80,Outlaws And Mustangs,Cody Jinks,42,8,34,4,0,181300,13600,167700,387038,2024.03.28
81,Hey There Hometown,Abby Leigh Anderson,36,36,0,35,0,158100,158100,0,665,2024.03.28
82,Ain'T No Better Place,Niko Moon,25,8,17,1,0,157600,59300,98300,75810,2024.03.28
83,Wondering Why,Red Clay Strays,54,-63,117,4,0,142600,-306900,449500,4550143,2024.03.28
84,Wild Ones,Jessie Murph & Jelly Roll,44,1,43,2,0,133500,2200,131300,10620761,2024.03.28
85,Wherever You Are Tonight,Kenny Chesney,17,16,1,15,0,131300,128200,3100,951271,2024.03.28
86,Bayou Boy,Graham Barham,36,2,34,1,0,130900,19600,111300,31447,2024.03.28
87,Dance Like No One's Watching,Gabby Barrett,28,-7,35,3,0,128900,-81800,210700,0,2024.03.28
88,Hey Driver,Zach Bryan Feat. The War and Treaty,42,6,36,3,0,113000,32900,80100,6724483,2024.03.28
89,Sarah's Place,Zach Bryan,16,2,14,2,0,112800,4300,108500,3048969,2024.03.28
90,How Is She,Cole Swindell,14,0,14,1,0,105600,300,105300,45135,2024.03.28
91,Coal,Dylan Gossett,21,2,19,2,0,105200,17700,87500,5719304,2024.03.28
92,2am In London,Morgan Wade,48,48,0,48,0,95700,95700,0,298746,2024.03.28
93,Barely A Two Lane Road,Catie Offerman,48,47,1,48,0,95700,87700,8000,39427,2024.03.28
94,Nothing's News,Cody Jinks,14,14,0,14,0,94900,94900,0,59180,2024.03.28
95,Man Upstairs,Tim Dugger,16,3,13,1,0,90800,24300,66500,0,2024.03.28
96,No Present LIke The Time,Jay Allen,120,83,37,24,0,86300,71700,14600,0,2024.03.28
97,Devil You Know,Tyler Braden,31,-5,36,4,0,85600,-24100,109700,3240994,2024.03.28
98,Jack And Diet Coke,Redferrin,32,-6,38,3,0,80600,-17800,98400,1824233,2024.03.28
99,Paint The Town Blue,Ella Langley,16,16,0,15,0,70800,70800,0,360747,2024.03.28
100,Broadway Girls,Lil Durk Feat. Morgan Wallen,15,2,13,2,0,62500,12600,49900,3640141,2024.03.28
101,Young Man,Greylan James,10,10,0,2,0,56000,56000,0,40516,2024.03.28
102,Paying For It,Levi Hummon,61,11,50,9,0,53100,2500,50600,77176,2024.03.28
103,I Like Big Trucks,Alli Walker,17,-1,18,1,0,51500,-3000,54500,33292,2024.03.28
104,Heart They Didn'T Break,Maddie & Tae,60,-1,61,6,0,49800,-200,50000,406560,2024.03.28
105,Money On Me,Morgan Wallen,14,14,0,14,0,42300,42300,0,643449,2024.03.28
106,Goodbye You,Landon Parker,49,49,0,17,0,41000,41000,0,1322,2024.03.28
107,Space In My Heart,Enrique Iglesias & Miranda Lambert,12,-9,21,1,0,40400,-57100,97500,925046,2024.03.28
108,Thinkin Bout Cheatin,Mae Estes,53,-16,69,18,0,40300,-9700,50000,18899,2024.03.28
109,This Side Of The Dirt,Neon Union,84,-72,156,17,0,40200,-92600,132800,51121,2024.03.28
110,Country's Cool Again,Lainey Wilson,18,-5,23,2,0,39300,-62000,101300,819230,2024.03.28
111,Break Mine,Brothers Osborne,9,9,0,6,0,37900,37900,0,888051,2024.03.28
112,Strangers,Kameron Marlowe & Ella Langley,16,3,13,1,0,37300,3800,33500,948469,2024.03.28
113,Hold On To Me,Nathan Merovich,48,36,12,12,0,34400,25800,8600,0,2024.03.28
114,Few Good Stories,Kenny Chesney,3,3,0,3,0,33500,33500,0,544502,2024.03.28
115,The Star-Spangled Banner,Chris Stapleton,8,-6,14,8,0,33400,-18700,52100,88634,2024.03.28
116,Oklahoma Sooner,Jake Banfield,10,-4,14,1,0,33000,-26000,59000,4263,2024.03.28
117,How You Get To Heaven,Ty Herndon,4,-4,8,1,0,31700,-58700,90400,446,2024.03.28
118,Summertime Blues,Zach Bryan,12,7,5,2,0,30400,21100,9300,578591,2024.03.28
119,Use Me,Zach Top,13,-1,14,1,0,30200,-7500,37700,211873,2024.03.28
120,Neon Star (Country Boy Lullaby),Morgan Wallen,6,1,5,1,0,29400,1600,27800,2314855,2024.03.28
121,Fiddle In The Band,Kane Brown,3,3,0,2,0,28400,28400,0,2612767,2024.03.28
122,Lighten That Load,Waylon Hanel,34,34,0,17,0,27100,27100,0,6455,2024.03.28
123,Pray All The Way Home,Austin Snell,35,-25,60,18,0,25900,-67000,92900,1046141,2024.03.28
124,What She Sees In Me,Chris Young,4,4,0,4,0,25500,25500,0,813268,2024.03.28
125,That's Texas,Cody Johnson,3,0,3,2,0,25500,-2900,28400,247612,2024.03.28
126,Heartfirst,Kelsea Ballerini,6,4,2,5,0,25000,15000,10000,309666,2024.03.28
127,Certified,Laura Bryna,37,-8,45,7,0,24800,-3300,28100,2032,2024.03.28
128,Heart Attack,Boy Named Banjo,8,-4,12,1,0,24500,-8700,33200,3276,2024.03.28
129,Sun To Me,Zach Bryan,7,5,2,3,0,24300,19000,5300,6093745,2024.03.28
130,Oklahoma Smokeshow,Zach Bryan,5,4,1,2,0,24200,22000,2200,6625506,2024.03.28
131,Darlin',Jenna Paulette,4,4,0,1,0,24100,24100,0,118908,2024.03.28
132,"Burn, Burn, Burn",Zach Bryan,4,4,0,1,0,23600,23600,0,5438115,2024.03.28
132,From Austin,Zach Bryan,5,4,1,2,0,23600,23600,0,2844384,2024.03.28
134,Guilty Pleasure,Kenny Chesney,3,2,1,2,0,23500,20700,2800,739055,2024.03.28
135,5 Leaf Clover,Luke Combs,5,0,5,5,0,23300,-37700,61000,2319014,2024.03.28
136,Pride,Sara Evans,7,-20,27,3,0,23300,-49700,73000,139239,2024.03.28
137,Thicc As Thieves,Lauren Alaina,20,-4,24,4,0,23200,5900,17300,346861,2024.03.28
138,Here Comes Jesus,Jeff & Sheri Easter,3,2,1,2,0,23100,16800,6300,27253,2024.03.28
139,'98 Braves,Morgan Wallen,4,1,3,4,0,22200,9000,13200,1949359,2024.03.28
140,You In A Honky Tonk,Randall King,3,-1,4,2,0,21700,1100,20600,314562,2024.03.28
141,Wreckage,Nate Smith,8,3,5,1,0,21600,15200,6400,862682,2024.03.28
142,Mine Again,Zach Bryan,3,3,0,1,0,20900,20900,0,729541,2024.03.28
142,Heading South,Zach Bryan,3,3,0,1,0,20900,20900,0,6278513,2024.03.28
144,National Anthem,Pryor & Lee,3,3,0,3,0,20100,20100,0,0,2024.03.28
145,I Need You,Frontmen,11,2,9,2,0,19900,3100,16800,1597,2024.03.28
146,What Good Am I,Zack Dyer,4,1,3,1,0,19600,3900,15700,2402,2024.03.28
147,Star Spangled Banner,Maren Morris,1,1,0,1,0,19500,19500,0,0,2024.03.28
148,Quittin' Time,Zach Bryan,2,1,1,1,0,19200,4100,15100,1129147,2024.03.28
149,When My Baby's In Boots,Randall King,2,-2,4,1,0,19200,-11700,30900,0,2024.03.28
150,25-8,Larry Fleet,7,-2,9,1,0,18000,-13400,31400,41414,2024.03.28
151,Thinkin' Bout,Kenny Chesney,1,1,0,1,0,17900,17900,0,616307,2024.03.28
152,You'll Always Be My Baby (Written For Daughters' Weddings),Alan Jackson,8,6,2,1,0,17700,13700,4000,42595,2024.03.28
153,Long Live Cowgirls,Ian Munsick & Cody Johnson,23,-17,40,4,0,17600,-44900,62500,758172,2024.03.28
154,One More Sunset,Kenny Chesney,1,1,0,1,0,17500,17500,0,441061,2024.03.28
155,Good Day (2021),Brett Eldredge,3,2,1,1,0,16200,10800,5400,68265,2024.03.28
156,Dive Bar,"Willie Jones, Ben Burgess",11,-6,17,1,0,15900,-12600,28500,13868,2024.03.28
157,Means Something To Me,Tate Emmons,2,1,1,2,0,15800,9500,6300,861,2024.03.28
158,Ain't It Baby (Live at Billy Bob's Texas),Josh Ward,2,2,0,1,0,15700,15700,0,865,2024.03.28
159,Can Down,Mike Ryan,2,1,1,1,0,15700,15700,0,33617,2024.03.28
160,A Little Bit Closer,Braxton Keith,2,1,1,1,0,15700,600,15100,75948,2024.03.28
161,Holy Roller,Zach Bryan,8,3,5,1,0,15300,9600,5700,1093212,2024.03.28
162,Any Given Friday Night,Luke Combs,2,0,2,1,0,15200,0,15200,211251,2024.03.28
163,Dive,Luke Combs,2,0,2,1,0,15200,-15000,30200,1452797,2024.03.28
164,Young Man's Blues,Parker Mccollum,1,1,0,1,0,15100,15100,0,552688,2024.03.28
164,If I Had A Bar,Jon Wolfe,1,1,0,1,0,15100,15100,0,9764,2024.03.28
164,If You Can Dance,Jon Stork,1,1,0,1,0,15100,15100,0,1386,2024.03.28
167,Up In Texas,Midland,1,0,1,1,0,15100,14500,600,99496,2024.03.28
168,Work Boots,Cody Johnson,1,0,1,1,0,15100,2400,12700,338198,2024.03.28
169,We Ain't The Only Ones,Randy Rogers & Wade Bowen,1,-1,2,1,0,15100,-15100,30200,0,2024.03.28
170,Hippies & Cowboys,Cody Jinks,1,-2,3,1,0,15100,-13300,28400,1538657,2024.03.28
171,Am I The Only One,Aaron Lewis,4,2,2,1,0,15000,9400,5600,599631,2024.03.28
172,This Too Shall Pass,Kenny Chesney,1,1,0,1,0,15000,15000,0,373446,2024.03.28
173,One Two Step,Gunnar Latham,17,-34,51,17,0,14800,-22100,36900,849,2024.03.28
174,Birmingham,Zach Bryan,2,2,0,1,0,14200,14200,0,606690,2024.03.28
174,Spotless,Zach Bryan,2,2,0,1,0,14200,14200,0,3709900,2024.03.28
174,Fear And Friday's,Zach Bryan,2,2,0,1,0,14200,14200,0,1725063,2024.03.28
177,He Bought Me,Old Paths,2,1,1,2,0,13700,7300,6400,137,2024.03.28
178,In God's Time,Jordan Family Band,2,1,1,2,0,13600,7300,6300,3178,2024.03.28
179,Heart Of A Small Town,Tim Dugger,3,0,3,1,0,13600,-6200,19800,9322,2024.03.28
180,If She Wants A Cowboy,Zach Bryan,2,2,0,1,0,13400,13400,0,637425,2024.03.28
181,Loud and Heavy,Cody Jinks,6,-2,8,1,0,13200,-4600,17800,1555331,2024.03.28
182,The Star-Spangled Banner,Carly Pearce,2,-4,6,2,0,13100,-27500,40600,0,2024.03.28
183,I Can'T Breathe,Parker Mccollum,1,1,0,1,0,12700,12700,0,1015153,2024.03.28
184,Come On In,Kingdom Heirs,2,0,2,2,0,12700,0,12700,1777,2024.03.28
185,Wings Of A Dove,Jonathan Wilburn,2,-1,3,2,0,12700,-7300,20000,0,2024.03.28
186,"Houston, We Got A Problem",Luke Combs,4,-4,8,1,0,12500,-3300,15800,1277435,2024.03.28
187,A Cowboy Who Would,Chancey Williams,17,0,17,17,0,12300,0,12300,27738,2024.03.28
188,She's Gotta Know,Conner Sweet,17,-17,34,17,0,12300,-12300,24600,1157,2024.03.28
189,Always You,Trey Lewis,17,-34,51,17,0,12300,-24600,36900,107059,2024.03.28
190,My Bar,Priscilla Block,1,1,0,1,0,11200,11200,0,129295,2024.03.28
191,The Chop,Scoot Teasley,2,2,0,1,0,10800,10800,0,3592,2024.03.28
192,Actin' Up,Miranda Lambert,2,2,0,1,0,10300,10300,0,288331,2024.03.28
193,Wine Country,Hannah Ellis,12,0,12,2,0,10300,2500,7800,18311,2024.03.28
194,Small Town Spinnin',Marynn Taylor,1,1,0,1,0,10200,10200,0,37588,2024.03.28
194,Back Home,Shane Profitt,1,1,0,1,0,10200,10200,0,69557,2024.03.28
196,Sunrise,Morgan Wallen,2,1,1,2,0,10200,4800,5400,3117877,2024.03.28
197,No Yesterday,Jeremy McComb,5,-1,6,1,0,9900,-5200,15100,1480,2024.03.28
198,Ain'T She,Adam Doleac,2,0,2,1,0,9800,-1000,10800,437442,2024.03.28
199,Decoration,Jillian Riscoe,8,3,5,1,0,9600,1900,7700,7,2024.03.28
200,Long Gone,Kenny Chesney,1,1,0,1,0,9600,9600,0,290896,2024.03.28
1,Burn It Down,Parker Mccollum,7368,1050,6318,144,0,27514600,3992400,23522200,6814864,2024.04.04
2,Man Made A Bar,Morgan Wallen,7177,261,6916,144,0,27298000,744400,26553600,9142177,2024.04.04
3,Outskirts,Sam Hunt,7148,599,6549,142,0,26960400,2230500,24729900,1670531,2024.04.04
4,World On Fire,Nate Smith,5433,-163,5596,144,0,24266200,-483800,24750000,4706456,2024.04.04
5,Truck Bed,Hardy,5611,-1208,6819,141,0,22277300,-4903500,27180800,6860940,2024.04.04
6,Pretty Little Poison,Warren Zeiders,5199,-260,5459,140,0,21819000,-1295800,23114800,7251970,2024.04.04
7,Back Then Right Now,Tyler Hubbard,5883,568,5315,144,0,21429000,1494200,19934800,2496245,2024.04.04
8,Tucson Too Late,Jordan Davis,5599,474,5125,144,0,21119100,1816800,19302300,2296014,2024.04.04
9,Cab In A Solo,Scotty McCreery,5434,340,5094,144,0,20369800,1263800,19106000,1089394,2024.04.04
10,23,Chayce Beckham,4914,-2868,7782,144,0,19376300,-8774600,28150900,8171587,2024.04.04
11,Wildflowers And Wild Horses,Lainey Wilson,5425,255,5170,144,0,18495100,1007700,17487400,6183674,2024.04.04
12,Take Her Home,Kenny Chesney,4692,145,4547,144,0,17694700,870600,16824100,1796464,2024.04.04
13,Where It Ends,Bailey Zimmerman,4831,223,4608,144,0,17205200,821400,16383800,5217244,2024.04.04
14,Fearless,Jackson Dean,4115,176,3939,143,0,14546000,721500,13824500,982718,2024.04.04
15,Halfway To Hell,Jelly Roll,3889,285,3604,144,0,14511700,959200,13552500,2724395,2024.04.04
16,Your Place,Ashley Cooke,4128,326,3802,143,0,14070800,1097400,12973400,1876481,2024.04.04
17,We Don'T Fight Anymore,Carly Pearce,3798,316,3482,144,0,12512900,575100,11937800,2525384,2024.04.04
18,Let Your Boys Be Country,Jason Aldean,3162,340,2822,143,0,11341600,1418200,9923400,1617653,2024.04.04
19,We Ride,Bryan Martin,2733,235,2498,143,0,9599000,922700,8676300,3960875,2024.04.04
20,I'M Not Pretty,Megan Moroney,2814,121,2693,141,0,9218400,167800,9050600,2306568,2024.04.04
21,Out Of That Truck,Carrie Underwood,2768,61,2707,139,0,9210900,396800,8814100,1151054,2024.04.04
22,Can't Break Up Now,Old Dominion,2732,173,2559,144,0,8444800,915600,7529200,1345448,2024.04.04
23,Young Love & Saturday Nights,Chris Young,2342,56,2286,143,0,7876900,229300,7647600,1499163,2024.04.04
24,Bulletproof,Nate Smith,2053,308,1745,139,0,6943700,1245000,5698700,3876250,2024.04.04
25,Love You Again,Chase Matthew,2323,109,2214,139,0,6937900,435700,6502200,2294929,2024.04.04
26,Dirt Cheap,Cody Johnson,1234,212,1022,103,0,4853300,857300,3996000,4090617,2024.04.04
27,Cowboys And Plowboys,Jon Pardi Feat. Luke Bryan,1664,88,1576,140,0,4474700,421100,4053600,581086,2024.04.04
28,Chevrolet,Dustin Lynch Feat. Jelly Roll,1539,104,1435,132,0,4318900,492800,3826100,2267527,2024.04.04
29,Rodeo Man,Garth Brooks & Ronnie Dunn,1798,215,1583,143,0,4247800,501700,3746100,1124043,2024.04.04
30,Dance With You,Brett Young,1441,48,1393,129,0,4158700,714700,3444000,1532994,2024.04.04
31,Messed Up As Me,Keith Urban,1270,142,1128,125,0,4002900,394700,3608200,1055526,2024.04.04
32,Gonna Love You,Parmalee,1507,111,1396,131,0,3946000,666500,3279500,245734,2024.04.04
33,One Bad Habit,Tim McGraw,1559,126,1433,144,0,3729100,199900,3529200,317969,2024.04.04
34,Drinkin' Problems,Dillon Carmichael,1672,139,1533,141,0,3648400,308300,3340100,30089,2024.04.04
35,This Is My Dirt,Justin Moore,1343,-68,1411,134,0,3470100,-100300,3570400,418649,2024.04.04
36,She's Somebody's Daughter,Drew Baldridge,1272,166,1106,121,0,3267000,569800,2697200,395922,2024.04.04
37,Texas Hold 'Em,Beyonce,1512,42,1470,116,0,3182900,-205300,3388200,27818592,2024.04.04
38,Bigger Houses,Dan + Shay,1171,100,1071,131,0,3120600,317000,2803600,1184309,2024.04.04
39,Sounds Like The Radio,Zach Top,1082,25,1057,109,0,2980400,-16800,2997200,458452,2024.04.04
40,American Girl,Dierks Bentley,902,85,817,95,0,2746800,196900,2549900,577625,2024.04.04
41,Find Another Bar,Chris Lane,928,-32,960,97,0,2088000,271300,1816700,193594,2024.04.04
42,Cowboy Songs,George Birge,772,-1,773,90,0,2071400,-5500,2076900,508246,2024.04.04
43,Boys Back Home,Dylan Marlowe Feat. Dylan Scott,768,39,729,89,0,1950800,174000,1776800,3068900,2024.04.04
44,In Your Love,Tyler Childers,893,-25,918,101,0,1671800,-57400,1729200,3257752,2024.04.04
45,Austin,Dasha,492,199,293,37,0,1601700,589700,1012000,10605691,2024.04.04
46,Brokenhearted,Joe Nichols,625,1,624,61,0,1501900,108400,1393500,9579,2024.04.04
47,Whatcha See Is Whatcha Get,Chris Janson,704,3,701,87,0,1475700,-177100,1652800,343198,2024.04.04
48,Damn Good Day To Leave,Riley Green,568,49,519,72,0,1446800,94100,1352700,1303379,2024.04.04
49,I'm In Love,Hailey Whitters,602,-34,636,77,0,1381400,-91200,1472600,208458,2024.04.04
50,Think I’m In Love With You,Chris Stapleton,556,7,549,63,0,1378800,-31900,1410700,3741124,2024.04.04
51,This Town's Been Too Good To Us,Dylan Scott,548,60,488,67,0,1375100,369900,1005200,3818453,2024.04.04
52,Breakin' In Boots,Matt Stell,708,54,654,89,0,1334800,32400,1302400,1123485,2024.04.04
53,I Tried A Ring On,Tigirlily Gold,713,74,639,94,0,1265700,347100,918600,382284,2024.04.04
54,Love You Back,Lady A,737,18,719,103,0,1205700,300,1205400,168294,2024.04.04
55,Tie Up,Zac Brown Band,443,-1175,1618,75,0,1129000,-6195700,7324700,1168260,2024.04.04
56,Jolene,Beyonce,341,341,0,58,0,981600,981600,0,22475805,2024.04.04
57,Life With You,Kelsey Hart,493,95,398,63,0,924200,266300,657900,1954739,2024.04.04
58,Last Rodeo,Restless Road,433,10,423,51,0,912600,32100,880500,512804,2024.04.04
59,Called Crazy,Kassi Ashton,192,-44,236,13,0,887000,-316200,1203200,90576,2024.04.04
60,Spin You Around (1/24),Morgan Wallen,210,-17,227,9,0,845200,-9600,854800,6913424,2024.04.04
61,Ain'T About You,Huntergirl,556,21,535,74,0,795800,66100,729700,18031,2024.04.04
62,Make Me Wanna Smoke,Runaway June,411,12,399,54,0,692400,87200,605200,23946,2024.04.04
63,King Of Country Music,Ryan Larkins,378,18,360,53,0,682300,51800,630500,12416,2024.04.04
64,Single Again,Josh Ross,392,40,352,57,0,630400,-34500,664900,2141312,2024.04.04
65,No Caller Id,Megan Moroney,176,-10,186,7,0,500000,-44200,544200,4116723,2024.04.04
66,The Devil I Know,Ashley McBryde,265,20,245,36,0,448600,9800,438800,349918,2024.04.04
67,This Heart,Corey Kent,273,15,258,35,0,432400,17000,415400,2218936,2024.04.04
68,Things I Take For Granted,Larry Fleet,282,14,268,40,0,410900,-23800,434700,1708751,2024.04.04
69,Cowgirls,Morgan Wallen,112,42,70,22,0,382100,85600,296500,6755332,2024.04.04
70,Pride,Sara Evans,105,98,7,57,0,381000,357700,23300,68827,2024.04.04
71,Neon Baby,Annie Bosko,257,-7,264,39,0,377000,61100,315900,16144,2024.04.04
72,Wine Into Whiskey,Tucker Wetmore,107,10,97,5,0,354200,-84700,438900,6436586,2024.04.04
73,Color Up My World,"Hailey Whitters, Ben Rector",71,-80,151,36,0,333400,-271000,604400,800474,2024.04.04
74,Rain In The Rearview,Anne Wilson,246,-32,278,37,0,305600,-103300,408900,973961,2024.04.04
75,Million Little Bandaids,Caroline Jones,239,-15,254,34,0,287000,8500,278500,16341,2024.04.04
76,Purple Irises,Gwen Stefani & Blake Shelton,190,-14,204,32,0,231300,14500,216800,239184,2024.04.04
77,Dance Like No One's Watching,Gabby Barrett,53,25,28,7,0,225900,97000,128900,0,2024.04.04
78,Outlaws And Mustangs,Cody Jinks,49,7,42,5,0,208000,26700,181300,254755,2024.04.04
79,Wondering Why,Red Clay Strays,68,14,54,7,0,199500,56900,142600,4546610,2024.04.04
80,Holy Smokes,Bailey Zimmerman,33,-1,34,2,0,195300,-24300,219600,4779506,2024.04.04
81,Wild Ones,Jessie Murph & Jelly Roll,55,11,44,2,0,186800,53300,133500,11224679,2024.04.04
82,The Architect,Kacey Musgraves,116,15,101,14,0,184500,-110700,295200,1827408,2024.04.04
83,Damn Good Time,Jordan Davis,20,2,18,1,0,174900,-32000,206900,152882,2024.04.04
84,Hey Driver,Zach Bryan Feat. The War and Treaty,55,13,42,4,0,158400,45400,113000,6322789,2024.04.04
85,Young Man,Greylan James,27,17,10,3,0,149500,93500,56000,52706,2024.04.04
86,Ships That Don’t Come In,"Joe Diffie, Luke Combs, Hixtape, Toby Keith",21,21,0,12,0,144900,144900,0,912861,2024.04.04
87,Sarah's Place,Zach Bryan,14,-2,16,1,0,120500,7700,112800,3270981,2024.04.04
88,Jack And Diet Coke,Redferrin,40,8,32,3,0,114900,34300,80600,2147543,2024.04.04
89,Devil You Know,Tyler Braden,33,2,31,3,0,104100,18500,85600,3155099,2024.04.04
90,Coal,Dylan Gossett,21,0,21,2,0,100000,-5200,105200,5462552,2024.04.04
91,No Present LIke The Time,Jay Allen,116,-4,120,23,0,100000,13700,86300,0,2024.04.04
92,Sway,Kacey Musgraves,48,48,0,48,0,93800,93800,0,792647,2024.04.04
93,Bayou Boy,Graham Barham,31,-5,36,1,0,80800,-50100,130900,25136,2024.04.04
94,Man Upstairs,Tim Dugger,16,0,16,1,0,79200,-11600,90800,0,2024.04.04
95,How Is She,Cole Swindell,12,-2,14,1,0,72600,-33000,105600,45366,2024.04.04
96,Cancel,Randy Houser,65,-92,157,14,0,72500,-111100,183600,31334,2024.04.04
97,Dive,Luke Combs,5,3,2,1,0,71900,56700,15200,1447707,2024.04.04
98,Two Of Us,Brett Kissel & Cooper Alan,15,15,0,14,0,69500,69500,0,25387,2024.04.04
99,Summertime Blues,Zach Bryan,21,9,12,1,0,63800,33400,30400,591665,2024.04.04
100,Paying For It,Levi Hummon,63,2,61,10,0,62100,9000,53100,76352,2024.04.04
101,Two Night Stands,Kylie Morgan,42,40,2,11,0,60600,53300,7300,186960,2024.04.04
102,Heart They Didn'T Break,Maddie & Tae,58,-2,60,6,0,58300,8500,49800,402074,2024.04.04
103,God Moments,Conner Smith,9,9,0,9,0,56800,56800,0,37221,2024.04.04
104,Broadway Girls,Lil Durk Feat. Morgan Wallen,13,-2,15,2,0,56500,-6000,62500,3768683,2024.04.04
105,How You Get To Heaven,Ty Herndon,4,0,4,1,0,52200,20500,31700,464,2024.04.04
106,Strangers,Kameron Marlowe & Ella Langley,20,4,16,4,0,51100,13800,37300,872324,2024.04.04
107,Good On You,Priscilla Block,27,27,0,7,0,50500,50500,0,364831,2024.04.04
108,The Star-Spangled Banner,Chris Stapleton,13,5,8,12,0,49600,16200,33400,101525,2024.04.04
109,Break Mine,Brothers Osborne,11,2,9,2,0,47600,9700,37900,750074,2024.04.04
110,Honky Tonk Attitude,HIXTAPE & Joe Diffie Feat. Luke Bryan & Randy Houser,7,7,0,1,0,47400,47400,0,289316,2024.04.04
111,My Bar,Priscilla Block,5,4,1,2,0,44800,33600,11200,129283,2024.04.04
112,Thinkin Bout Cheatin,Mae Estes,50,-3,53,17,0,41800,1500,40300,19789,2024.04.04
113,Hold On To Me,Nathan Merovich,39,-9,48,13,0,40500,6100,34400,0,2024.04.04
114,I Like Big Trucks,Alli Walker,16,-1,17,1,0,39400,-12100,51500,30008,2024.04.04
115,Country Back,Randy Houser,25,25,0,8,0,39100,39100,0,0,2024.04.04
116,Pray All The Way Home,Austin Snell,39,4,35,19,0,38300,12400,25900,1078699,2024.04.04
117,Me To Me,Morgan Wallen,14,14,0,14,0,38100,38100,0,932884,2024.04.04
118,Deeper Well,Kacey Musgraves,17,10,7,3,0,38100,34900,3200,3567851,2024.04.04
119,Country Gold,Anne Wilson,10,9,1,2,0,36200,32700,3500,354243,2024.04.04
120,Darlin',Jenna Paulette,13,9,4,1,0,35300,11200,24100,113930,2024.04.04
121,'98 Braves,Morgan Wallen,5,1,4,4,0,34900,12700,22200,2038738,2024.04.04
122,Oklahoma Sooner,Jake Banfield,11,1,10,1,0,34000,1000,33000,4471,2024.04.04
123,This Side Of The Dirt,Neon Union,54,-30,84,10,0,33200,-7000,40200,28927,2024.04.04
124,The Painter,Ryan Larkins,7,7,0,3,0,31400,31400,0,8399,2024.04.04
125,You In A Honky Tonk,Randall King,3,0,3,2,0,29800,8100,21700,328666,2024.04.04
126,Always You,Trey Lewis,34,17,17,17,0,29600,17300,12300,114997,2024.04.04
127,Lighten That Load,Waylon Hanel,34,0,34,17,0,29600,2500,27100,12758,2024.04.04
128,Goodbye You,Landon Parker,34,-15,49,17,0,29600,-11400,41000,1345,2024.04.04
129,Ghost In My Chevy,Carson Wallace,33,33,0,17,0,29500,29500,0,12428,2024.04.04
130,Quittin' Time,Zach Bryan,2,0,2,1,0,29200,10000,19200,1125272,2024.04.04
131,Country's Cool Again,Lainey Wilson,16,-2,18,1,0,28900,-10400,39300,861050,2024.04.04
132,Highway Towns,Sykamore,33,33,0,17,0,28800,28800,0,19714,2024.04.04
133,Long Live Cowgirls,Ian Munsick & Cody Johnson,23,0,23,4,0,28700,11100,17600,786140,2024.04.04
134,State You Left Me In,Jake Worthington,2,1,1,1,0,28100,27500,600,16926,2024.04.04
135,Certified,Laura Bryna,35,-2,37,6,0,27700,2900,24800,2056,2024.04.04
136,When My Baby's In Boots,Randall King,3,1,2,1,0,26800,7600,19200,0,2024.04.04
137,Am I The Only One,Aaron Lewis,5,1,4,1,0,24500,9500,15000,663428,2024.04.04
138,John Deere Green,"HIXTAPE Feat. HARDY, Morgan Wallen, Joe Diffie",4,3,1,3,0,24300,22100,2200,0,2024.04.04
139,Use Me,Zach Top,11,-2,13,1,0,23400,-6800,30200,213910,2024.04.04
140,Third Rock From The Sun,"HIXTAPE & Joe Diffie Feat. Brooks & Dunn, Blake Shelton & HARDY",3,3,0,3,0,23200,23200,0,0,2024.04.04
141,Whose Rearview,Jason Aldean,3,2,1,1,0,20200,14700,5500,569291,2024.04.04
142,25-8,Larry Fleet,8,1,7,1,0,20000,2000,18000,42436,2024.04.04
143,Learn About Love,Jacquie Roar,13,13,0,12,0,19700,19700,0,0,2024.04.04
144,Give Me A Sunrise,Braxton Keith,2,2,0,1,0,18700,18700,0,38893,2024.04.04
145,Roulette On The Heart,Conner Smith,9,8,1,3,0,17100,16500,600,636143,2024.04.04
146,Fiddle In The Band,Kane Brown,2,-1,3,2,0,15800,-12600,28400,2189709,2024.04.04
147,Sunrise Tells The Story,Midland,2,2,0,1,0,15500,15500,0,154582,2024.04.04
148,A Cowboy Who Would,Chancey Williams,17,0,17,17,0,14800,2500,12300,26646,2024.04.04
149,One Two Step,Gunnar Latham,17,0,17,17,0,14800,0,14800,850,2024.04.04
150,Loser,Mike Ryan,1,0,1,1,0,14600,14000,600,9892,2024.04.04
151,Open The Gate,Zach Bryan,1,0,1,1,0,14600,13700,900,1484065,2024.04.04
152,Up In Texas,Midland,1,0,1,1,0,14600,-500,15100,83615,2024.04.04
152,We Ain't The Only Ones,Randy Rogers & Wade Bowen,1,0,1,1,0,14600,-500,15100,0,2024.04.04
154,A Little Bit Closer,Braxton Keith,1,-1,2,1,0,14600,-1100,15700,77113,2024.04.04
155,That's Texas,Cody Johnson,1,-2,3,1,0,14600,-10900,25500,251215,2024.04.04
156,Address Change Notification,Southbound,2,2,0,2,0,14300,14300,0,5119,2024.04.04
157,Thunder,Jim & Melissa Brady,2,2,0,2,0,14200,14200,0,179,2024.04.04
158,Here Comes Jesus,Jeff & Sheri Easter,2,-1,3,2,0,14200,-8900,23100,32294,2024.04.04
159,I'Ve Seen Me Do It,Joe Peters,2,1,1,1,0,13100,12700,400,474,2024.04.04
160,Star Spangled Banner,Mickey Guyton,2,1,1,2,0,12400,9800,2600,0,2024.04.04
161,Heart Attack,Boy Named Banjo,4,-4,8,1,0,11800,-12700,24500,3097,2024.04.04
162,Bright Side Of Blue,Abby Anderson,1,1,0,1,0,11300,11300,0,63713,2024.04.04
163,Levii's Jeans,Beyonce,3,3,0,2,0,11100,11100,0,16198625,2024.04.04
164,He Pilots My Ship,Tribute Quartet,2,1,1,2,0,11100,4700,6400,697,2024.04.04
165,Wings Of A Dove,Jonathan Wilburn,2,0,2,2,0,11100,-1600,12700,0,2024.04.04
166,No Yesterday,Jeremy McComb,7,2,5,1,0,10200,300,9900,444,2024.04.04
167,Joe,Luke Combs,1,1,0,1,0,10200,10200,0,383497,2024.04.04
167,See Me Now,Luke Combs,1,1,0,1,0,10200,10200,0,423797,2024.04.04
169,Wine Country,Hannah Ellis,7,-5,12,2,0,10100,-200,10300,19537,2024.04.04
170,Braggin' On Jesus,Steeles,1,1,0,1,0,9900,9900,0,3397,2024.04.04
170,Do It For You,Jason Crabb,1,1,0,1,0,9900,9900,0,4695,2024.04.04
170,Anywhere Jesus Is,Scotty Inman,1,1,0,1,0,9900,9900,0,1007,2024.04.04
173,Means Something To Me,Tate Emmons,1,-1,2,1,0,9900,-5900,15800,1168,2024.04.04
174,Ain'T No Better Place,Niko Moon,3,-22,25,1,0,9900,-147700,157600,90733,2024.04.04
175,Heart Of A Small Town,Tim Dugger,2,-1,3,1,0,9800,-3800,13600,9678,2024.04.04
176,Fake Id,Sydney Mack,5,0,5,1,0,9100,1000,8100,827,2024.04.04
177,Loud and Heavy,Cody Jinks,4,-2,6,2,0,9100,-4100,13200,1543048,2024.04.04
178,Ii Most Wanted,Beyonce,3,3,0,2,0,8200,8200,0,25245373,2024.04.04
179,Space In My Heart,Enrique Iglesias & Miranda Lambert,9,-3,12,1,0,8100,-32300,40400,778521,2024.04.04
180,The Old Rugged Cross,Carrie Underwood,1,1,0,1,0,7500,7500,0,57597,2024.04.04
180,Gettin' Ready To Breathe,Wes Hampton,1,1,0,1,0,7500,7500,0,20864,2024.04.04
180,Red Letter Blueprint,Scotty McCreery,1,1,0,1,0,7500,7500,0,363789,2024.04.04
180,The Rising Of The Son,Mckamey Legacy,1,1,0,1,0,7500,7500,0,77,2024.04.04
180,Looks Like Jesus,Brian Free & Assurance,1,1,0,1,0,7500,7500,0,781,2024.04.04
180,By Your Grace,Cody Johnson,1,1,0,1,0,7500,7500,0,525425,2024.04.04
180,Three,Jackson Michelson,1,1,0,1,0,7500,7500,0,3089,2024.04.04
180,"Given, Buried, Risen",Legacy Five,1,1,0,1,0,7500,7500,0,1629,2024.04.04
188,The Building,Emily Ann Roberts,1,0,1,1,0,7500,1200,6300,36625,2024.04.04
189,Because He Lives,Carrie Underwood,1,0,1,1,0,7500,200,7300,99657,2024.04.04
190,Bury Me In This Bar,Dalton Dover,1,1,0,1,0,7400,7400,0,282741,2024.04.04
191,Raise The Roof,Christian Beck,4,-1,5,1,0,7400,-1200,8600,104,2024.04.04
192,Crazy One More Time (2022),Kip Moore,4,4,0,1,0,7200,7200,0,8065,2024.04.04
193,"Salt, Lime & Tequila",Ryan Griffin,1,0,1,1,0,7200,6900,300,67451,2024.04.04
194,Thicc As Thieves,Lauren Alaina,16,-4,20,1,0,7000,-16200,23200,277774,2024.04.04
195,Nothing But Love Songs,Randy Rogers Band,2,2,0,2,0,6800,6800,0,11932,2024.04.04
196,Where You'Ve Walked,Lauren Talley,1,1,0,1,0,6700,6700,0,939,2024.04.04
196,Celebration At The Empty Grave,Down East Boys,1,1,0,1,0,6700,6700,0,4424,2024.04.04
196,Front Porch Sittin',Zane & Donna King,1,1,0,1,0,6700,6700,0,0,2024.04.04
196,Sheaves (Dedicated To Isabel),Karen Peck & New River,1,1,0,1,0,6700,6700,0,4262,2024.04.04
196,Our God Is Good,Kenna Turner West,1,1,0,1,0,6700,6700,0,15,2024.04.04
196,Come On In,Guardians,1,1,0,1,0,6700,6700,0,0,2024.04.04
196,Your Healing Is On The Way,Greater Vision,1,1,0,1,0,6700,6700,0,940,2024.04.04
196,Just Beyond,Barry Abernathy,1,1,0,1,0,6700,6700,0,0,2024.04.04
196,Revival Broke Out,Gaither Vocal Band,1,1,0,1,0,6700,6700,0,1634,2024.04.04
196,Four Days Late (Acoustic),Karen Peck & New River,1,1,0,1,0,6700,6700,0,0,2024.04.04
196,Carry The Glorious Gospel,Mylon Hayes Family,1,1,0,1,0,6700,6700,0,4515,2024.04.04
196,Part Of The Family,Littles,1,1,0,1,0,6700,6700,0,0,2024.04.04
208,Heaven Is Happening,Guardians,1,0,1,1,0,6700,400,6300,0,2024.04.04
208,Pb&J,Todd Tilghman,1,0,1,1,0,6700,400,6300,284,2024.04.04
208,Meet Me At The Cross,Brian Free & Assurance,1,0,1,1,0,6700,400,6300,5426,2024.04.04
208,Dear Heavenly Father,11th Hour,1,0,1,1,0,6700,400,6300,3965,2024.04.04
208,Two Or Three,Collingsworth Family,1,0,1,1,0,6700,400,6300,9932,2024.04.04
208,Help Is On The Way,Gold City,1,0,1,1,0,6700,400,6300,23233,2024.04.04
214,My God,Scotty Inman,1,0,1,1,0,6700,-600,7300,52944,2024.04.04
1,Man Made A Bar,Morgan Wallen,8198,1021,7177,144,0,31067400,3769400,27298000,8761261,2024.04.11
2,Outskirts,Sam Hunt,7682,534,7148,143,0,28877600,1917200,26960400,2121784,2024.04.11
3,Burn It Down,Parker Mccollum,6502,-866,7368,144,0,23979700,-3534900,27514600,7146506,2024.04.11
4,World On Fire,Nate Smith,5100,-333,5433,144,0,22942900,-1323300,24266200,4283155,2024.04.11
5,Back Then Right Now,Tyler Hubbard,6266,383,5883,144,0,22566000,1137000,21429000,2510476,2024.04.11
6,Tucson Too Late,Jordan Davis,6033,434,5599,144,0,22427100,1308000,21119100,2676364,2024.04.11
7,Cab In A Solo,Scotty McCreery,5696,262,5434,144,0,21692900,1323100,20369800,1090554,2024.04.11
8,Pretty Little Poison,Warren Zeiders,5127,-72,5199,139,0,21517200,-301800,21819000,7242885,2024.04.11
9,Where It Ends,Bailey Zimmerman,5401,570,4831,144,0,19518600,2313400,17205200,7534028,2024.04.11
10,Wildflowers And Wild Horses,Lainey Wilson,5334,-91,5425,144,0,18349400,-145700,18495100,6320301,2024.04.11
11,Take Her Home,Kenny Chesney,4919,227,4692,144,0,18148500,453800,17694700,1630265,2024.04.11
12,Halfway To Hell,Jelly Roll,4276,387,3889,144,0,16211500,1699800,14511700,3496362,2024.04.11
13,Fearless,Jackson Dean,4111,-4,4115,143,0,14703000,157000,14546000,958884,2024.04.11
14,Your Place,Ashley Cooke,4140,12,4128,143,0,14436600,365800,14070800,1845515,2024.04.11
15,We Don'T Fight Anymore,Carly Pearce,3796,-2,3798,144,0,12791300,278400,12512900,2743585,2024.04.11
16,Let Your Boys Be Country,Jason Aldean,3395,233,3162,143,0,12712900,1371300,11341600,1835159,2024.04.11
17,We Ride,Bryan Martin,3174,441,2733,143,0,10956800,1357800,9599000,4221852,2024.04.11
18,Out Of That Truck,Carrie Underwood,2705,-63,2768,139,0,9202600,-8300,9210900,1095706,2024.04.11
19,Young Love & Saturday Nights,Chris Young,2667,325,2342,140,0,9033800,1156900,7876900,1633688,2024.04.11
20,I'M Not Pretty,Megan Moroney,2803,-11,2814,141,0,9031800,-186600,9218400,1905275,2024.04.11
21,Can't Break Up Now,Old Dominion,2722,-10,2732,144,0,8724000,279200,8444800,1280058,2024.04.11
22,Bulletproof,Nate Smith,2393,340,2053,140,0,8114200,1170500,6943700,4887706,2024.04.11
23,Love You Again,Chase Matthew,2457,134,2323,139,0,7818500,880600,6937900,2484805,2024.04.11
24,Dirt Cheap,Cody Johnson,1503,269,1234,116,0,6153900,1300600,4853300,4471580,2024.04.11
25,Chevrolet,Dustin Lynch Feat. Jelly Roll,1739,200,1539,137,0,4945800,626900,4318900,2439476,2024.04.11
26,Cowboys And Plowboys,Jon Pardi Feat. Luke Bryan,1742,78,1664,140,0,4846900,372200,4474700,575526,2024.04.11
27,"Love You, Miss You, Mean It",Luke Bryan,1124,1123,1,122,0,4754500,4751700,2800,3464021,2024.04.11
28,Rodeo Man,Garth Brooks & Ronnie Dunn,1866,68,1798,143,0,4474100,226300,4247800,1151211,2024.04.11
29,Dance With You,Brett Young,1547,106,1441,131,0,4339500,180800,4158700,1644082,2024.04.11
30,One Bad Habit,Tim McGraw,1694,135,1559,144,0,4296600,567500,3729100,464399,2024.04.11
31,Gonna Love You,Parmalee,1542,35,1507,132,0,4051500,105500,3946000,267255,2024.04.11
32,She's Somebody's Daughter,Drew Baldridge,1410,138,1272,119,0,3958700,691700,3267000,399518,2024.04.11
33,This Is My Dirt,Justin Moore,1509,166,1343,134,0,3934400,464300,3470100,449882,2024.04.11
34,Messed Up As Me,Keith Urban,1360,90,1270,126,0,3904800,-98100,4002900,1095155,2024.04.11
35,Drinkin' Problems,Dillon Carmichael,1640,-32,1672,141,0,3601100,-47300,3648400,38441,2024.04.11
36,Bigger Houses,Dan + Shay,1193,22,1171,132,0,3073700,-46900,3120600,1274829,2024.04.11
37,Texas Hold 'Em,Beyonce,1484,-28,1512,130,0,2989000,-193900,3182900,20105542,2024.04.11
38,Sounds Like The Radio,Zach Top,1156,74,1082,127,0,2982400,2000,2980400,756063,2024.04.11
39,Austin,Dasha,751,259,492,66,0,2685700,1084000,1601700,13233395,2024.04.11
40,American Girl,Dierks Bentley,902,0,902,103,0,2663600,-83200,2746800,635213,2024.04.11
41,Cowboy Songs,George Birge,856,84,772,90,0,2350300,278900,2071400,658906,2024.04.11
42,Find Another Bar,Chris Lane,978,50,928,97,0,2059600,-28400,2088000,131772,2024.04.11
43,Boys Back Home,Dylan Marlowe Feat. Dylan Scott,822,54,768,91,0,1937100,-13700,1950800,2984058,2024.04.11
44,This Town's Been Too Good To Us,Dylan Scott,659,111,548,73,0,1755700,380600,1375100,3266475,2024.04.11
45,In Your Love,Tyler Childers,939,46,893,107,0,1643700,-28100,1671800,2980721,2024.04.11
46,Whatcha See Is Whatcha Get,Chris Janson,795,91,704,91,0,1610800,135100,1475700,205077,2024.04.11
47,Breakin' In Boots,Matt Stell,812,104,708,93,0,1574200,239400,1334800,833047,2024.04.11
48,Love You Back,Lady A,758,21,737,102,0,1414700,209000,1205700,241163,2024.04.11
49,Damn Good Day To Leave,Riley Green,558,-10,568,73,0,1284100,-162700,1446800,1415237,2024.04.11
50,Think I’m In Love With You,Chris Stapleton,547,-9,556,62,0,1278900,-99900,1378800,5032514,2024.04.11
51,I'm In Love,Hailey Whitters,620,18,602,73,0,1254000,-127400,1381400,219171,2024.04.11
52,I Tried A Ring On,Tigirlily Gold,714,1,713,93,0,1209100,-56600,1265700,783964,2024.04.11
53,Tie Up,Zac Brown Band,508,65,443,75,0,1203400,74400,1129000,1150476,2024.04.11
54,Cowgirls,Morgan Wallen,249,137,112,40,0,1033600,651500,382100,8163101,2024.04.11
55,Life With You,Kelsey Hart,553,60,493,69,0,1016900,92700,924200,2366898,2024.04.11
56,Last Rodeo,Restless Road,418,-15,433,49,0,825300,-87300,912600,522322,2024.04.11
57,Single Again,Josh Ross,452,60,392,63,0,821800,191400,630400,1845918,2024.04.11
58,King Of Country Music,Ryan Larkins,393,15,378,52,0,799900,117600,682300,11466,2024.04.11
59,Called Crazy,Kassi Ashton,187,-5,192,12,0,728000,-159000,887000,90094,2024.04.11
60,Ain'T About You,Huntergirl,482,-74,556,71,0,727100,-68700,795800,18936,2024.04.11
61,Spin You Around (1/24),Morgan Wallen,174,-36,210,5,0,690900,-154300,845200,6647797,2024.04.11
62,Make Me Wanna Smoke,Runaway June,366,-45,411,46,0,639900,-52500,692400,23324,2024.04.11
63,No Caller Id,Megan Moroney,211,35,176,7,0,639600,139600,500000,4097300,2024.04.11
64,The Devil I Know,Ashley McBryde,298,33,265,36,0,499000,50400,448600,320399,2024.04.11
65,Things I Take For Granted,Larry Fleet,294,12,282,40,0,437300,26400,410900,1728132,2024.04.11
66,Wine Into Whiskey,Tucker Wetmore,122,15,107,6,0,421200,67000,354200,7086487,2024.04.11
67,This Heart,Corey Kent,294,21,273,40,0,419800,-12600,432400,2195423,2024.04.11
68,Neon Baby,Annie Bosko,265,8,257,39,0,381300,4300,377000,12035,2024.04.11
69,Color Up My World,"Hailey Whitters, Ben Rector",74,3,71,37,0,346000,12600,333400,787008,2024.04.11
70,Dance Like No One's Watching,Gabby Barrett,128,75,53,25,0,311200,85300,225900,0,2024.04.11
71,Million Little Bandaids,Caroline Jones,253,14,239,34,0,293800,6800,287000,16204,2024.04.11
72,Desperado Troubadours,Sawyer Brown,57,57,0,56,0,287200,287200,0,28528,2024.04.11
73,Good On You,Priscilla Block,106,79,27,27,0,240900,190400,50500,382221,2024.04.11
74,Holy Smokes,Bailey Zimmerman,34,1,33,2,0,215700,20400,195300,4588070,2024.04.11
75,Country Back,Randy Houser,180,155,25,34,0,215500,176400,39100,0,2024.04.11
76,Purple Irises,Gwen Stefani & Blake Shelton,167,-23,190,25,0,213600,-17700,231300,223723,2024.04.11
77,Rain In The Rearview,Anne Wilson,148,-98,246,32,0,212300,-93300,305600,1140577,2024.04.11
78,Damn Good Time,Jordan Davis,22,2,20,1,0,197700,22800,174900,180735,2024.04.11
79,Wondering Why,Red Clay Strays,75,7,68,5,0,193700,-5800,199500,4609821,2024.04.11
80,The Architect,Kacey Musgraves,120,4,116,15,0,193000,8500,184500,1699154,2024.04.11
81,Outlaws And Mustangs,Cody Jinks,47,-2,49,6,0,192300,-15700,208000,227220,2024.04.11
82,Young Man,Greylan James,37,10,27,3,0,189500,40000,149500,57372,2024.04.11
83,Wild Ones,Jessie Murph & Jelly Roll,47,-8,55,2,0,186500,-300,186800,10842727,2024.04.11
84,Take Me Home,Little Big Town,38,38,0,38,0,175200,175200,0,117623,2024.04.11
85,Girl In The Mirror,Megan Moroney,37,37,0,37,0,173000,173000,0,502508,2024.04.11
86,Hey Driver,Zach Bryan Feat. The War and Treaty,73,18,55,5,0,172000,13600,158400,6004666,2024.04.11
87,Jolene,Beyonce,37,-304,341,3,0,135600,-846000,981600,9351667,2024.04.11
88,Jack And Diet Coke,Redferrin,41,1,40,3,0,125500,10600,114900,2066467,2024.04.11
89,How Is She,Cole Swindell,18,6,12,1,0,121600,49000,72600,42931,2024.04.11
90,Two Night Stands,Kylie Morgan,86,44,42,12,0,93200,32600,60600,213634,2024.04.11
91,Coal,Dylan Gossett,19,-2,21,2,0,92600,-7400,100000,5454982,2024.04.11
92,True North,Lily Rose,48,48,0,48,0,91500,91500,0,119667,2024.04.11
93,Bright Side Of Blue,Abby Anderson,48,47,1,48,0,91500,80200,11300,56715,2024.04.11
94,Devil You Know,Tyler Braden,34,1,33,4,0,86500,-17600,104100,3519506,2024.04.11
95,Paying For It,Levi Hummon,70,7,63,14,0,82600,20500,62100,80946,2024.04.11
96,Man Upstairs,Tim Dugger,17,1,16,1,0,76200,-3000,79200,0,2024.04.11
97,Summertime Blues,Zach Bryan,23,2,21,1,0,65800,2000,63800,557064,2024.04.11
98,Break Mine,Brothers Osborne,20,9,11,3,0,63700,16100,47600,531904,2024.04.11
99,Highway Towns,Sykamore,67,34,33,17,0,59100,30300,28800,2482,2024.04.11
100,The Star-Spangled Banner,Chris Stapleton,11,-2,13,11,0,54800,5200,49600,83874,2024.04.11
101,'98 Braves,Morgan Wallen,16,11,5,14,0,54100,19200,34900,2139130,2024.04.11
102,Country Gold,Anne Wilson,15,5,10,2,0,53800,17600,36200,392472,2024.04.11
103,Deeper Well,Kacey Musgraves,23,6,17,3,0,52500,14400,38100,3645168,2024.04.11
104,Heart They Didn'T Break,Maddie & Tae,47,-11,58,5,0,51300,-7000,58300,303544,2024.04.11
105,Strangers,Kameron Marlowe & Ella Langley,16,-4,20,2,0,49600,-1500,51100,831995,2024.04.11
106,Lighten That Load,Waylon Hanel,51,17,34,17,0,44400,14800,29600,12241,2024.04.11
107,Thinkin Bout Cheatin,Mae Estes,51,1,50,17,0,44400,2600,41800,19634,2024.04.11
108,Goodbye You,Landon Parker,50,16,34,17,0,44300,14700,29600,1225,2024.04.11
109,Sarah's Place,Zach Bryan,5,-9,14,1,0,44000,-76500,120500,3223427,2024.04.11
110,How You Get To Heaven,Ty Herndon,4,0,4,1,0,43300,-8900,52200,435,2024.04.11
111,Broadway Girls,Lil Durk Feat. Morgan Wallen,10,-3,13,3,0,43000,-13500,56500,4105843,2024.04.11
112,This Side Of The Dirt,Neon Union,53,-1,54,8,0,41100,7900,33200,33399,2024.04.11
113,Oklahoma Sooner,Jake Banfield,14,3,11,1,0,40600,6600,34000,4529,2024.04.11
114,Bayou Boy,Graham Barham,21,-10,31,1,0,39600,-41200,80800,22492,2024.04.11
115,Darlin',Jenna Paulette,12,-1,13,1,0,38900,3600,35300,265969,2024.04.11
116,No Present LIke The Time,Jay Allen,45,-71,116,23,0,32900,-67100,100000,0,2024.04.11
117,Long Live Cowgirls,Ian Munsick & Cody Johnson,25,2,23,5,0,32700,4000,28700,770713,2024.04.11
118,Country's Cool Again,Lainey Wilson,18,2,16,2,0,32500,3600,28900,1002832,2024.04.11
119,Certified,Laura Bryna,37,2,35,6,0,30000,2300,27700,1964,2024.04.11
120,Ghost In My Chevy,Carson Wallace,34,1,33,17,0,29600,100,29500,12283,2024.04.11
121,Star Spangled Banner,Mickey Guyton,3,1,2,3,0,28300,15900,12400,0,2024.04.11
122,When My Baby's In Boots,Randall King,2,-1,3,1,0,28100,1300,26800,0,2024.04.11
123,Sparks Fly,Taylor Swift,7,2,5,1,0,26500,10000,16500,288419,2024.04.11
124,That's Texas,Cody Johnson,3,2,1,1,0,25700,11100,14600,290529,2024.04.11
125,The Chop,Scoot Teasley,4,3,1,1,0,25000,19600,5400,1542,2024.04.11
126,Am I The Only One,Aaron Lewis,6,1,5,1,0,24900,400,24500,661659,2024.04.11
127,My Bar,Priscilla Block,5,0,5,2,0,22800,-22000,44800,141955,2024.04.11
128,I Like Big Trucks,Alli Walker,16,0,16,1,0,22400,-17000,39400,41719,2024.04.11
129,Whose Rearview,Jason Aldean,4,1,3,2,0,20900,700,20200,533958,2024.04.11
130,You In A Honky Tonk,Randall King,4,1,3,3,0,20500,-9300,29800,332611,2024.04.11
131,Single At The Same Time,Jake Worthington,2,1,1,2,0,20100,19200,900,9709,2024.04.11
132,Friends Like That,John Morgan,6,6,0,3,0,19800,19800,0,1425269,2024.04.11
133,Honky Tonk Attitude,HIXTAPE & Joe Diffie Feat. Luke Bryan & Randy Houser,6,-1,7,2,0,19800,-27600,47400,126310,2024.04.11
134,Devil I'Ve Been,Chayce Beckham,5,5,0,5,0,19700,19700,0,399200,2024.04.11
135,Whiskey's Gonna Find Me,Jackson,3,3,0,1,0,19400,19400,0,0,2024.04.11
136,Learn About Love,Jacquie Roar,14,1,13,13,0,19000,-700,19700,19982,2024.04.11
137,Roots,Austin Burke,6,6,0,1,0,18300,18300,0,92955,2024.04.11
138,Roulette On The Heart,Conner Smith,7,-2,9,3,0,17600,500,17100,715250,2024.04.11
139,Heart Of A Small Town,Tim Dugger,3,1,2,1,0,17300,7500,9800,12273,2024.04.11
140,Third Rock From The Sun,"HIXTAPE & Joe Diffie Feat. Brooks & Dunn, Blake Shelton & HARDY",1,-2,3,1,0,16900,-6300,23200,0,2024.04.11
141,25-8,Larry Fleet,3,-5,8,1,0,16800,-3200,20000,42119,2024.04.11
142,Any Given Friday Night,Luke Combs,2,2,0,1,0,16000,16000,0,218243,2024.04.11
143,Dancin' In The Moonlight,Chris Lane Feat. Lauren Alaina,2,2,0,2,0,15800,15800,0,153519,2024.04.11
144,Use Me,Zach Top,8,-3,11,1,0,15600,-7800,23400,336285,2024.04.11
145,A Little Bit Closer,Braxton Keith,2,1,1,1,0,15500,900,14600,80588,2024.04.11
146,Buckles And Broken Hearts,Joe Peters,2,1,1,1,0,15300,10000,5300,1098,2024.04.11
147,A Cowboy Who Would,Chancey Williams,17,0,17,17,0,14800,0,14800,26094,2024.04.11
147,One Two Step,Gunnar Latham,17,0,17,17,0,14800,0,14800,736,2024.04.11
149,Dancin' With The Devil,Josh Ward,1,1,0,1,0,14600,14600,0,12014,2024.04.11
150,We Ain't The Only Ones,Randy Rogers & Wade Bowen,1,0,1,1,0,14600,0,14600,0,2024.04.11
150,Open The Gate,Zach Bryan,1,0,1,1,0,14600,0,14600,1335376,2024.04.11
152,Give Me A Sunrise,Braxton Keith,1,-1,2,1,0,14600,-4100,18700,38443,2024.04.11
153,Quittin' Time,Zach Bryan,1,-1,2,1,0,14600,-14600,29200,1023871,2024.04.11
154,Cancel,Randy Houser,16,-49,65,6,0,13900,-58600,72500,30718,2024.04.11
155,Ships That Don’t Come In,"Joe Diffie, Luke Combs, Hixtape, Toby Keith",5,-16,21,1,0,13800,-131100,144900,573868,2024.04.11
156,Up In Texas,Midland,1,0,1,1,0,13500,-1100,14600,99441,2024.04.11
157,Narcissist,Avery Anna,2,2,0,1,0,13100,13100,0,451721,2024.04.11
158,Wings Of A Dove,Jonathan Wilburn,2,0,2,2,0,11900,800,11100,0,2024.04.11
159,28th Of June,Megan Moroney,1,1,0,1,0,11300,11300,0,1145246,2024.04.11
160,Forward,Niia,1,1,0,1,0,10600,10600,0,178,2024.04.11
161,Fox In The Henhouse,Luke Combs,1,1,0,1,0,10200,10200,0,134981,2024.04.11
161,Blinding Lights,Tebey,1,1,0,1,0,10200,10200,0,396935,2024.04.11
161,Dying Man,Morgan Wallen,1,1,0,1,0,10200,10200,0,1423730,2024.04.11
164,Bury Me In This Bar,Dalton Dover,1,0,1,1,0,10200,2800,7400,82481,2024.04.11
165,God's Been Good,LeFevre Quartet,1,0,1,1,0,9900,5500,4400,1183,2024.04.11
166,No Yesterday,Jeremy McComb,6,-1,7,1,0,9800,-400,10200,552,2024.04.11
167,I Wrote The Book,Morgan Wallen,2,1,1,2,0,9400,5000,4400,3793266,2024.04.11
168,Pray All The Way Home,Austin Snell,5,-34,39,3,0,9400,-28900,38300,1244274,2024.04.11
169,Country House,Sam Hunt,2,2,0,1,0,9300,9300,0,1347485,2024.04.11
170,Heart Attack,Boy Named Banjo,4,0,4,1,0,9000,-2800,11800,3487,2024.04.11
171,Holy Roller,Zach Bryan,5,0,5,1,0,8900,3900,5000,1075437,2024.04.11
172,You'll Always Be My Baby (Written For Daughters' Weddings),Alan Jackson,3,-1,4,1,0,8700,3500,5200,45776,2024.04.11
173,My Place,Carly Pearce,2,2,0,2,0,8600,8600,0,583000,2024.04.11
174,Space In My Heart,Enrique Iglesias & Miranda Lambert,10,1,9,1,0,8600,500,8100,657045,2024.04.11
175,Record High,Randall King,2,2,0,2,0,8400,8400,0,22839,2024.04.11
176,Push Our Luck,Darci Lynne,5,1,4,1,0,8200,4800,3400,17182,2024.04.11
177,Wine Country,Hannah Ellis,6,-1,7,2,0,7600,-2500,10100,16780,2024.04.11
178,Scars In Heaven,Casting Crowns,1,1,0,1,0,7500,7500,0,559795,2024.04.11
178,I Surrender All,Carrie Underwood,1,1,0,1,0,7500,7500,0,36446,2024.04.11
180,Ain't Much Changed,Joe Wodarek,7,1,6,1,0,7500,2900,4600,0,2024.04.11
181,Two Or Three,Collingsworth Family,1,0,1,1,0,7500,800,6700,9105,2024.04.11
182,Fake Id,Sydney Mack,4,-1,5,1,0,7400,-1700,9100,786,2024.04.11
183,Thicc As Thieves,Lauren Alaina,11,-5,16,1,0,7300,300,7000,263006,2024.04.11
184,Sun To Me,Zach Bryan,3,1,2,1,0,7100,2600,4500,5903124,2024.04.11
185,Double Down,Cody Johnson,1,1,0,1,0,6800,6800,0,185987,2024.04.11
186,There Is A Name,LeFevre Quartet,1,1,0,1,0,6700,6700,0,825,2024.04.11
186,Heading In A New Direction,Elaine Roy,1,1,0,1,0,6700,6700,0,0,2024.04.11
186,It Won't Be Long,Poet Voices,1,1,0,1,0,6700,6700,0,0,2024.04.11
186,"Ever Present, Ever Faithful",Jim & Melissa Brady,1,1,0,1,0,6700,6700,0,3570,2024.04.11
186,Back To The Garden,Erwins,1,1,0,1,0,6700,6700,0,0,2024.04.11
186,Not One Word,Collingsworth Family,1,1,0,1,0,6700,6700,0,5,2024.04.11
186,There's A Song For That,Down East Boys,1,1,0,1,0,6700,6700,0,2510,2024.04.11
186,Way Up On The Mountain,Becky Isaacs Bowman,1,1,0,1,0,6700,6700,0,836,2024.04.11
186,When They Call My Name,Mark Trammell Quartet,1,1,0,1,0,6700,6700,0,5318,2024.04.11
186,Fall Into Place,Jeff & Sheri Easter,1,1,0,1,0,6700,6700,0,774,2024.04.11
186,"I, John",Blackwood Brothers Quartet,1,1,0,1,0,6700,6700,0,15,2024.04.11
186,Breaking Boundaries,Sunday Drive,1,1,0,1,0,6700,6700,0,463,2024.04.11
186,The Day I Get Home,Kelly Garner,1,1,0,1,0,6700,6700,0,240,2024.04.11
186,Praying For The Prodigal,Kingsmen,1,1,0,1,0,6700,6700,0,1022,2024.04.11
186,God Is Listening,Triumphant Quartet,1,1,0,1,0,6700,6700,0,0,2024.04.11
186,Middle Of Nowhere,Southbound,1,1,0,1,0,6700,6700,0,6730,2024.04.11
186,Forgiven,Joseph Habedank,1,1,0,1,0,6700,6700,0,0,2024.04.11
203,Made A Mess,Tim Menzies,1,0,1,1,0,6700,6300,400,110,2024.04.11
204,Dive Bar,"Willie Jones, Ben Burgess",7,0,7,1,0,6700,600,6100,21954,2024.04.11
205,Revival Broke Out,Gaither Vocal Band,1,0,1,1,0,6700,0,6700,1622,2024.04.11
205,Part Of The Family,Littles,1,0,1,1,0,6700,0,6700,0,2024.04.11
205,Your Healing Is On The Way,Greater Vision,1,0,1,1,0,6700,0,6700,918,2024.04.11
205,Pb&J,Todd Tilghman,1,0,1,1,0,6700,0,6700,280,2024.04.11
205,Help Is On The Way,Gold City,1,0,1,1,0,6700,0,6700,23633,2024.04.11
205,Dear Heavenly Father,11th Hour,1,0,1,1,0,6700,0,6700,4388,2024.04.11
211,Means Something To Me,Tate Emmons,1,0,1,1,0,6700,-3200,9900,944,2024.04.11
1,Outskirts,Sam Hunt,8487,805,7682,144,0,33177600,4300000,28877600,1787062,2024.04.18
2,Man Made A Bar,Morgan Wallen,6194,-2004,8198,144,0,25987700,-5079700,31067400,8108818,2024.04.18
3,Back Then Right Now,Tyler Hubbard,6804,538,6266,144,0,24576200,2010200,22566000,3774844,2024.04.18
4,Tucson Too Late,Jordan Davis,6574,541,6033,144,0,24251900,1824800,22427100,2359164,2024.04.18
5,Cab In A Solo,Scotty McCreery,5934,238,5696,144,0,22043400,350500,21692900,1098811,2024.04.18
6,Pretty Little Poison,Warren Zeiders,5220,93,5127,142,0,21659600,142400,21517200,7546828,2024.04.18
7,World On Fire,Nate Smith,5053,-47,5100,144,0,21575700,-1367200,22942900,4423379,2024.04.18
8,Where It Ends,Bailey Zimmerman,5800,399,5401,144,0,21039000,1520400,19518600,7355855,2024.04.18
9,Take Her Home,Kenny Chesney,4985,66,4919,144,0,19345500,1197000,18148500,1956362,2024.04.18
10,Wildflowers And Wild Horses,Lainey Wilson,5522,188,5334,144,0,18740000,390600,18349400,6093404,2024.04.18
11,Halfway To Hell,Jelly Roll,4878,602,4276,144,0,18401800,2190300,16211500,3450472,2024.04.18
12,Your Place,Ashley Cooke,4679,539,4140,144,0,15732900,1296300,14436600,2055358,2024.04.18
13,Fearless,Jackson Dean,4294,183,4111,143,0,15307900,604900,14703000,1001711,2024.04.18
14,Let Your Boys Be Country,Jason Aldean,3699,304,3395,144,0,13591900,879000,12712900,1932448,2024.04.18
15,We Don'T Fight Anymore,Carly Pearce,3908,112,3796,144,0,12949100,157800,12791300,2909434,2024.04.18
16,We Ride,Bryan Martin,3520,346,3174,143,0,11874300,917500,10956800,4361334,2024.04.18
17,Young Love & Saturday Nights,Chris Young,2816,149,2667,141,0,9945000,911200,9033800,1893490,2024.04.18
18,Bulletproof,Nate Smith,2818,425,2393,141,0,9543600,1429400,8114200,6860031,2024.04.18
19,Out Of That Truck,Carrie Underwood,2707,2,2705,139,0,9131000,-71600,9202600,1025767,2024.04.18
20,I'M Not Pretty,Megan Moroney,2808,5,2803,141,0,8943300,-88500,9031800,1971695,2024.04.18
21,Can't Break Up Now,Old Dominion,2856,134,2722,144,0,8677300,-46700,8724000,1232940,2024.04.18
22,Love You Again,Chase Matthew,2791,334,2457,141,0,8667700,849200,7818500,2324912,2024.04.18
23,Dirt Cheap,Cody Johnson,1869,366,1503,137,0,7136200,982300,6153900,5152337,2024.04.18
24,Chevrolet,Dustin Lynch Feat. Jelly Roll,1896,157,1739,137,0,5600500,654700,4945800,2341139,2024.04.18
25,One Bad Habit,Tim McGraw,1788,94,1694,143,0,4862900,566300,4296600,452026,2024.04.18
26,She's Somebody's Daughter,Drew Baldridge,1593,183,1410,129,0,4679200,720500,3958700,435886,2024.04.18
27,Rodeo Man,Garth Brooks & Ronnie Dunn,1834,-32,1866,143,0,4676800,202700,4474100,1049069,2024.04.18
28,Cowboys And Plowboys,Jon Pardi Feat. Luke Bryan,1740,-2,1742,140,0,4610800,-236100,4846900,638187,2024.04.18
29,Dance With You,Brett Young,1602,55,1547,132,0,4509400,169900,4339500,1589206,2024.04.18
30,Gonna Love You,Parmalee,1643,101,1542,135,0,4169000,117500,4051500,278908,2024.04.18
31,Drinkin' Problems,Dillon Carmichael,1670,30,1640,143,0,3942200,341100,3601100,40157,2024.04.18
32,This Is My Dirt,Justin Moore,1505,-4,1509,136,0,3940800,6400,3934400,513443,2024.04.18
33,Messed Up As Me,Keith Urban,1446,86,1360,133,0,3932700,27900,3904800,1117512,2024.04.18
34,Forever To Me,Cole Swindell,991,987,4,91,0,3581700,3575200,6500,2061646,2024.04.18
35,Bigger Houses,Dan + Shay,1317,124,1193,134,0,3295000,221300,3073700,1366000,2024.04.18
36,Austin,Dasha,881,130,751,70,0,3132300,446600,2685700,12945710,2024.04.18
37,Sounds Like The Radio,Zach Top,1242,86,1156,117,0,3041500,59100,2982400,703823,2024.04.18
38,Texas Hold 'Em,Beyonce,1383,-101,1484,130,0,2898800,-90200,2989000,16259379,2024.04.18
39,Tie Up,Zac Brown Band,758,250,508,78,0,2716600,1513200,1203400,940818,2024.04.18
40,Cowboy Songs,George Birge,940,84,856,108,0,2688400,338100,2350300,586084,2024.04.18
41,American Girl,Dierks Bentley,912,10,902,106,0,2679800,16200,2663600,604869,2024.04.18
42,"Love You, Miss You, Mean It",Luke Bryan,817,-307,1124,99,0,2623000,-2131500,4754500,3177198,2024.04.18
43,Cowgirls,Morgan Wallen,621,372,249,71,0,2534200,1500600,1033600,8694036,2024.04.18
44,Find Another Bar,Chris Lane,1012,34,978,106,0,2078400,18800,2059600,119903,2024.04.18
45,Boys Back Home,Dylan Marlowe Feat. Dylan Scott,817,-5,822,92,0,1909800,-27300,1937100,2902708,2024.04.18
46,This Town's Been Too Good To Us,Dylan Scott,714,55,659,76,0,1888500,132800,1755700,2549726,2024.04.18
47,In Your Love,Tyler Childers,973,34,939,108,0,1692000,48300,1643700,3066478,2024.04.18
48,Breakin' In Boots,Matt Stell,829,17,812,95,0,1672000,97800,1574200,994832,2024.04.18
49,Love You Back,Lady A,776,18,758,100,0,1578000,163300,1414700,190435,2024.04.18
50,Whatcha See Is Whatcha Get,Chris Janson,730,-65,795,90,0,1509800,-101000,1610800,163670,2024.04.18
51,Damn Good Day To Leave,Riley Green,616,58,558,82,0,1450500,166400,1284100,1620841,2024.04.18
52,Think I’m In Love With You,Chris Stapleton,570,23,547,63,0,1371600,92700,1278900,6357810,2024.04.18
53,I'm In Love,Hailey Whitters,629,9,620,76,0,1290300,36300,1254000,222923,2024.04.18
54,I Tried A Ring On,Tigirlily Gold,739,25,714,92,0,1225500,16400,1209100,675736,2024.04.18
55,Life With You,Kelsey Hart,564,11,553,66,0,1111600,94700,1016900,2333862,2024.04.18
56,Called Crazy,Kassi Ashton,251,64,187,58,0,843900,115900,728000,115351,2024.04.18
57,Last Rodeo,Restless Road,411,-7,418,49,0,814500,-10800,825300,507643,2024.04.18
58,King Of Country Music,Ryan Larkins,365,-28,393,55,0,781100,-18800,799900,12591,2024.04.18
59,Single Again,Josh Ross,414,-38,452,59,0,753900,-67900,821800,1808760,2024.04.18
60,Make Me Wanna Smoke,Runaway June,349,-17,366,44,0,608000,-31900,639900,15267,2024.04.18
61,Ain'T About You,Huntergirl,352,-130,482,51,0,565100,-162000,727100,17791,2024.04.18
62,Spin You Around (1/24),Morgan Wallen,142,-32,174,6,0,553000,-137900,690900,6822335,2024.04.18
63,Wine Into Whiskey,Tucker Wetmore,152,30,122,15,0,548400,127200,421200,7280518,2024.04.18
64,Things I Take For Granted,Larry Fleet,311,17,294,44,0,485000,47700,437300,2292659,2024.04.18
65,The Devil I Know,Ashley McBryde,288,-10,298,37,0,482200,-16800,499000,355794,2024.04.18
66,Country Back,Randy Houser,297,117,180,46,0,471000,255500,215500,347,2024.04.18
67,Dance Like No One's Watching,Gabby Barrett,216,88,128,28,0,403700,92500,311200,0,2024.04.18
68,This Heart,Corey Kent,280,-14,294,40,0,387200,-32600,419800,2130639,2024.04.18
69,Neon Baby,Annie Bosko,266,1,265,39,0,384200,2900,381300,12596,2024.04.18
70,Color Up My World,"Hailey Whitters, Ben Rector",76,2,74,38,0,365200,19200,346000,439915,2024.04.18
71,Good On You,Priscilla Block,201,95,106,33,0,311600,70700,240900,436500,2024.04.18
72,No Caller Id,Megan Moroney,132,-79,211,7,0,302600,-337000,639600,4429042,2024.04.18
73,Million Little Bandaids,Caroline Jones,229,-24,253,35,0,270400,-23400,293800,16251,2024.04.18
74,Ghost,Josiah And The Bonnevilles,48,48,0,47,0,235700,235700,0,509230,2024.04.18
75,Friends Like That,John Morgan,81,75,6,11,0,209000,189200,19800,1719486,2024.04.18
76,Young Man,Greylan James,36,-1,37,4,0,191700,2200,189500,62992,2024.04.18
77,Sunshine Shine,Blanco Brown,46,46,0,45,0,190600,190600,0,79931,2024.04.18
78,Wild Ones,Jessie Murph & Jelly Roll,51,4,47,2,0,183400,-3100,186500,10434901,2024.04.18
79,Hey There Hometown,Abby Leigh Anderson,38,38,0,38,0,182600,182600,0,664,2024.04.18
80,Damn Good Time,Jordan Davis,20,-2,22,1,0,175600,-22100,197700,211392,2024.04.18
81,Outlaws And Mustangs,Cody Jinks,41,-6,47,5,0,169800,-22500,192300,210954,2024.04.18
82,Hey Driver,Zach Bryan Feat. The War and Treaty,69,-4,73,4,0,153000,-19000,172000,6433652,2024.04.18
83,Break Mine,Brothers Osborne,46,26,20,7,0,152500,88800,63700,506159,2024.04.18
84,The Architect,Kacey Musgraves,97,-23,120,15,0,143000,-50000,193000,1156401,2024.04.18
85,Holy Smokes,Bailey Zimmerman,24,-10,34,1,0,141400,-74300,215700,4609836,2024.04.18
86,Devil You Know,Tyler Braden,49,15,34,5,0,126700,40200,86500,4558217,2024.04.18
87,Purple Irises,Gwen Stefani & Blake Shelton,92,-75,167,22,0,125700,-87900,213600,234766,2024.04.18
88,Wondering Why,Red Clay Strays,52,-23,75,5,0,121300,-72400,193700,5102627,2024.04.18
89,Jack And Diet Coke,Redferrin,40,-1,41,3,0,120300,-5200,125500,2086317,2024.04.18
90,Coal,Dylan Gossett,18,-1,19,2,0,104500,11900,92600,5572585,2024.04.18
91,How Is She,Cole Swindell,16,-2,18,1,0,104400,-17200,121600,48623,2024.04.18
92,Two Night Stands,Kylie Morgan,92,6,86,15,0,98600,5400,93200,169739,2024.04.18
93,Late Bloomer,Carter Faith,48,48,0,48,0,93800,93800,0,102597,2024.04.18
94,Man Upstairs,Tim Dugger,17,0,17,1,0,89000,12800,76200,0,2024.04.18
95,Dive,Luke Combs,6,6,0,1,0,85400,85400,0,1401709,2024.04.18
96,Rain In The Rearview,Anne Wilson,93,-55,148,16,0,82000,-130300,212300,1148032,2024.04.18
97,Jolene,Beyonce,31,-6,37,1,0,76800,-58800,135600,6156685,2024.04.18
98,Deeper Well,Kacey Musgraves,26,3,23,2,0,74300,21800,52500,2910927,2024.04.18
99,Jesus Saves,Riley Green,12,12,0,1,0,70400,70400,0,1881985,2024.04.18
100,Roots,Austin Burke,21,15,6,1,0,69600,51300,18300,89194,2024.04.18
101,Strangers,Kameron Marlowe & Ella Langley,17,1,16,3,0,61000,11400,49600,808361,2024.04.18
102,Paying For It,Levi Hummon,67,-3,70,10,0,60500,-22100,82600,83400,2024.04.18
103,Start Nowhere,Sam Hunt,9,9,0,9,0,56800,56800,0,180458,2024.04.18
104,Heart They Didn'T Break,Maddie & Tae,51,4,47,5,0,55800,4500,51300,299253,2024.04.18
105,Death Row,Thomas Rhett Feat. Tyler Hubbard & Russell Dickerson,9,9,0,9,0,54600,54600,0,48377,2024.04.18
105,Locked Up,Sam Hunt,9,9,0,9,0,54600,54600,0,1452280,2024.04.18
107,No Present LIke The Time,Jay Allen,64,19,45,23,0,54300,21400,32900,0,2024.04.18
108,Summertime Blues,Zach Bryan,19,-4,23,1,0,52400,-13400,65800,578933,2024.04.18
109,Broadway Girls,Lil Durk Feat. Morgan Wallen,14,4,10,2,0,51900,8900,43000,4270003,2024.04.18
110,The Star-Spangled Banner,Chris Stapleton,15,4,11,14,0,51000,-3800,54800,86140,2024.04.18
111,Ain't That Some,Morgan Wallen,15,15,0,14,0,44400,44400,0,4390271,2024.04.18
112,Thinkin Bout Cheatin,Mae Estes,51,0,51,17,0,44400,0,44400,19347,2024.04.18
113,Highway Towns,Sykamore,51,-16,67,17,0,44400,-14700,59100,1556,2024.04.18
114,Whiskey's Gonna Find Me,Jackson,8,5,3,1,0,40300,20900,19400,0,2024.04.18
115,That's Texas,Cody Johnson,4,1,3,2,0,39700,14000,25700,303512,2024.04.18
116,Country's Cool Again,Lainey Wilson,17,-1,18,3,0,37200,4700,32500,917895,2024.04.18
117,Country Gold,Anne Wilson,10,-5,15,2,0,36300,-17500,53800,344679,2024.04.18
118,Darlin',Jenna Paulette,14,2,12,1,0,35800,-3100,38900,270621,2024.04.18
119,Pray All The Way Home,Austin Snell,27,22,5,20,0,35500,26100,9400,1226047,2024.04.18
120,Oklahoma Sooner,Jake Banfield,13,-1,14,1,0,35400,-5200,40600,6220,2024.04.18
121,Bayou Boy,Graham Barham,18,-3,21,1,0,35400,-4200,39600,17653,2024.04.18
122,Sparks Fly,Taylor Swift,8,1,7,1,0,31300,4800,26500,306422,2024.04.18
123,Roulette On The Heart,Conner Smith,17,10,7,9,0,30200,12600,17600,633803,2024.04.18
124,This Side Of The Dirt,Neon Union,50,-3,53,8,0,29900,-11200,41100,36712,2024.04.18
125,Ghost In My Chevy,Carson Wallace,34,0,34,17,0,29600,0,29600,13744,2024.04.18
126,Goodbye You,Landon Parker,34,-16,50,17,0,29600,-14700,44300,1537,2024.04.18
127,Lighten That Load,Waylon Hanel,34,-17,51,17,0,29600,-14800,44400,13424,2024.04.18
128,Country House,Sam Hunt,11,9,2,1,0,23400,14100,9300,1187191,2024.04.18
129,Certified,Laura Bryna,30,-7,37,6,0,23400,-6600,30000,1949,2024.04.18
130,Summer Talkin',Tyler Hubbard,4,4,0,4,0,20800,20800,0,295584,2024.04.18
131,Ships That Don’t Come In,"Joe Diffie, Luke Combs, Hixtape, Toby Keith",4,-1,5,4,0,20600,6800,13800,465246,2024.04.18
132,Am I The Only One,Aaron Lewis,6,0,6,1,0,20400,-4500,24900,695751,2024.04.18
133,Hometown Home,Locash,8,8,0,1,0,19000,19000,0,807,2024.04.18
134,Baby Do,Randall King,2,0,2,1,0,18700,16900,1800,18179,2024.04.18
135,Open The Gate,Zach Bryan,3,2,1,1,0,18500,3900,14600,1384012,2024.04.18
136,I Like Big Trucks,Alli Walker,13,-3,16,1,0,18200,-4200,22400,30537,2024.04.18
137,A Little Bit Closer,Braxton Keith,2,0,2,1,0,17600,2100,15500,82435,2024.04.18
138,Strong,Tyler Hubbard,4,4,0,4,0,16700,16700,0,239894,2024.04.18
139,You'll Always Be My Baby (Written For Daughters' Weddings),Alan Jackson,5,2,3,1,0,16700,8000,8700,49579,2024.04.18
140,John Deere Green,"HIXTAPE Feat. HARDY, Morgan Wallen, Joe Diffie",3,3,0,3,0,16600,16600,0,0,2024.04.18
141,Russell County Line,49 Winchester,11,4,7,2,0,16100,9500,6600,404663,2024.04.18
142,Any Given Friday Night,Luke Combs,2,0,2,1,0,16000,0,16000,243826,2024.04.18
143,Would If I Could (Feat. Lainey Wilson),Ernest,4,4,0,2,0,15900,15900,0,2204265,2024.04.18
144,Up In Texas,Midland,2,1,1,1,0,15500,2000,13500,208495,2024.04.18
145,When My Baby's In Boots,Randall King,2,0,2,1,0,15500,-12600,28100,0,2024.04.18
146,Everything I Need,Chayce Beckham,3,3,0,2,0,14900,14900,0,79565,2024.04.18
147,A Cowboy Who Would,Chancey Williams,17,0,17,17,0,14800,0,14800,26709,2024.04.18
147,One Two Step,Gunnar Latham,17,0,17,17,0,14800,0,14800,762,2024.04.18
149,I Ain'T Crazy,Erin Kinsey,7,7,0,2,0,14600,14600,0,907762,2024.04.18
150,Wild Horses,Kin Faux,1,0,1,1,0,14600,12100,2500,3421,2024.04.18
151,Give Me A Sunrise,Braxton Keith,1,0,1,1,0,14600,0,14600,39569,2024.04.18
152,Work Boots,Cody Johnson,2,1,1,1,0,14400,13500,900,354852,2024.04.18
153,He Bought Me,Old Paths,2,1,1,2,0,14300,9900,4400,215,2024.04.18
154,Your Healing Is On The Way,Greater Vision,2,1,1,2,0,14200,7500,6700,842,2024.04.18
155,Thicc As Thieves,Lauren Alaina,11,0,11,3,0,13800,6500,7300,262708,2024.04.18
156,Whose Rearview,Jason Aldean,2,-2,4,1,0,13600,-7300,20900,531921,2024.04.18
157,Sunrise Tells The Story,Midland,1,0,1,1,0,13500,12600,900,167002,2024.04.18
158,Double Down,Cody Johnson,2,1,1,1,0,13400,6600,6800,200754,2024.04.18
159,Mansions,Sound Street,2,1,1,2,0,11900,7500,4400,496,2024.04.18
159,Come On In,Kingdom Heirs,2,1,1,2,0,11900,7500,4400,1961,2024.04.18
161,Wine Country,Hannah Ellis,7,1,6,2,0,11900,4300,7600,18640,2024.04.18
162,HEAVEN HAS A BAR,Niko Moon,1,1,0,1,0,11800,11800,0,14,2024.04.18
163,Use Me,Zach Top,8,0,8,1,0,11700,-3900,15600,288024,2024.04.18
164,Heartfirst,Kelsea Ballerini,3,3,0,3,0,11400,11400,0,325497,2024.04.18
165,Kiss My Boots,Brian Kelley,1,1,0,1,0,11300,11300,0,202411,2024.04.18
165,Live Forever,Kate Hudson,1,1,0,1,0,11300,11300,0,62131,2024.04.18
167,"Salt, Lime & Tequila",Ryan Griffin,4,4,0,1,0,11100,11100,0,71155,2024.04.18
168,5 Leaf Clover,Luke Combs,2,2,0,2,0,11000,11000,0,2080964,2024.04.18
169,Holy Roller,Zach Bryan,6,1,5,1,0,10600,1700,8900,1043237,2024.04.18
170,Forward,Niia,1,0,1,1,0,10600,0,10600,164,2024.04.18
171,Take Forever (Hally's Song),Cooper Alan,1,1,0,1,0,10200,10200,0,1334036,2024.04.18
171,Hannah Ford Road,Luke Combs,1,1,0,1,0,10200,10200,0,306971,2024.04.18
171,Whiskey Friends,Morgan Wallen,1,1,0,1,0,10200,10200,0,1437993,2024.04.18
174,My Jesus,Anne Wilson,1,1,0,1,0,9900,9900,0,1675795,2024.04.18
174,That's My King,Cece Winans,1,1,0,1,0,9900,9900,0,769170,2024.04.18
174,We Are The Church,Ernie Haase & Signature Sound,1,1,0,1,0,9900,9900,0,20560,2024.04.18
174,Do It For You,Jason Crabb,1,1,0,1,0,9900,9900,0,4752,2024.04.18
178,Dive Bar,"Willie Jones, Ben Burgess",8,1,7,1,0,9800,3100,6700,53713,2024.04.18
179,Tennessee Fan,Morgan Wallen,1,1,0,1,0,9400,9400,0,1332943,2024.04.18
180,I Wrote The Book,Morgan Wallen,1,-1,2,1,0,9400,0,9400,3859307,2024.04.18
181,'98 Braves,Morgan Wallen,1,-15,16,1,0,9400,-44700,54100,2105951,2024.04.18
182,Hawaii,Old Dominion,1,1,0,1,0,9300,9300,0,91499,2024.04.18
183,Space In My Heart,Enrique Iglesias & Miranda Lambert,11,1,10,1,0,9100,500,8600,610861,2024.04.18
184,Heart Attack,Boy Named Banjo,3,-1,4,1,0,8700,-300,9000,3572,2024.04.18
185,Narcissist,Avery Anna,1,-1,2,1,0,7600,-5500,13100,446499,2024.04.18
186,Red Letter Blueprint,Scotty McCreery,1,1,0,1,0,7500,7500,0,129915,2024.04.18
186,I'm So Blessed,CAIN,1,1,0,1,0,7500,7500,0,831001,2024.04.18
186,Be The Reason,Steeles,1,1,0,1,0,7500,7500,0,427,2024.04.18
186,Here Comes Jesus,Jeff & Sheri Easter,1,1,0,1,0,7500,7500,0,28191,2024.04.18
186,Sunday Sermons,Anne Wilson,1,1,0,1,0,7500,7500,0,640927,2024.04.18
191,Long Live Cowgirls,Ian Munsick & Cody Johnson,11,-14,25,3,0,7100,-25600,32700,791206,2024.04.18
192,Black And White,Joe Mullins & The Radio Ramblers,1,1,0,1,0,6900,6900,0,222,2024.04.18
193,Uh-huh (Ajá),Frank Ray,2,2,0,2,0,6700,6700,0,232,2024.04.18
194,Let's Sing,Booth Brothers,1,0,1,1,0,6700,6300,400,434,2024.04.18
194,Sheaves (Dedicated To Isabel),Karen Peck & New River,1,0,1,1,0,6700,6300,400,4099,2024.04.18
196,Praying For The Prodigal,Kingsmen,1,0,1,1,0,6700,0,6700,1105,2024.04.18
196,Pb&J,Todd Tilghman,1,0,1,1,0,6700,0,6700,269,2024.04.18
196,Help Is On The Way,Gold City,1,0,1,1,0,6700,0,6700,24086,2024.04.18
196,Back To The Garden,Erwins,1,0,1,1,0,6700,0,6700,0,2024.04.18
196,When They Call My Name,Mark Trammell Quartet,1,0,1,1,0,6700,0,6700,5627,2024.04.18
196,Forgiven,Joseph Habedank,1,0,1,1,0,6700,0,6700,2,2024.04.18
196,"I, John",Blackwood Brothers Quartet,1,0,1,1,0,6700,0,6700,31,2024.04.18
196,Not One Word,Collingsworth Family,1,0,1,1,0,6700,0,6700,2,2024.04.18
196,Fall Into Place,Jeff & Sheri Easter,1,0,1,1,0,6700,0,6700,913,2024.04.18
196,There's A Song For That,Down East Boys,1,0,1,1,0,6700,0,6700,3018,2024.04.18
196,Made A Mess,Tim Menzies,1,0,1,1,0,6700,0,6700,119,2024.04.18
196,It Won't Be Long,Poet Voices,1,0,1,1,0,6700,0,6700,0,2024.04.18
196,"Ever Present, Ever Faithful",Jim & Melissa Brady,1,0,1,1,0,6700,0,6700,3200,2024.04.18
196,The Day I Get Home,Kelly Garner,1,0,1,1,0,6700,0,6700,254,2024.04.18
196,Means Something To Me,Tate Emmons,1,0,1,1,0,6700,0,6700,766,2024.04.18
196,Breaking Boundaries,Sunday Drive,1,0,1,1,0,6700,0,6700,439,2024.04.18
196,Part Of The Family,Littles,1,0,1,1,0,6700,0,6700,0,2024.04.18
196,God Is Listening,Triumphant Quartet,1,0,1,1,0,6700,0,6700,0,2024.04.18
196,Dear Heavenly Father,11th Hour,1,0,1,1,0,6700,0,6700,4446,2024.04.18
196,Heading In A New Direction,Elaine Roy,1,0,1,1,0,6700,0,6700,0,2024.04.18
196,There Is A Name,LeFevre Quartet,1,0,1,1,0,6700,0,6700,798,2024.04.18
196,Way Up On The Mountain,Becky Isaacs Bowman,1,0,1,1,0,6700,0,6700,720,2024.04.18
196,Middle Of Nowhere,Southbound,1,0,1,1,0,6700,0,6700,6229,2024.04.18
1,Outskirts,Sam Hunt,7872,-615,8487,144,0,31661100,-1516500,33177600,1598432,2024.04.25
2,Cab In A Solo,Scotty McCreery,7702,1768,5934,144,0,27798300,5754900,22043400,1068156,2024.04.25
3,Back Then Right Now,Tyler Hubbard,7143,339,6804,144,0,26025900,1449700,24576200,4479505,2024.04.25
4,Tucson Too Late,Jordan Davis,6879,305,6574,144,0,25819300,1567400,24251900,2113813,2024.04.25
5,Where It Ends,Bailey Zimmerman,6217,417,5800,144,0,22899500,1860500,21039000,7167506,2024.04.25
6,Take Her Home,Kenny Chesney,5556,571,4985,144,0,21998900,2653400,19345500,1631433,2024.04.25
7,World On Fire,Nate Smith,4950,-103,5053,144,0,21059500,-516200,21575700,4233981,2024.04.25
8,Pretty Little Poison,Warren Zeiders,5045,-175,5220,140,0,20588400,-1071200,21659600,7279653,2024.04.25
9,Halfway To Hell,Jelly Roll,5278,400,4878,144,0,20335300,1933500,18401800,3081815,2024.04.25
10,Wildflowers And Wild Horses,Lainey Wilson,5562,40,5522,144,0,19045800,305800,18740000,5997612,2024.04.25
11,Your Place,Ashley Cooke,4872,193,4679,144,0,17130400,1397500,15732900,1674751,2024.04.25
12,Fearless,Jackson Dean,4250,-44,4294,143,0,15217000,-90900,15307900,975591,2024.04.25
13,Let Your Boys Be Country,Jason Aldean,3940,241,3699,143,0,14032400,440500,13591900,1745668,2024.04.25
14,We Don'T Fight Anymore,Carly Pearce,4162,254,3908,144,0,13828400,879300,12949100,2727465,2024.04.25
15,We Ride,Bryan Martin,3828,308,3520,144,0,12723000,848700,11874300,4335743,2024.04.25
16,Young Love & Saturday Nights,Chris Young,3002,186,2816,141,0,10923300,978300,9945000,2154776,2024.04.25
17,Bulletproof,Nate Smith,3080,262,2818,144,0,10708900,1165300,9543600,6218521,2024.04.25
18,Love You Again,Chase Matthew,3104,313,2791,141,0,10208400,1540700,8667700,2336242,2024.04.25
19,Can't Break Up Now,Old Dominion,2950,94,2856,144,0,9090100,412800,8677300,1236940,2024.04.25
20,I'M Not Pretty,Megan Moroney,2854,46,2808,143,0,8850100,-93200,8943300,1971768,2024.04.25
21,Dirt Cheap,Cody Johnson,2225,356,1869,138,0,8222100,1085900,7136200,4632098,2024.04.25
22,Chevrolet,Dustin Lynch Feat. Jelly Roll,2103,207,1896,141,0,6643700,1043200,5600500,2194344,2024.04.25
23,She's Somebody's Daughter,Drew Baldridge,1856,263,1593,133,0,5278400,599200,4679200,446742,2024.04.25
24,One Bad Habit,Tim McGraw,1926,138,1788,144,0,5149200,286300,4862900,406764,2024.04.25
25,Rodeo Man,Garth Brooks & Ronnie Dunn,2073,239,1834,143,0,4885700,208900,4676800,968153,2024.04.25
26,Cowgirls,Morgan Wallen,1193,572,621,88,0,4794400,2260200,2534200,8796899,2024.04.25
27,Dance With You,Brett Young,1661,59,1602,134,0,4767100,257700,4509400,1476106,2024.04.25
28,This Is My Dirt,Justin Moore,1694,189,1505,137,0,4542700,601900,3940800,498979,2024.04.25
29,Gonna Love You,Parmalee,1714,71,1643,137,0,4402700,233700,4169000,273698,2024.04.25
30,Messed Up As Me,Keith Urban,1491,45,1446,134,0,4003600,70900,3932700,1045294,2024.04.25
31,Drinkin' Problems,Dillon Carmichael,1676,6,1670,142,0,3938700,-3500,3942200,39456,2024.04.25
32,Tie Up,Zac Brown Band,893,135,758,78,0,3653200,936600,2716600,711651,2024.04.25
33,Bigger Houses,Dan + Shay,1343,26,1317,134,0,3569100,274100,3295000,1184253,2024.04.25
34,Austin,Dasha,935,54,881,68,0,3326700,194400,3132300,12694858,2024.04.25
35,Sounds Like The Radio,Zach Top,1246,4,1242,114,0,3308800,267300,3041500,669437,2024.04.25
36,"Love You, Miss You, Mean It",Luke Bryan,924,107,817,102,0,3113800,490800,2623000,2908808,2024.04.25
37,American Girl,Dierks Bentley,941,29,912,106,0,2898100,218300,2679800,608232,2024.04.25
38,Cowboy Songs,George Birge,1053,113,940,114,0,2789200,100800,2688400,559804,2024.04.25
39,Find Another Bar,Chris Lane,1087,75,1012,106,0,2307500,229100,2078400,106354,2024.04.25
40,Boys Back Home,Dylan Marlowe Feat. Dylan Scott,861,44,817,96,0,2056800,147000,1909800,2809567,2024.04.25
41,This Town's Been Too Good To Us,Dylan Scott,753,39,714,80,0,1952700,64200,1888500,2623045,2024.04.25
42,Whatcha See Is Whatcha Get,Chris Janson,848,118,730,99,0,1933800,424000,1509800,250046,2024.04.25
43,Damn Good Day To Leave,Riley Green,696,80,616,83,0,1760600,310100,1450500,1131731,2024.04.25
44,In Your Love,Tyler Childers,999,26,973,109,0,1743400,51400,1692000,2826976,2024.04.25
45,Forever To Me,Cole Swindell,540,-451,991,99,0,1631600,-1950100,3581700,2247267,2024.04.25
46,Breakin' In Boots,Matt Stell,862,33,829,101,0,1627000,-45000,1672000,745316,2024.04.25
47,Love You Back,Lady A,800,24,776,104,0,1557600,-20400,1578000,183595,2024.04.25
48,I Tried A Ring On,Tigirlily Gold,819,80,739,96,0,1490400,264900,1225500,600267,2024.04.25
49,Think I’m In Love With You,Chris Stapleton,586,16,570,65,0,1362000,-9600,1371600,6031614,2024.04.25
50,I'm In Love,Hailey Whitters,633,4,629,76,0,1246700,-43600,1290300,209346,2024.04.25
51,Life With You,Kelsey Hart,679,115,564,80,0,1240000,128400,1111600,2123293,2024.04.25
52,Called Crazy,Kassi Ashton,242,-9,251,13,0,979600,135700,843900,87927,2024.04.25
53,Last Rodeo,Restless Road,467,56,411,51,0,953600,139100,814500,471361,2024.04.25
54,King Of Country Music,Ryan Larkins,373,8,365,55,0,802200,21100,781100,10290,2024.04.25
55,Single Again,Josh Ross,464,50,414,67,0,723900,-30000,753900,1805935,2024.04.25
56,Wine Into Whiskey,Tucker Wetmore,191,39,152,20,0,713300,164900,548400,6634993,2024.04.25
57,Make Me Wanna Smoke,Runaway June,381,32,349,44,0,667000,59000,608000,14979,2024.04.25
58,Country Back,Randy Houser,351,54,297,55,0,658000,187000,471000,203857,2024.04.25
59,Things I Take For Granted,Larry Fleet,303,-8,311,51,0,533600,48600,485000,1864837,2024.04.25
60,Friends Like That,John Morgan,207,126,81,41,0,474000,265000,209000,1660245,2024.04.25
61,Spin You Around (1/24),Morgan Wallen,134,-8,142,6,0,467900,-85100,553000,6618118,2024.04.25
62,This Heart,Corey Kent,311,31,280,44,0,463300,76100,387200,1935547,2024.04.25
63,The Devil I Know,Ashley McBryde,308,20,288,37,0,447200,-35000,482200,363043,2024.04.25
64,Neon Baby,Annie Bosko,259,-7,266,38,0,441500,57300,384200,11585,2024.04.25
65,Dance Like No One’s Watching,Gabby Barrett,236,236,0,32,0,424800,424800,0,1017100,2024.04.25
66,Good On You,Priscilla Block,237,36,201,36,0,385100,73500,311600,607903,2024.04.25
67,Shape Of You,Ed Sheeran,76,76,0,38,0,365200,365200,0,3391345,2024.04.25
68,No Caller Id,Megan Moroney,129,-3,132,8,0,343100,40500,302600,3873006,2024.04.25
69,Million Little Bandaids,Caroline Jones,224,-5,229,33,0,264700,-5700,270400,18161,2024.04.25
70,Devil You Know,Tyler Braden,133,84,49,19,0,245300,118600,126700,4666500,2024.04.25
71,Break Mine,Brothers Osborne,63,17,46,12,0,234200,81700,152500,391381,2024.04.25
72,Ain'T About You,Huntergirl,156,-196,352,28,0,220600,-344500,565100,17504,2024.04.25
73,Young Man,Greylan James,36,0,36,3,0,213700,22000,191700,57909,2024.04.25
74,Damn Good Time,Jordan Davis,23,3,20,1,0,198500,22900,175600,174703,2024.04.25
75,Color Up My World,"Hailey Whitters, Ben Rector",39,-37,76,39,0,188000,-177200,365200,129918,2024.04.25
76,Hey Driver,Zach Bryan Feat. The War and Treaty,75,6,69,4,0,186600,33600,153000,6044641,2024.04.25
77,Wild Ones,Jessie Murph & Jelly Roll,49,-2,51,2,0,185000,1600,183400,10160756,2024.04.25
78,Outlaws And Mustangs,Cody Jinks,31,-10,41,5,0,147100,-22700,169800,178170,2024.04.25
79,Two Night Stands,Kylie Morgan,119,27,92,18,0,135700,37100,98600,159299,2024.04.25
80,Holy Smokes,Bailey Zimmerman,23,-1,24,2,0,132400,-9000,141400,4398756,2024.04.25
81,The Architect,Kacey Musgraves,93,-4,97,15,0,120300,-22700,143000,950975,2024.04.25
82,A Bar Song (Tipsy),Shaboozey,35,34,1,8,0,118300,113800,4500,21168012,2024.04.25
83,Jack And Diet Coke,Redferrin,41,1,40,3,0,104900,-15400,120300,1930251,2024.04.25
84,Jolene,Beyonce,36,5,31,1,0,104500,27700,76800,4776007,2024.04.25
85,Wondering Why,Red Clay Strays,52,0,52,6,0,104200,-17100,121300,4836577,2024.04.25
86,Man Upstairs,Tim Dugger,20,3,17,1,0,103700,14700,89000,33913,2024.04.25
87,So Do I,Tenille Arts,49,49,0,48,0,99100,99100,0,67058,2024.04.25
88,Sometimes,Laci Kaye Booth,48,48,0,48,0,91500,91500,0,26376,2024.04.25
89,All Dogs Go To Heaven,Chris Young,17,17,0,16,0,87400,87400,0,23265,2024.04.25
90,Roulette On The Heart,Conner Smith,72,55,17,22,0,82300,52100,30200,805272,2024.04.25
91,Coal,Dylan Gossett,19,1,18,2,0,79000,-25500,104500,4940771,2024.04.25
92,Break It Like A Man,Harper Grace,16,16,0,15,0,77500,77500,0,32679,2024.04.25
93,Rain In The Rearview,Anne Wilson,63,-30,93,15,0,71400,-10600,82000,1484552,2024.04.25
94,Everything I Need,Chayce Beckham,66,63,3,12,0,70400,55500,14900,77356,2024.04.25
95,Hometown Home,Locash,19,11,8,6,0,70400,51400,19000,226309,2024.04.25
96,Ii Most Wanted,Beyonce & Miley Cyrus,44,44,0,44,0,67800,67800,0,6020257,2024.04.25
97,Broadway Girls,Lil Durk Feat. Morgan Wallen,12,-2,14,2,0,63700,11800,51900,4057659,2024.04.25
98,How Is She,Cole Swindell,15,-1,16,1,0,60700,-43700,104400,43698,2024.04.25
99,Purple Irises,Gwen Stefani & Blake Shelton,54,-38,92,17,0,58000,-67700,125700,169104,2024.04.25
100,Paying For It,Levi Hummon,65,-2,67,10,0,56900,-3600,60500,83607,2024.04.25
101,Strangers,Kameron Marlowe & Ella Langley,19,2,17,2,0,56100,-4900,61000,736894,2024.04.25
102,Heart They Didn'T Break,Maddie & Tae,46,-5,51,5,0,54900,-900,55800,264333,2024.04.25
103,Summertime Blues,Zach Bryan,22,3,19,1,0,53400,1000,52400,557966,2024.04.25
104,Long Live Cowgirls,Ian Munsick & Cody Johnson,28,17,11,14,0,52600,45500,7100,798143,2024.04.25
105,Country Gold,Anne Wilson,14,4,10,3,0,51700,15400,36300,456726,2024.04.25
106,Roots,Austin Burke,14,-7,21,1,0,50400,-19200,69600,72837,2024.04.25
107,Country House,Sam Hunt,17,6,11,4,0,47800,24400,23400,996921,2024.04.25
108,Pray All The Way Home,Austin Snell,21,-6,27,4,0,46400,10900,35500,1188178,2024.04.25
109,'73 Beetle,Tyler Hubbard,8,8,0,8,0,45400,45400,0,0,2024.04.25
110,Checking In,For King & Country & Lee Brice,51,51,0,17,0,44400,44400,0,138520,2024.04.25
111,Jesus Saves,Riley Green,9,-3,12,1,0,37900,-32500,70400,1404968,2024.04.25
112,Oklahoma Sooner,Jake Banfield,11,-2,13,1,0,37800,2400,35400,5042,2024.04.25
113,Whiskey's Gonna Find Me,Jackson,8,0,8,1,0,35000,-5300,40300,0,2024.04.25
114,Paint The Town Blue,Ella Langley,21,21,0,15,0,32700,32700,0,169646,2024.04.25
115,Work Boots,Cody Johnson,3,1,2,1,0,32200,17800,14400,326008,2024.04.25
116,No Present LIke The Time,Jay Allen,42,-22,64,22,0,30900,-23400,54300,0,2024.04.25
117,Deeper Well,Kacey Musgraves,14,-12,26,2,0,30800,-43500,74300,2544451,2024.04.25
118,Thinkin Bout Cheatin,Mae Estes,34,-17,51,17,0,29600,-14800,44400,18762,2024.04.25
119,Am I The Only One,Aaron Lewis,6,0,6,2,0,28900,8500,20400,663375,2024.04.25
120,This Side Of The Dirt,Neon Union,51,1,50,9,0,27100,-2800,29900,31146,2024.04.25
121,Darlin',Jenna Paulette,14,0,14,1,0,23700,-12100,35800,258299,2024.04.25
122,The Star-Spangled Banner,Chris Stapleton,7,-8,15,7,0,22800,-28200,51000,82855,2024.04.25
123,Country's Cool Again,Lainey Wilson,14,-3,17,1,0,22600,-14600,37200,865006,2024.04.25
124,Baby Daddy's Weekend,Elle King,3,3,0,2,0,22000,22000,0,0,2024.04.25
125,Problems,12/Oc,10,8,2,1,0,21700,17800,3900,1997,2024.04.25
126,Would If I Could (Feat. Lainey Wilson),Ernest,9,5,4,1,0,21400,5500,15900,2262160,2024.04.25
127,Certified,Laura Bryna,27,-3,30,6,0,19900,-3500,23400,2736,2024.04.25
128,Russell County Line,49 Winchester,9,-2,11,1,0,18400,2300,16100,391244,2024.04.25
129,Pirates & Parrots,Zac Brown Band,3,3,0,3,0,17700,17700,0,1416230,2024.04.25
130,When My Baby's In Boots,Randall King,2,0,2,1,0,17600,2100,15500,0,2024.04.25
131,Tractor Time,Darryl Worley,3,3,0,3,0,16900,16900,0,307742,2024.04.25
132,John Deere Green,"HIXTAPE Feat. HARDY, Morgan Wallen, Joe Diffie",4,1,3,4,0,16700,100,16600,0,2024.04.25
133,Buckles And Broken Hearts,Joe Peters,3,2,1,1,0,16000,10700,5300,793,2024.04.25
134,Any Given Friday Night,Luke Combs,2,0,2,1,0,16000,0,16000,235476,2024.04.25
135,Baby Do,Randall King,2,0,2,1,0,15500,-3200,18700,17968,2024.04.25
136,Open The Gate,Zach Bryan,2,-1,3,1,0,15500,-3000,18500,1371062,2024.04.25
137,That's Texas,Cody Johnson,2,-2,4,1,0,15500,-24200,39700,291027,2024.04.25
138,Uh-huh (Ajá),Frank Ray,5,3,2,3,0,15100,8400,6700,91202,2024.04.25
139,A Cowboy Who Would,Chancey Williams,17,0,17,17,0,14800,0,14800,24950,2024.04.25
140,Goodbye You,Landon Parker,17,-17,34,17,0,14800,-14800,29600,1524,2024.04.25
141,Highway Towns,Sykamore,17,-34,51,17,0,14800,-29600,44400,1027,2024.04.25
142,Pop Goes The Whiskey (Feat. Ernest),Jake Worthington,1,1,0,1,0,14600,14600,0,3172,2024.04.25
142,Boy From Anderson County,Kolby Cooper,1,1,0,1,0,14600,14600,0,26870,2024.04.25
144,Up In Texas,Midland,2,0,2,1,0,14400,-1100,15500,327281,2024.04.25
145,Dive,Luke Combs,2,-4,6,1,0,14400,-71000,85400,1406132,2024.04.25
146,Forgiven,Joseph Habedank,2,1,1,2,0,14200,7500,6700,6865,2024.04.25
146,Means Something To Me,Tate Emmons,2,1,1,2,0,14200,7500,6700,658,2024.04.25
148,Sunrise Tells The Story,Midland,1,0,1,1,0,13500,0,13500,154438,2024.04.25
149,Give Me A Sunrise,Braxton Keith,1,0,1,1,0,13500,-1100,14600,43876,2024.04.25
150,Whose Rearview,Jason Aldean,2,0,2,1,0,13400,-200,13600,529616,2024.04.25
151,You'll Always Be My Baby (Written For Daughters' Weddings),Alan Jackson,6,1,5,1,0,13100,-3600,16700,45881,2024.04.25
152,Holy Roller,Zach Bryan,6,0,6,1,0,12600,2000,10600,985563,2024.04.25
153,The Good I'Ll Do,Zach Bryan,2,0,2,1,0,12000,11800,200,2261849,2024.04.25
154,He Bought Me,Old Paths,2,0,2,2,0,11900,-2400,14300,226,2024.04.25
155,Stick Season,Noah Kahan,6,5,1,1,0,11600,5100,6500,13303227,2024.04.25
156,Use Me,Zach Top,9,1,8,1,0,11600,-100,11700,302407,2024.04.25
157,Back 40 Back,Luke Combs,1,1,0,1,0,10200,10200,0,238693,2024.04.25
157,Makes Two Of Us,Colin Stough,1,1,0,1,0,10200,10200,0,220489,2024.04.25
157,My Song Will Never Die,Luke Combs,1,1,0,1,0,10200,10200,0,160099,2024.04.25
160,Devil Don't Know,Morgan Wallen,1,0,1,1,0,10200,5600,4600,766760,2024.04.25
161,'98 Braves,Morgan Wallen,1,0,1,1,0,10200,800,9400,1921167,2024.04.25
162,Georgia Girl,Megan Moroney,1,1,0,1,0,10100,10100,0,330306,2024.04.25
163,Meet Me At The Cross,Brian Free & Assurance,1,1,0,1,0,9900,9900,0,4645,2024.04.25
164,He Pilots My Ship,Tribute Quartet,1,0,1,1,0,9900,5500,4400,766,2024.04.25
165,Mansions,Sound Street,1,-1,2,1,0,9900,-2000,11900,384,2024.04.25
166,5 Leaf Clover,Luke Combs,1,-1,2,1,0,9500,-1500,11000,2024253,2024.04.25
167,Wine Country,Hannah Ellis,6,-1,7,2,0,9500,-2400,11900,14966,2024.04.25
168,Ain't That Some,Morgan Wallen,1,-14,15,1,0,9400,-35000,44400,4067941,2024.04.25
169,Record High,Randall King,3,3,0,2,0,9300,9300,0,23709,2024.04.25
170,Locked Up,Sam Hunt,1,-8,9,1,0,9200,-45400,54600,1098028,2024.04.25
170,Death Row,Thomas Rhett Feat. Tyler Hubbard & Russell Dickerson,1,-8,9,1,0,9200,-45400,54600,43876,2024.04.25
172,Start Nowhere,Sam Hunt,1,-8,9,1,0,9200,-47600,56800,147642,2024.04.25
173,Wind Up Missin' You,Tucker Wetmore,3,3,0,1,0,9100,9100,0,7953122,2024.04.25
174,No Yesterday,Jeremy McComb,4,0,4,1,0,8600,4200,4400,286,2024.04.25
175,Heart Of A Small Town,Tim Dugger,2,-1,3,1,0,8400,4000,4400,13136,2024.04.25
176,Slow Dance,Daniel Jeffers,1,0,1,1,0,8300,7000,1300,3206,2024.04.25
177,Waiting For Me,Truesong,1,1,0,1,0,7500,7500,0,714,2024.04.25
177,Make The Morning Worth The Midnight,Gaither Vocal Band,1,1,0,1,0,7500,7500,0,11313,2024.04.25
177,Anywhere Jesus Is,Scotty Inman,1,1,0,1,0,7500,7500,0,933,2024.04.25
177,In God's Time,Jordan Family Band,1,1,0,1,0,7500,7500,0,3009,2024.04.25
181,Here Comes Jesus,Jeff & Sheri Easter,1,0,1,1,0,7500,0,7500,24835,2024.04.25
181,Red Letter Blueprint,Scotty McCreery,1,0,1,1,0,7500,0,7500,115736,2024.04.25
183,We Are The Church,Ernie Haase & Signature Sound,1,0,1,1,0,7500,-2400,9900,21844,2024.04.25
184,Space In My Heart,Enrique Iglesias & Miranda Lambert,10,-1,11,1,0,7400,-1700,9100,434751,2024.04.25
185,"Salt, Lime & Tequila",Ryan Griffin,1,-3,4,1,0,7200,-3900,11100,67306,2024.04.25
186,Everleave,Alexandra Kay,2,2,0,1,0,6800,6800,0,330666,2024.04.25
187,Double Down,Cody Johnson,1,-1,2,1,0,6800,-6600,13400,189534,2024.04.25
188,You In A Honky Tonk,Randall King,3,2,1,2,0,6700,4200,2500,314063,2024.04.25
189,Holy Smoke,Frank Vieira,7,1,6,1,0,6700,1300,5400,135,2024.04.25
190,Revival Broke Out,Gaither Vocal Band,1,0,1,1,0,6700,6300,400,1899,2024.04.25
191,"I, John",Blackwood Brothers Quartet,1,0,1,1,0,6700,0,6700,28,2024.04.25
191,God Is Listening,Triumphant Quartet,1,0,1,1,0,6700,0,6700,0,2024.04.25
191,Middle Of Nowhere,Southbound,1,0,1,1,0,6700,0,6700,7049,2024.04.25
191,Dear Heavenly Father,11th Hour,1,0,1,1,0,6700,0,6700,4302,2024.04.25
191,Pb&J,Todd Tilghman,1,0,1,1,0,6700,0,6700,309,2024.04.25
191,The Day I Get Home,Kelly Garner,1,0,1,1,0,6700,0,6700,205,2024.04.25
191,"Ever Present, Ever Faithful",Jim & Melissa Brady,1,0,1,1,0,6700,0,6700,3853,2024.04.25
191,Praying For The Prodigal,Kingsmen,1,0,1,1,0,6700,0,6700,856,2024.04.25
191,Heading In A New Direction,Elaine Roy,1,0,1,1,0,6700,0,6700,0,2024.04.25
191,Fall Into Place,Jeff & Sheri Easter,1,0,1,1,0,6700,0,6700,822,2024.04.25
191,Sheaves (Dedicated To Isabel),Karen Peck & New River,1,0,1,1,0,6700,0,6700,4038,2024.04.25
191,Not One Word,Collingsworth Family,1,0,1,1,0,6700,0,6700,4,2024.04.25
191,Made A Mess,Tim Menzies,1,0,1,1,0,6700,0,6700,146,2024.04.25
191,Breaking Boundaries,Sunday Drive,1,0,1,1,0,6700,0,6700,547,2024.04.25
191,Help Is On The Way,Gold City,1,0,1,1,0,6700,0,6700,20955,2024.04.25
191,Part Of The Family,Littles,1,0,1,1,0,6700,0,6700,0,2024.04.25
191,There's A Song For That,Down East Boys,1,0,1,1,0,6700,0,6700,2713,2024.04.25
191,There Is A Name,LeFevre Quartet,1,0,1,1,0,6700,0,6700,878,2024.04.25
191,Way Up On The Mountain,Becky Isaacs Bowman,1,0,1,1,0,6700,0,6700,766,2024.04.25
191,When They Call My Name,Mark Trammell Quartet,1,0,1,1,0,6700,0,6700,5687,2024.04.25
191,It Won't Be Long,Poet Voices,1,0,1,1,0,6700,0,6700,0,2024.04.25
191,Let's Sing,Booth Brothers,1,0,1,1,0,6700,0,6700,350,2024.04.25
213,Your Healing Is On The Way,Greater Vision,1,-1,2,1,0,6700,-7500,14200,910,2024.04.25
1,Outskirts,Sam Hunt,7033,-839,7872,142,0,29088600,-2572500,31661100,1663689,2024.05.02
1,Outskirts,Sam Hunt,7033,-839,7872,142,0,29088600,-2572500,31661100,1663689,2024.05.02
3,Back Then Right Now,Tyler Hubbard,7388,245,7143,144,0,27199100,1173200,26025900,4438567,2024.05.02
3,Back Then Right Now,Tyler Hubbard,7388,245,7143,144,0,27199100,1173200,26025900,4438567,2024.05.02
5,Tucson Too Late,Jordan Davis,7057,178,6879,144,0,26818000,998700,25819300,1882361,2024.05.02
5,Tucson Too Late,Jordan Davis,7057,178,6879,144,0,26818000,998700,25819300,1882361,2024.05.02
7,Where It Ends,Bailey Zimmerman,7068,851,6217,144,0,26119600,3220100,22899500,7647861,2024.05.02
7,Where It Ends,Bailey Zimmerman,7068,851,6217,144,0,26119600,3220100,22899500,7647861,2024.05.02
9,Wildflowers And Wild Horses,Lainey Wilson,7119,1557,5562,144,0,24423100,5377300,19045800,6146066,2024.05.02
9,Wildflowers And Wild Horses,Lainey Wilson,7119,1557,5562,144,0,24423100,5377300,19045800,6146066,2024.05.02
11,Take Her Home,Kenny Chesney,5828,272,5556,144,0,22809200,810300,21998900,1791063,2024.05.02
11,Take Her Home,Kenny Chesney,5828,272,5556,144,0,22809200,810300,21998900,1791063,2024.05.02
13,Halfway To Hell,Jelly Roll,5998,720,5278,144,0,22361300,2026000,20335300,3324566,2024.05.02
13,Halfway To Hell,Jelly Roll,5998,720,5278,144,0,22361300,2026000,20335300,3324566,2024.05.02
15,Pretty Little Poison,Warren Zeiders,4890,-155,5045,138,0,19892800,-695600,20588400,7738756,2024.05.02
15,Pretty Little Poison,Warren Zeiders,4890,-155,5045,138,0,19892800,-695600,20588400,7738756,2024.05.02
17,Your Place,Ashley Cooke,5011,139,4872,144,0,17926700,796300,17130400,1900032,2024.05.02
17,Your Place,Ashley Cooke,5011,139,4872,144,0,17926700,796300,17130400,1900032,2024.05.02
19,Cab In A Solo,Scotty McCreery,4577,-3125,7702,144,0,17678200,-10120100,27798300,1269430,2024.05.02
19,Cab In A Solo,Scotty McCreery,4577,-3125,7702,144,0,17678200,-10120100,27798300,1269430,2024.05.02
21,Fearless,Jackson Dean,4278,28,4250,143,0,15235100,18100,15217000,1059817,2024.05.02
21,Fearless,Jackson Dean,4278,28,4250,143,0,15235100,18100,15217000,1059817,2024.05.02
23,Let Your Boys Be Country,Jason Aldean,4184,244,3940,144,0,15175700,1143300,14032400,1987105,2024.05.02
23,Let Your Boys Be Country,Jason Aldean,4184,244,3940,144,0,15175700,1143300,14032400,1987105,2024.05.02
25,We Ride,Bryan Martin,4070,242,3828,144,0,14056000,1333000,12723000,4654414,2024.05.02
25,We Ride,Bryan Martin,4070,242,3828,144,0,14056000,1333000,12723000,4654414,2024.05.02
27,We Don'T Fight Anymore,Carly Pearce,4246,84,4162,144,0,13948800,120400,13828400,2800283,2024.05.02
27,We Don'T Fight Anymore,Carly Pearce,4246,84,4162,144,0,13948800,120400,13828400,2800283,2024.05.02
29,Bulletproof,Nate Smith,3413,333,3080,144,0,11652100,943200,10708900,6868866,2024.05.02
29,Bulletproof,Nate Smith,3413,333,3080,144,0,11652100,943200,10708900,6868866,2024.05.02
31,Young Love & Saturday Nights,Chris Young,3342,340,3002,141,0,11645500,722200,10923300,1687724,2024.05.02
31,Young Love & Saturday Nights,Chris Young,3342,340,3002,141,0,11645500,722200,10923300,1687724,2024.05.02
33,Love You Again,Chase Matthew,3219,115,3104,141,0,10611400,403000,10208400,2483262,2024.05.02
33,Love You Again,Chase Matthew,3219,115,3104,141,0,10611400,403000,10208400,2483262,2024.05.02
35,Dirt Cheap,Cody Johnson,2873,648,2225,140,0,10445200,2223100,8222100,4973704,2024.05.02
35,Dirt Cheap,Cody Johnson,2873,648,2225,140,0,10445200,2223100,8222100,4973704,2024.05.02
37,I'M Not Pretty,Megan Moroney,3003,149,2854,143,0,9419500,569400,8850100,2064425,2024.05.02
37,I'M Not Pretty,Megan Moroney,3003,149,2854,143,0,9419500,569400,8850100,2064425,2024.05.02
39,Can't Break Up Now,Old Dominion,2922,-28,2950,144,0,8969200,-120900,9090100,1195802,2024.05.02
39,Can't Break Up Now,Old Dominion,2922,-28,2950,144,0,8969200,-120900,9090100,1195802,2024.05.02
41,Chevrolet,Dustin Lynch Feat. Jelly Roll,2325,222,2103,140,0,7534000,890300,6643700,2219960,2024.05.02
41,Chevrolet,Dustin Lynch Feat. Jelly Roll,2325,222,2103,140,0,7534000,890300,6643700,2219960,2024.05.02
43,Cowgirls,Morgan Wallen,1873,680,1193,119,0,7288600,2494200,4794400,10187526,2024.05.02
43,Cowgirls,Morgan Wallen,1873,680,1193,119,0,7288600,2494200,4794400,10187526,2024.05.02
45,She's Somebody's Daughter,Drew Baldridge,2294,438,1856,133,0,6665100,1386700,5278400,454300,2024.05.02
45,She's Somebody's Daughter,Drew Baldridge,2294,438,1856,133,0,6665100,1386700,5278400,454300,2024.05.02
47,One Bad Habit,Tim McGraw,2216,290,1926,144,0,5822200,673000,5149200,421405,2024.05.02
47,One Bad Habit,Tim McGraw,2216,290,1926,144,0,5822200,673000,5149200,421405,2024.05.02
49,This Is My Dirt,Justin Moore,1725,31,1694,138,0,4989100,446400,4542700,538219,2024.05.02
49,This Is My Dirt,Justin Moore,1725,31,1694,138,0,4989100,446400,4542700,538219,2024.05.02
51,Drinkin' Buddies,"Lee Brice, Hailey Whitters, And Nate Smith",1079,1079,0,124,0,4867700,4867700,0,1173939,2024.05.02
52,Dance With You,Brett Young,1719,58,1661,131,0,4765300,-1800,4767100,1406702,2024.05.02
52,Dance With You,Brett Young,1719,58,1661,131,0,4765300,-1800,4767100,1406702,2024.05.02
54,Rodeo Man,Garth Brooks & Ronnie Dunn,1957,-116,2073,143,0,4746700,-139000,4885700,974781,2024.05.02
54,Rodeo Man,Garth Brooks & Ronnie Dunn,1957,-116,2073,143,0,4746700,-139000,4885700,974781,2024.05.02
56,Gonna Love You,Parmalee,1799,85,1714,139,0,4744600,341900,4402700,281786,2024.05.02
56,Gonna Love You,Parmalee,1799,85,1714,139,0,4744600,341900,4402700,281786,2024.05.02
58,Messed Up As Me,Keith Urban,1668,177,1491,136,0,4302000,298400,4003600,1080396,2024.05.02
58,Messed Up As Me,Keith Urban,1668,177,1491,136,0,4302000,298400,4003600,1080396,2024.05.02
60,Drinkin' Problems,Dillon Carmichael,1801,125,1676,142,0,4194000,255300,3938700,50113,2024.05.02
60,Drinkin' Problems,Dillon Carmichael,1801,125,1676,142,0,4194000,255300,3938700,50113,2024.05.02
62,"Love You, Miss You, Mean It",Luke Bryan,1251,327,924,116,0,4071700,957900,3113800,2482924,2024.05.02
62,"Love You, Miss You, Mean It",Luke Bryan,1251,327,924,116,0,4071700,957900,3113800,2482924,2024.05.02
64,Bigger Houses,Dan + Shay,1560,217,1343,135,0,3967000,397900,3569100,1227027,2024.05.02
64,Bigger Houses,Dan + Shay,1560,217,1343,135,0,3967000,397900,3569100,1227027,2024.05.02
66,Tie Up,Zac Brown Band,909,16,893,84,0,3708300,55100,3653200,454799,2024.05.02
66,Tie Up,Zac Brown Band,909,16,893,84,0,3708300,55100,3653200,454799,2024.05.02
68,Sounds Like The Radio,Zach Top,1419,173,1246,136,0,3702400,393600,3308800,807659,2024.05.02
68,Sounds Like The Radio,Zach Top,1419,173,1246,136,0,3702400,393600,3308800,807659,2024.05.02
70,Austin,Dasha,1067,132,935,82,0,3572800,246100,3326700,12756834,2024.05.02
70,Austin,Dasha,1067,132,935,82,0,3572800,246100,3326700,12756834,2024.05.02
72,American Girl,Dierks Bentley,1100,159,941,134,0,3125000,226900,2898100,634203,2024.05.02
72,American Girl,Dierks Bentley,1100,159,941,134,0,3125000,226900,2898100,634203,2024.05.02
74,Cowboy Songs,George Birge,1029,-24,1053,99,0,2669600,-119600,2789200,604860,2024.05.02
74,Cowboy Songs,George Birge,1029,-24,1053,99,0,2669600,-119600,2789200,604860,2024.05.02
76,Find Another Bar,Chris Lane,1040,-47,1087,109,0,2147200,-160300,2307500,105579,2024.05.02
76,Find Another Bar,Chris Lane,1040,-47,1087,109,0,2147200,-160300,2307500,105579,2024.05.02
78,Boys Back Home,Dylan Marlowe Feat. Dylan Scott,902,41,861,96,0,2027800,-29000,2056800,2852211,2024.05.02
78,Boys Back Home,Dylan Marlowe Feat. Dylan Scott,902,41,861,96,0,2027800,-29000,2056800,2852211,2024.05.02
80,Damn Good Day To Leave,Riley Green,776,80,696,88,0,1984500,223900,1760600,1041163,2024.05.02
80,Damn Good Day To Leave,Riley Green,776,80,696,88,0,1984500,223900,1760600,1041163,2024.05.02
82,Whatcha See Is Whatcha Get,Chris Janson,842,-6,848,102,0,1941100,7300,1933800,202791,2024.05.02
82,Whatcha See Is Whatcha Get,Chris Janson,842,-6,848,102,0,1941100,7300,1933800,202791,2024.05.02
84,This Town's Been Too Good To Us,Dylan Scott,767,14,753,74,0,1931400,-21300,1952700,2557346,2024.05.02
84,This Town's Been Too Good To Us,Dylan Scott,767,14,753,74,0,1931400,-21300,1952700,2557346,2024.05.02
86,Called Crazy,Kassi Ashton,458,216,242,25,0,1917100,937500,979600,77911,2024.05.02
86,Called Crazy,Kassi Ashton,458,216,242,25,0,1917100,937500,979600,77911,2024.05.02
88,Breakin' In Boots,Matt Stell,933,71,862,98,0,1789900,162900,1627000,934061,2024.05.02
88,Breakin' In Boots,Matt Stell,933,71,862,98,0,1789900,162900,1627000,934061,2024.05.02
90,Forever To Me,Cole Swindell,540,0,540,71,0,1778200,146600,1631600,2057726,2024.05.02
90,Forever To Me,Cole Swindell,540,0,540,71,0,1778200,146600,1631600,2057726,2024.05.02
92,In Your Love,Tyler Childers,1056,57,999,135,0,1770900,27500,1743400,2819543,2024.05.02
92,In Your Love,Tyler Childers,1056,57,999,135,0,1770900,27500,1743400,2819543,2024.05.02
94,Love You Back,Lady A,819,19,800,105,0,1720900,163300,1557600,120620,2024.05.02
94,Love You Back,Lady A,819,19,800,105,0,1720900,163300,1557600,120620,2024.05.02
96,I Tried A Ring On,Tigirlily Gold,877,58,819,97,0,1472100,-18300,1490400,692181,2024.05.02
96,I Tried A Ring On,Tigirlily Gold,877,58,819,97,0,1472100,-18300,1490400,692181,2024.05.02
98,Think I’m In Love With You,Chris Stapleton,595,9,586,69,0,1321700,-40300,1362000,6300178,2024.05.02
98,Think I’m In Love With You,Chris Stapleton,595,9,586,69,0,1321700,-40300,1362000,6300178,2024.05.02
100,I'm In Love,Hailey Whitters,643,10,633,75,0,1291700,45000,1246700,218855,2024.05.02
100,I'm In Love,Hailey Whitters,643,10,633,75,0,1291700,45000,1246700,218855,2024.05.02
102,Life With You,Kelsey Hart,685,6,679,83,0,1265000,25000,1240000,2215222,2024.05.02
102,Life With You,Kelsey Hart,685,6,679,83,0,1265000,25000,1240000,2215222,2024.05.02
104,A Bar Song (Tipsy),Shaboozey,231,196,35,33,0,993300,875000,118300,35640033,2024.05.02
104,A Bar Song (Tipsy),Shaboozey,231,196,35,33,0,993300,875000,118300,35640033,2024.05.02
106,Friends Like That,John Morgan Feat. Jason Aldean,424,217,207,59,0,885100,411100,474000,1514272,2024.05.02
106,Friends Like That,John Morgan Feat. Jason Aldean,424,217,207,59,0,885100,411100,474000,1514272,2024.05.02
108,Last Rodeo,Restless Road,432,-35,467,48,0,819100,-134500,953600,536192,2024.05.02
108,Last Rodeo,Restless Road,432,-35,467,48,0,819100,-134500,953600,536192,2024.05.02
110,King Of Country Music,Ryan Larkins,365,-8,373,57,0,780200,-22000,802200,8839,2024.05.02
110,King Of Country Music,Ryan Larkins,365,-8,373,57,0,780200,-22000,802200,8839,2024.05.02
112,Wine Into Whiskey,Tucker Wetmore,234,43,191,23,0,760900,47600,713300,6789056,2024.05.02
112,Wine Into Whiskey,Tucker Wetmore,234,43,191,23,0,760900,47600,713300,6789056,2024.05.02
114,Single Again,Josh Ross,443,-21,464,67,0,753500,29600,723900,1878835,2024.05.02
114,Single Again,Josh Ross,443,-21,464,67,0,753500,29600,723900,1878835,2024.05.02
116,Country Back,Randy Houser,427,76,351,65,0,749500,91500,658000,96851,2024.05.02
116,Country Back,Randy Houser,427,76,351,65,0,749500,91500,658000,96851,2024.05.02
118,Make Me Wanna Smoke,Runaway June,407,26,381,44,0,723900,56900,667000,15479,2024.05.02
118,Make Me Wanna Smoke,Runaway June,407,26,381,44,0,723900,56900,667000,15479,2024.05.02
120,Break Mine,Brothers Osborne,199,136,63,62,0,576000,341800,234200,333230,2024.05.02
120,Break Mine,Brothers Osborne,199,136,63,62,0,576000,341800,234200,333230,2024.05.02
122,Dance Like No One’s Watching,Gabby Barrett,261,25,236,31,0,534300,109500,424800,1019866,2024.05.02
122,Dance Like No One’s Watching,Gabby Barrett,261,25,236,31,0,534300,109500,424800,1019866,2024.05.02
124,Spin You Around (1/24),Morgan Wallen,180,46,134,6,0,522700,54800,467900,6722964,2024.05.02
124,Spin You Around (1/24),Morgan Wallen,180,46,134,6,0,522700,54800,467900,6722964,2024.05.02
126,Things I Take For Granted,Larry Fleet,334,31,303,56,0,521800,-11800,533600,1618855,2024.05.02
126,Things I Take For Granted,Larry Fleet,334,31,303,56,0,521800,-11800,533600,1618855,2024.05.02
128,The Devil I Know,Ashley McBryde,331,23,308,40,0,516600,69400,447200,347211,2024.05.02
128,The Devil I Know,Ashley McBryde,331,23,308,40,0,516600,69400,447200,347211,2024.05.02
130,Good On You,Priscilla Block,270,33,237,40,0,479700,94600,385100,692710,2024.05.02
130,Good On You,Priscilla Block,270,33,237,40,0,479700,94600,385100,692710,2024.05.02
132,Neon Baby,Annie Bosko,291,32,259,38,0,478900,37400,441500,38530,2024.05.02
132,Neon Baby,Annie Bosko,291,32,259,38,0,478900,37400,441500,38530,2024.05.02
134,This Heart,Corey Kent,327,16,311,46,0,422200,-41100,463300,2242458,2024.05.02
134,This Heart,Corey Kent,327,16,311,46,0,422200,-41100,463300,2242458,2024.05.02
136,No Caller Id,Megan Moroney,145,16,129,8,0,372400,29300,343100,3759260,2024.05.02
136,No Caller Id,Megan Moroney,145,16,129,8,0,372400,29300,343100,3759260,2024.05.02
138,Devil You Know,Tyler Braden,193,60,133,23,0,313300,68000,245300,4803516,2024.05.02
138,Devil You Know,Tyler Braden,193,60,133,23,0,313300,68000,245300,4803516,2024.05.02
140,Roulette On The Heart,Conner Smith,236,164,72,45,0,292900,210600,82300,753429,2024.05.02
140,Roulette On The Heart,Conner Smith,236,164,72,45,0,292900,210600,82300,753429,2024.05.02
142,Sunshine Shine,Blanco Brown,57,57,0,56,0,289300,289300,0,65940,2024.05.02
142,Sunshine Shine,Blanco Brown,57,57,0,56,0,289300,289300,0,65940,2024.05.02
144,Young Man,Greylan James,44,8,36,3,0,279400,65700,213700,66271,2024.05.02
144,Young Man,Greylan James,44,8,36,3,0,279400,65700,213700,66271,2024.05.02
146,Damn Good Time,Jordan Davis,31,8,23,1,0,272800,74300,198500,195736,2024.05.02
146,Damn Good Time,Jordan Davis,31,8,23,1,0,272800,74300,198500,195736,2024.05.02
148,Hey Driver,Zach Bryan Feat. The War and Treaty,67,-8,75,5,0,186700,100,186600,6867344,2024.05.02
148,Hey Driver,Zach Bryan Feat. The War and Treaty,67,-8,75,5,0,186700,100,186600,6867344,2024.05.02
150,Wild Ones,Jessie Murph & Jelly Roll,55,6,49,13,0,185400,400,185000,10512920,2024.05.02
150,Wild Ones,Jessie Murph & Jelly Roll,55,6,49,13,0,185400,400,185000,10512920,2024.05.02
152,Color Up My World,"Hailey Whitters, Ben Rector",38,-1,39,38,0,183400,-4600,188000,106792,2024.05.02
152,Color Up My World,"Hailey Whitters, Ben Rector",38,-1,39,38,0,183400,-4600,188000,106792,2024.05.02
154,The Architect,Kacey Musgraves,120,27,93,60,0,176600,56300,120300,983019,2024.05.02
154,The Architect,Kacey Musgraves,120,27,93,60,0,176600,56300,120300,983019,2024.05.02
156,Checking In,For King & Country & Lee Brice,132,81,51,26,0,175600,131200,44400,197756,2024.05.02
156,Checking In,For King & Country & Lee Brice,132,81,51,26,0,175600,131200,44400,197756,2024.05.02
158,Jack And Diet Coke,Redferrin,43,2,41,3,0,168000,63100,104900,2186298,2024.05.02
158,Jack And Diet Coke,Redferrin,43,2,41,3,0,168000,63100,104900,2186298,2024.05.02
160,Everything I Need,Chayce Beckham,152,86,66,35,0,167000,96600,70400,118963,2024.05.02
160,Everything I Need,Chayce Beckham,152,86,66,35,0,167000,96600,70400,118963,2024.05.02
162,Hometown Home,Locash,29,10,19,9,0,159000,88600,70400,122714,2024.05.02
162,Hometown Home,Locash,29,10,19,9,0,159000,88600,70400,122714,2024.05.02
164,Wind Up Missin' You,Tucker Wetmore,34,31,3,2,0,148100,139000,9100,7505948,2024.05.02
164,Wind Up Missin' You,Tucker Wetmore,34,31,3,2,0,148100,139000,9100,7505948,2024.05.02
166,Wondering Why,Red Clay Strays,55,3,52,5,0,134400,30200,104200,5099136,2024.05.02
166,Wondering Why,Red Clay Strays,55,3,52,5,0,134400,30200,104200,5099136,2024.05.02
168,Two Night Stands,Kylie Morgan,125,6,119,20,0,126900,-8800,135700,162923,2024.05.02
168,Two Night Stands,Kylie Morgan,125,6,119,20,0,126900,-8800,135700,162923,2024.05.02
170,Million Little Bandaids,Caroline Jones,108,-116,224,18,0,102100,-162600,264700,103663,2024.05.02
170,Million Little Bandaids,Caroline Jones,108,-116,224,18,0,102100,-162600,264700,103663,2024.05.02
172,Pretty Good Living,Sarahbeth Taite,48,48,0,48,0,91500,91500,0,14967,2024.05.02
172,Take Me Home,Little Big Town,48,48,0,48,0,91500,91500,0,631713,2024.05.02
172,Pretty Good Living,Sarahbeth Taite,48,48,0,48,0,91500,91500,0,14967,2024.05.02
172,Take Me Home,Little Big Town,48,48,0,48,0,91500,91500,0,631713,2024.05.02
176,Man Upstairs,Tim Dugger,17,-3,20,1,0,86500,-17200,103700,23283,2024.05.02
176,Man Upstairs,Tim Dugger,17,-3,20,1,0,86500,-17200,103700,23283,2024.05.02
178,Jolene,Beyonce,36,0,36,1,0,85000,-19500,104500,3394953,2024.05.02
178,Jolene,Beyonce,36,0,36,1,0,85000,-19500,104500,3394953,2024.05.02
180,Work Boots,Cody Johnson,7,4,3,1,0,77500,45300,32200,327593,2024.05.02
180,Work Boots,Cody Johnson,7,4,3,1,0,77500,45300,32200,327593,2024.05.02
182,That's Texas,Cody Johnson,5,3,2,2,0,75000,59500,15500,327687,2024.05.02
182,That's Texas,Cody Johnson,5,3,2,2,0,75000,59500,15500,327687,2024.05.02
184,Strangers,Kameron Marlowe & Ella Langley,21,2,19,5,0,73500,17400,56100,660244,2024.05.02
184,Strangers,Kameron Marlowe & Ella Langley,21,2,19,5,0,73500,17400,56100,660244,2024.05.02
186,Coal,Dylan Gossett,20,1,19,3,0,71900,-7100,79000,5042488,2024.05.02
186,Coal,Dylan Gossett,20,1,19,3,0,71900,-7100,79000,5042488,2024.05.02
188,Holy Smokes,Bailey Zimmerman,21,-2,23,3,0,68200,-64200,132400,4579414,2024.05.02
188,Holy Smokes,Bailey Zimmerman,21,-2,23,3,0,68200,-64200,132400,4579414,2024.05.02
190,Ii Most Wanted,Beyonce & Miley Cyrus,43,-1,44,43,0,66000,-1800,67800,5282741,2024.05.02
190,Ii Most Wanted,Beyonce & Miley Cyrus,43,-1,44,43,0,66000,-1800,67800,5282741,2024.05.02
192,Broadway Girls,Lil Durk Feat. Morgan Wallen,15,3,12,2,0,63900,200,63700,4493282,2024.05.02
192,Broadway Girls,Lil Durk Feat. Morgan Wallen,15,3,12,2,0,63900,200,63700,4493282,2024.05.02
194,Paying For It,Levi Hummon,62,-3,65,10,0,59200,2300,56900,83473,2024.05.02
194,Paying For It,Levi Hummon,62,-3,65,10,0,59200,2300,56900,83473,2024.05.02
196,The Star-Spangled Banner,Chris Stapleton,13,6,7,12,0,58000,35200,22800,80439,2024.05.02
196,The Star-Spangled Banner,Chris Stapleton,13,6,7,12,0,58000,35200,22800,80439,2024.05.02
198,Dive,Luke Combs,4,2,2,1,0,57300,42900,14400,1416864,2024.05.02
198,Dive,Luke Combs,4,2,2,1,0,57300,42900,14400,1416864,2024.05.02
200,Pray All The Way Home,Austin Snell,23,2,21,3,0,55400,9000,46400,1030511,2024.05.02
200,Pray All The Way Home,Austin Snell,23,2,21,3,0,55400,9000,46400,1030511,2024.05.02
1,Tucson Too Late,Jordan Davis,7967,910,7057,144,0,30491500,3673500,26818000,2198173,2024.05.09
2,Back Then Right Now,Tyler Hubbard,7449,61,7388,144,0,27731400,532300,27199100,3017007,2024.05.09
3,Where It Ends,Bailey Zimmerman,7225,157,7068,144,0,27281900,1162300,26119600,7304416,2024.05.09
4,Outskirts,Sam Hunt,6442,-591,7033,142,0,27226300,-1862300,29088600,1635364,2024.05.09
5,Halfway To Hell,Jelly Roll,6404,406,5998,144,0,23899100,1537800,22361300,3155500,2024.05.09
6,Take Her Home,Kenny Chesney,6178,350,5828,144,0,23696100,886900,22809200,1765171,2024.05.09
7,Pretty Little Poison,Warren Zeiders,4562,-328,4890,140,0,18813200,-1079600,19892800,7156563,2024.05.09
8,Your Place,Ashley Cooke,5278,267,5011,144,0,18489200,562500,17926700,1878926,2024.05.09
9,Wildflowers And Wild Horses,Lainey Wilson,4107,-3012,7119,144,0,16058100,-8365000,24423100,6111979,2024.05.09
10,Let Your Boys Be Country,Jason Aldean,4395,211,4184,144,0,16035800,860100,15175700,2064758,2024.05.09
11,We Ride,Bryan Martin,4328,258,4070,144,0,15212700,1156700,14056000,4516860,2024.05.09
12,Fearless,Jackson Dean,4267,-11,4278,144,0,14835600,-399500,15235100,1071134,2024.05.09
13,We Don'T Fight Anymore,Carly Pearce,4185,-61,4246,144,0,13910800,-38000,13948800,2746332,2024.05.09
14,Young Love & Saturday Nights,Chris Young,3767,425,3342,143,0,13274200,1628700,11645500,1286800,2024.05.09
15,Bulletproof,Nate Smith,3731,318,3413,144,0,12960800,1308700,11652100,6756150,2024.05.09
16,Dirt Cheap,Cody Johnson,3326,453,2873,142,0,12359200,1914000,10445200,4759854,2024.05.09
17,Love You Again,Chase Matthew,3439,220,3219,141,0,10978400,367000,10611400,2539012,2024.05.09
18,I Had Some Help,Post Malone,2293,2293,0,142,0,10359000,10359000,0,0,2024.05.09
19,I'M Not Pretty,Megan Moroney,3071,68,3003,143,0,9613800,194300,9419500,2054188,2024.05.09
20,Cowgirls,Morgan Wallen,2402,529,1873,139,0,9608200,2319600,7288600,11071195,2024.05.09
21,Chevrolet,Dustin Lynch Feat. Jelly Roll,2636,311,2325,140,0,8736700,1202700,7534000,2126086,2024.05.09
22,Can't Break Up Now,Old Dominion,2846,-76,2922,144,0,8473900,-495300,8969200,1236227,2024.05.09
23,She's Somebody's Daughter,Drew Baldridge,2688,394,2294,136,0,8090300,1425200,6665100,459856,2024.05.09
24,One Bad Habit,Tim McGraw,2289,73,2216,144,0,6477500,655300,5822200,419421,2024.05.09
25,This Is My Dirt,Justin Moore,1884,159,1725,140,0,5275000,285900,4989100,535003,2024.05.09
26,Messed Up As Me,Keith Urban,1722,54,1668,136,0,5086700,784700,4302000,992717,2024.05.09
27,Dance With You,Brett Young,1703,-16,1719,134,0,4932900,167600,4765300,1553077,2024.05.09
28,Gonna Love You,Parmalee,1905,106,1799,139,0,4876900,132300,4744600,308381,2024.05.09
29,Rodeo Man,Garth Brooks & Ronnie Dunn,2058,101,1957,143,0,4853100,106400,4746700,1098467,2024.05.09
30,Miles On It,Marshmello & Kane Brown,1392,1389,3,109,0,4699500,4695800,3700,11266299,2024.05.09
31,Austin,Dasha,1333,266,1067,120,0,4582200,1009400,3572800,12947985,2024.05.09
32,"Love You, Miss You, Mean It",Luke Bryan,1445,194,1251,115,0,4481500,409800,4071700,2021343,2024.05.09
33,Drinkin' Problems,Dillon Carmichael,1710,-91,1801,142,0,4091700,-102300,4194000,44981,2024.05.09
34,Bigger Houses,Dan + Shay,1544,-16,1560,137,0,3982000,15000,3967000,1231690,2024.05.09
35,Tie Up,Zac Brown Band,982,73,909,85,0,3953100,244800,3708300,441407,2024.05.09
36,Sounds Like The Radio,Zach Top,1461,42,1419,135,0,3902400,200000,3702400,682654,2024.05.09
37,Wranglers,Miranda Lambert,1093,1093,0,109,0,3571000,3571000,0,3363768,2024.05.09
38,American Girl,Dierks Bentley,1203,103,1100,134,0,3293100,168100,3125000,603638,2024.05.09
39,Cowboy Songs,George Birge,1143,114,1029,119,0,3096400,426800,2669600,588545,2024.05.09
40,Called Crazy,Kassi Ashton,622,164,458,36,0,2754400,837300,1917100,71281,2024.05.09
41,A Bar Song (Tipsy),Shaboozey,569,338,231,58,0,2467000,1473700,993300,38229636,2024.05.09
42,Damn Good Day To Leave,Riley Green,887,111,776,110,0,2419300,434800,1984500,942210,2024.05.09
43,Find Another Bar,Chris Lane,1121,81,1040,108,0,2333600,186400,2147200,101545,2024.05.09
44,Boys Back Home,Dylan Marlowe Feat. Dylan Scott,953,51,902,97,0,2291300,263500,2027800,2797795,2024.05.09
45,Where That Came From,Randy Travis,413,413,0,80,0,2153700,2153700,0,2485571,2024.05.09
46,This Town's Been Too Good To Us,Dylan Scott,798,31,767,80,0,2070700,139300,1931400,2444904,2024.05.09
47,Breakin' In Boots,Matt Stell,1008,75,933,104,0,1996300,206400,1789900,929932,2024.05.09
48,Whatcha See Is Whatcha Get,Chris Janson,885,43,842,97,0,1921300,-19800,1941100,189963,2024.05.09
49,Forever To Me,Cole Swindell,573,33,540,73,0,1733500,-44700,1778200,1538994,2024.05.09
50,In Your Love,Tyler Childers,963,-93,1056,112,0,1678800,-92100,1770900,2735198,2024.05.09
51,Love You Back,Lady A,844,25,819,118,0,1671300,-49600,1720900,111787,2024.05.09
52,Think I’m In Love With You,Chris Stapleton,615,20,595,70,0,1657200,335500,1321700,5930224,2024.05.09
53,Drinkin' Buddies,"Lee Brice, Hailey Whitters, And Nate Smith",505,-574,1079,76,0,1654900,-3212800,4867700,1094848,2024.05.09
54,I Tried A Ring On,Tigirlily Gold,852,-25,877,96,0,1488900,16800,1472100,674383,2024.05.09
55,Life With You,Kelsey Hart,757,72,685,85,0,1425400,160400,1265000,2537664,2024.05.09
56,Friends Like That,John Morgan Feat. Jason Aldean,596,172,424,93,0,1354100,469000,885100,1237075,2024.05.09
57,I'm In Love,Hailey Whitters,617,-26,643,71,0,1269600,-22100,1291700,213929,2024.05.09
58,Last Rodeo,Restless Road,419,-13,432,48,0,877100,58000,819100,524206,2024.05.09
59,Break Mine,Brothers Osborne,337,138,199,90,0,845900,269900,576000,327062,2024.05.09
60,Country Back,Randy Houser,516,89,427,67,0,811100,61600,749500,74118,2024.05.09
61,Wine Into Whiskey,Tucker Wetmore,244,10,234,22,0,791000,30100,760900,6623697,2024.05.09
62,Single Again,Josh Ross,455,12,443,76,0,771500,18000,753500,1786803,2024.05.09
63,Make Me Wanna Smoke,Runaway June,420,13,407,44,0,769100,45200,723900,13208,2024.05.09
64,King Of Country Music,Ryan Larkins,414,49,365,62,0,752200,-28000,780200,9219,2024.05.09
65,The Devil I Know,Ashley McBryde,376,45,331,82,0,691400,174800,516600,337701,2024.05.09
66,Dance Like No One’s Watching,Gabby Barrett,307,46,261,31,0,647200,112900,534300,959566,2024.05.09
67,This Heart,Corey Kent,383,56,327,46,0,559900,137700,422200,2324034,2024.05.09
68,Good On You,Priscilla Block,258,-12,270,41,0,487200,7500,479700,636475,2024.05.09
69,Neon Baby,Annie Bosko,337,46,291,58,0,454600,-24300,478900,19953,2024.05.09
70,Things I Take For Granted,Larry Fleet,289,-45,334,46,0,430200,-91600,521800,1710237,2024.05.09
71,No Caller Id,Megan Moroney,152,7,145,7,0,403300,30900,372400,3680951,2024.05.09
72,Spin You Around (1/24),Morgan Wallen,139,-41,180,7,0,383700,-139000,522700,6431868,2024.05.09
73,Wind Up Missin' You,Tucker Wetmore,83,49,34,3,0,381500,233400,148100,6920417,2024.05.09
74,Young Man,Greylan James,57,13,44,4,0,368500,89100,279400,61813,2024.05.09
75,Roulette On The Heart,Conner Smith,283,47,236,43,0,365000,72100,292900,792507,2024.05.09
76,Damn Good Time,Jordan Davis,38,7,31,1,0,352800,80000,272800,200314,2024.05.09
77,Devil You Know,Tyler Braden,216,23,193,23,0,345200,31900,313300,4415144,2024.05.09
78,Everything I Need,Chayce Beckham,230,78,152,41,0,292200,125200,167000,263148,2024.05.09
79,Slow Burn,Brandon Ray,57,56,1,56,0,286400,275100,11300,1961,2024.05.09
80,Pay Me Back In Change,MacKenzie Porter,39,39,0,39,0,188000,188000,0,7131,2024.05.09
81,Color Up My World,"Hailey Whitters, Ben Rector",39,1,38,39,0,188000,4600,183400,92926,2024.05.09
82,Hometown Home,Locash,67,38,29,23,0,187900,28900,159000,111530,2024.05.09
83,Songs About Whiskey,Anne Wilson,58,54,4,49,0,162400,141600,20800,339510,2024.05.09
84,Two Night Stands,Kylie Morgan,131,6,125,20,0,156500,29600,126900,146114,2024.05.09
85,Pray All The Way Home,Austin Snell,55,32,23,14,0,152400,97000,55400,1027427,2024.05.09
86,Wondering Why,Red Clay Strays,50,-5,55,5,0,141900,7500,134400,5488957,2024.05.09
87,Strangers,Kameron Marlowe & Ella Langley,50,29,21,34,0,140300,66800,73500,697080,2024.05.09
88,Uh-huh (Ajá),Frank Ray,134,84,50,27,0,129600,90600,39000,76455,2024.05.09
89,Hey Driver,Zach Bryan Feat. The War and Treaty,54,-13,67,5,0,117500,-69200,186700,6289372,2024.05.09
90,Blackout Betty,Ashley McBryde,47,47,0,47,0,102700,102700,0,64286,2024.05.09
91,Jack And Diet Coke,Redferrin,31,-12,43,3,0,93200,-74800,168000,1770660,2024.05.09
92,Stealing A Kiss,The War And Treaty,48,48,0,48,0,91500,91500,0,35681,2024.05.09
92,2am In London,Morgan Wade,48,48,0,48,0,91500,91500,0,272622,2024.05.09
94,Straight Line,Keith Urban,47,47,0,47,0,90100,90100,0,478782,2024.05.09
95,Baby Daddy's Weekend,Elle King,82,62,20,16,0,84300,37300,47000,0,2024.05.09
96,Jolene,Beyonce,29,-7,36,1,0,80900,-4100,85000,2675092,2024.05.09
97,Liar,Jelly Roll,47,47,0,47,0,79600,79600,0,0,2024.05.09
97,Hell Of A Way To Go,Riley Green,47,47,0,47,0,79600,79600,0,30128,2024.05.09
97,Save Me,Jelly Roll,47,47,0,47,0,79600,79600,0,3118772,2024.05.09
97,Worst Way,Riley Green,47,47,0,47,0,79600,79600,0,2489051,2024.05.09
101,Johnny Moonshine,Maggie Antone,17,17,0,16,0,78600,78600,0,103294,2024.05.09
102,Man Upstairs,Tim Dugger,15,-2,17,1,0,74300,-12200,86500,22215,2024.05.09
103,Coal,Dylan Gossett,18,-2,20,2,0,64100,-7800,71900,4559111,2024.05.09
104,Broadway Girls,Lil Durk Feat. Morgan Wallen,12,-3,15,2,0,61700,-2200,63900,5549982,2024.05.09
105,Goodbye You,Landon Parker,68,51,17,17,0,59200,44400,14800,1148,2024.05.09
106,Heart They Didn'T Break,Maddie & Tae,45,-1,46,3,0,57000,7700,49300,251110,2024.05.09
107,Jesus Saves,Riley Green,11,2,9,1,0,53300,5600,47700,1223461,2024.05.09
108,Holy Smokes,Bailey Zimmerman,16,-5,21,2,0,51000,-17200,68200,4809014,2024.05.09
109,Dive,Luke Combs,5,1,4,1,0,48800,-8500,57300,1391090,2024.05.09
110,Summertime Blues,Zach Bryan,21,2,19,1,0,48600,-900,49500,607485,2024.05.09
111,Oklahoma Sooner,Jake Banfield,15,3,12,1,0,45700,7300,38400,4359,2024.05.09
112,Paying For It,Levi Hummon,52,-10,62,9,0,45000,-14200,59200,84249,2024.05.09
113,Lighten That Load,Waylon Hanel,51,51,0,17,0,44400,44400,0,1291,2024.05.09
114,Roots,Austin Burke,17,5,12,1,0,42500,-3000,45500,14855,2024.05.09
115,That's Texas,Cody Johnson,4,-1,5,1,0,41300,-33700,75000,313830,2024.05.09
116,The Architect,Kacey Musgraves,56,-64,120,12,0,39800,-136800,176600,941760,2024.05.09
117,The Star-Spangled Banner,Chris Stapleton,11,-2,13,9,0,38900,-19100,58000,81558,2024.05.09
118,Don't Think Jesus,Morgan Wallen,14,14,0,14,0,38500,38500,0,1049734,2024.05.09
119,Ii Most Wanted,Beyonce & Miley Cyrus,21,-22,43,21,0,37500,-28500,66000,4415513,2024.05.09
120,Million Little Bandaids,Caroline Jones,61,-47,108,14,0,34200,-67900,102100,53361,2024.05.09
121,How Is She,Cole Swindell,6,2,4,1,0,32400,-4800,37200,46777,2024.05.09
122,Open The Gate,Zach Bryan,3,1,2,1,0,30100,11400,18700,1869567,2024.05.09
123,Ghost In My Chevy,Carson Wallace,34,17,17,17,0,29600,14800,14800,10869,2024.05.09
124,Rain In The Rearview,Anne Wilson,39,-4,43,7,0,29100,-1000,30100,942404,2024.05.09
125,Am I The Only One,Aaron Lewis,6,-1,7,1,0,28700,8400,20300,643143,2024.05.09
126,Go Home W U,Keith Urban & Lainey Wilson,6,6,0,6,0,27300,27300,0,1971375,2024.05.09
127,Country House,Sam Hunt,10,-9,19,1,0,26600,-900,27500,642382,2024.05.09
128,Ain'T About You,Huntergirl,22,-22,44,6,0,25500,-23900,49400,14946,2024.05.09
129,I'M Gonna Miss Her,Post Malone,8,4,4,1,0,25200,12800,12400,2643015,2024.05.09
130,Running Out Of Time,Wyatt Flores,8,8,0,1,0,24800,24800,0,1029091,2024.05.09
131,Bury Me In This Bar,Dalton Dover,19,17,2,3,0,24100,12700,11400,53739,2024.05.09
132,Country's Cool Again,Lainey Wilson,12,-3,15,1,0,23800,-1500,25300,817086,2024.05.09
133,Never Been Over,Darius Rucker,4,-16,20,4,0,23400,-31600,55000,811697,2024.05.09
134,I Got A Problem,Drake Milligan,12,7,5,1,0,23300,6300,17000,54596,2024.05.09
135,Wild Ones,Jessie Murph & Jelly Roll,17,-38,55,3,0,22400,-163000,185400,10282941,2024.05.09
136,Would If I Could (Feat. Lainey Wilson),Ernest,9,-3,12,1,0,21200,-13600,34800,1835275,2024.05.09
137,Heart Of A Small Town,Tim Dugger,3,0,3,1,0,20800,-4000,24800,14069,2024.05.09
138,Sunrise,Morgan Wallen,6,6,0,3,0,20700,20700,0,3374803,2024.05.09
139,Buckles And Broken Hearts,Joe Peters,3,3,0,1,0,20600,20600,0,1108,2024.05.09
140,When My Baby's In Boots,Randall King,3,0,3,1,0,19600,-23100,42700,0,2024.05.09
141,This Side Of The Dirt,Neon Union,43,-11,54,7,0,19400,-34500,53900,27809,2024.05.09
142,Baby Do,Randall King,2,1,1,1,0,18700,5200,13500,17404,2024.05.09
143,Checking In,For King & Country & Lee Brice,3,-129,132,1,0,18400,-157200,175600,155783,2024.05.09
144,Days That End In Why,Morgan Wallen,5,0,5,2,0,17200,10200,7000,895466,2024.05.09
145,Any Given Friday Night,Luke Combs,2,0,2,1,0,16000,0,16000,241381,2024.05.09
146,Ain't That Some,Morgan Wallen,4,1,3,3,0,15800,300,15500,4828559,2024.05.09
147,My Baby Does,Drew Parker,2,1,1,1,0,15500,14600,900,2650,2024.05.09
148,Keith Whitley,Morgan Wallen,4,4,0,3,0,15100,15100,0,674819,2024.05.09
149,Single At The Same Time,Jake Worthington,1,1,0,1,0,14600,14600,0,8252,2024.05.09
150,Record High,Randall King,1,0,1,1,0,14600,10300,4300,25010,2024.05.09
151,Lucky,Megan Moroney,1,0,1,1,0,14600,0,14600,314485,2024.05.09
151,We Ain't The Only Ones,Randy Rogers & Wade Bowen,1,0,1,1,0,14600,0,14600,0,2024.05.09
153,Quittin' Time,Zach Bryan,2,0,2,1,0,14400,-1100,15500,1179391,2024.05.09
154,My God,Scotty Inman,2,1,1,2,0,14200,7500,6700,38140,2024.05.09
155,Oklahoma Smokeshow,Zach Bryan,4,4,0,1,0,13600,13600,0,6825880,2024.05.09
156,Whose Rearview,Jason Aldean,2,0,2,1,0,13600,200,13400,489945,2024.05.09
157,Give Me A Sunrise,Braxton Keith,1,-2,3,1,0,13500,-6100,19600,41361,2024.05.09
158,John Deere Green,"HIXTAPE Feat. HARDY, Morgan Wallen, Joe Diffie",2,1,1,2,0,13000,7500,5500,0,2024.05.09
159,Heaven On A Dirt Road,Jesse Felder,14,14,0,14,0,12000,12000,0,0,2024.05.09
160,Problems,12/Oc,7,2,5,1,0,12000,-1800,13800,1522,2024.05.09
161,Mansions,Sound Street,2,2,0,2,0,11900,11900,0,391,2024.05.09
162,Heart Attack,Boy Named Banjo,6,-1,7,1,0,11500,-10000,21500,3565,2024.05.09
163,Russell County Line,49 Winchester,10,4,6,1,0,11400,-1800,13200,410620,2024.05.09
164,Certified,Laura Bryna,19,3,16,1,0,11400,-3000,14400,4392,2024.05.09
165,My Place,Carly Pearce,2,2,0,2,0,11200,11200,0,156386,2024.05.09
166,Wings Of A Dove,Jonathan Wilburn,2,1,1,2,0,11100,6700,4400,0,2024.05.09
166,Come On In,Kingdom Heirs,2,1,1,2,0,11100,6700,4400,2169,2024.05.09
168,He Pilots My Ship,Tribute Quartet,2,0,2,2,0,11100,0,11100,895,2024.05.09
169,Me To Me,Morgan Wallen,4,4,0,2,0,10800,10800,0,916209,2024.05.09
170,Wine Country,Hannah Ellis,7,0,7,2,0,10700,2400,8300,14702,2024.05.09
171,Sun To Me,Zach Bryan,6,2,4,2,0,10600,1900,8700,6211903,2024.05.09
172,Dying Man,Morgan Wallen,1,1,0,1,0,10200,10200,0,1449068,2024.05.09
173,Born With A Beer In My Hand,Morgan Wallen,4,4,0,2,0,10100,10100,0,960913,2024.05.09
174,New Name Written Down In Glory,Avenue,1,1,0,1,0,9900,9900,0,82,2024.05.09
174,The Building,Emily Ann Roberts,1,1,0,1,0,9900,9900,0,40060,2024.05.09
176,"Salt, Lime & Tequila",Ryan Griffin,2,-2,4,1,0,9500,-100,9600,72051,2024.05.09
177,Decoration,Jillian Riscoe,5,0,5,1,0,9300,8300,1000,26,2024.05.09
178,Whiskey's Gonna Find Me,Jackson,3,-4,7,1,0,9200,-5200,14400,0,2024.05.09
179,Indifferent,Megan Moroney,2,2,0,1,0,9000,9000,0,4862200,2024.05.09
180,Hold,Michael Ray,1,1,0,1,0,8500,8500,0,114466,2024.05.09
181,Single Than She Was,Morgan Wallen,4,4,0,1,0,8400,8400,0,1001092,2024.05.09
182,Deeper Well,Kacey Musgraves,8,-11,19,2,0,8000,-22000,30000,2067525,2024.05.09
183,180 (Lifestyle),Morgan Wallen,3,3,0,1,0,7800,7800,0,1630759,2024.05.09
183,Neon Star (Country Boy Lullaby),Morgan Wallen,3,3,0,1,0,7800,7800,0,2115982,2024.05.09
185,Red Letter Blueprint,Scotty McCreery,1,1,0,1,0,7500,7500,0,88794,2024.05.09
185,O How I Love Jesus,Carrie Underwood,1,1,0,1,0,7500,7500,0,50893,2024.05.09
185,Gentle Shepherd,Ronnie Booth,1,1,0,1,0,7500,7500,0,1076,2024.05.09
185,Be The Reason,Steeles,1,1,0,1,0,7500,7500,0,573,2024.05.09
185,All Of My Help,Erwins,1,1,0,1,0,7500,7500,0,1243,2024.05.09
185,Living Water Bread Of Life,Ben Rochester Family,1,1,0,1,0,7500,7500,0,660,2024.05.09
185,Here Comes Jesus,Jeff & Sheri Easter,1,1,0,1,0,7500,7500,0,24584,2024.05.09
192,By Your Grace,Cody Johnson,1,0,1,1,0,7500,3100,4400,529301,2024.05.09
192,I'm So Blessed,CAIN,1,0,1,1,0,7500,3100,4400,802014,2024.05.09
194,Memories Of Home,Authentic Unlimited,1,0,1,1,0,7500,800,6700,2261,2024.05.09
195,You'll Always Be My Baby (Written For Daughters' Weddings),Alan Jackson,7,1,6,1,0,7000,-8600,15600,45631,2024.05.09
196,Fake Id,Sydney Mack,3,-1,4,1,0,7000,1700,5300,743,2024.05.09
197,Double Down,Cody Johnson,1,1,0,1,0,6800,6800,0,169297,2024.05.09
198,No Present LIke The Time,Jay Allen,16,-18,34,2,0,6800,-16200,23000,0,2024.05.09
199,Fall Into Place,Jeff & Sheri Easter,1,1,0,1,0,6700,6700,0,756,2024.05.09
199,There Is,Hyssongs,1,1,0,1,0,6700,6700,0,15,2024.05.09
199,When They Call My Name,Mark Trammell Quartet,1,1,0,1,0,6700,6700,0,5102,2024.05.09
199,Ready For The Change,Kingsmen Quartet,1,1,0,1,0,6700,6700,0,0,2024.05.09
199,Meet Me At The Cross,Brian Free & Assurance,1,1,0,1,0,6700,6700,0,4413,2024.05.09
199,Means Something To Me,Tate Emmons,1,1,0,1,0,6700,6700,0,480,2024.05.09
199,Let Me Be The Well,Kramers,1,1,0,1,0,6700,6700,0,848,2024.05.09
199,Dance,Karen Peck & New River,1,1,0,1,0,6700,6700,0,3525,2024.05.09
199,Unstoppable God,Kingsmen,1,1,0,1,0,6700,6700,0,6148,2024.05.09
199,Made A Mess,Tim Menzies,1,1,0,1,0,6700,6700,0,123,2024.05.09
199,Grace Will Lead You Home,Peach Goldman,1,1,0,1,0,6700,6700,0,0,2024.05.09
199,It Won't Be Long,Poet Voices,1,1,0,1,0,6700,6700,0,0,2024.05.09
199,After All,Mark Trammell Quartet,1,1,0,1,0,6700,6700,0,1855,2024.05.09
199,Standing Tall,Booth Brothers,1,1,0,1,0,6700,6700,0,460,2024.05.09
199,Looks Like Jesus,Brian Free & Assurance,1,1,0,1,0,6700,6700,0,912,2024.05.09
199,Peace Is,Sound,1,1,0,1,0,6700,6700,0,1210,2024.05.09
199,The Day I Get Home,Kelly Garner,1,1,0,1,0,6700,6700,0,248,2024.05.09
199,I'Ll See You In The Morning,Sweetwater Revival,1,1,0,1,0,6700,6700,0,1,2024.05.09
217,Pb&J,Todd Tilghman,1,0,1,1,0,6700,6300,400,152,2024.05.09
218,There Is A Name,LeFevre Quartet,1,0,1,1,0,6700,0,6700,773,2024.05.09
218,Two Or Three,Collingsworth Family,1,0,1,1,0,6700,0,6700,9404,2024.05.09
218,Help Is On The Way,Gold City,1,0,1,1,0,6700,0,6700,21672,2024.05.09
218,Up,Westward Road,1,0,1,1,0,6700,0,6700,18,2024.05.09
218,Heading In A New Direction,Elaine Roy,1,0,1,1,0,6700,0,6700,0,2024.05.09
218,Higher Ground,Annie Bosko,1,0,1,1,0,6700,0,6700,0,2024.05.09
218,Your Healing Is On The Way,Greater Vision,1,0,1,1,0,6700,0,6700,1006,2024.05.09
218,Front Porch Sittin',Zane & Donna King,1,0,1,1,0,6700,0,6700,0,2024.05.09
1,Back Then Right Now,Tyler Hubbard,7983,534,7449,144,0,29482100,1750700,27731400,2880663,2024.05.16
2,Tucson Too Late,Jordan Davis,7274,-693,7967,144,0,28410200,-2081300,30491500,2301910,2024.05.16
3,Where It Ends,Bailey Zimmerman,7420,195,7225,144,0,28221200,939300,27281900,7790337,2024.05.16
4,Outskirts,Sam Hunt,6175,-267,6442,142,0,25879300,-1347000,27226300,1692462,2024.05.16
5,Halfway To Hell,Jelly Roll,6841,437,6404,144,0,25239200,1340100,23899100,3790176,2024.05.16
6,Take Her Home,Kenny Chesney,6496,318,6178,144,0,24218100,522000,23696100,1692108,2024.05.16
7,Your Place,Ashley Cooke,5602,324,5278,144,0,19354700,865500,18489200,2005022,2024.05.16
8,Let Your Boys Be Country,Jason Aldean,4532,137,4395,144,0,16359300,323500,16035800,1817582,2024.05.16
9,I Had Some Help,Post Malone,3581,1288,2293,138,0,15767500,5408500,10359000,77133834,2024.05.16
10,We Ride,Bryan Martin,4432,104,4328,144,0,15475300,262600,15212700,4744314,2024.05.16
11,Fearless,Jackson Dean,4634,367,4267,144,0,15340000,504400,14835600,1024391,2024.05.16
12,Bulletproof,Nate Smith,4203,472,3731,144,0,15140800,2180000,12960800,7160132,2024.05.16
13,Young Love & Saturday Nights,Chris Young,4133,366,3767,144,0,14723100,1448900,13274200,1726457,2024.05.16
14,Dirt Cheap,Cody Johnson,3641,315,3326,143,0,13894600,1535400,12359200,4684590,2024.05.16
15,We Don'T Fight Anymore,Carly Pearce,4234,49,4185,144,0,13635500,-275300,13910800,2806754,2024.05.16
16,Cowgirls,Morgan Wallen,3011,609,2402,138,0,11664100,2055900,9608200,11910114,2024.05.16
17,Love You Again,Chase Matthew,3646,207,3439,141,0,11249500,271100,10978400,2528094,2024.05.16
18,I'M Not Pretty,Megan Moroney,3224,153,3071,143,0,10231400,617600,9613800,2021409,2024.05.16
19,Chevrolet,Dustin Lynch Feat. Jelly Roll,2949,313,2636,140,0,10050900,1314200,8736700,2333836,2024.05.16
20,She's Somebody's Daughter,Drew Baldridge,3030,342,2688,138,0,9850300,1760000,8090300,487197,2024.05.16
21,Beautiful As You,Thomas Rhett,2075,2072,3,126,0,9098700,9094500,4200,4620101,2024.05.16
22,Can't Break Up Now,Old Dominion,2864,18,2846,144,0,8440300,-33600,8473900,1335060,2024.05.16
23,Hang Tight Honey,Lainey Wilson,1525,1525,0,108,0,7029100,7029100,0,842960,2024.05.16
24,One Bad Habit,Tim McGraw,2529,240,2289,144,0,6835200,357700,6477500,449965,2024.05.16
25,This Is My Dirt,Justin Moore,2002,118,1884,141,0,5787800,512800,5275000,574513,2024.05.16
26,Dance With You,Brett Young,1802,99,1703,134,0,5219200,286300,4932900,1495531,2024.05.16
27,Messed Up As Me,Keith Urban,1816,94,1722,136,0,5029700,-57000,5086700,1010383,2024.05.16
28,Rodeo Man,Garth Brooks & Ronnie Dunn,2134,76,2058,143,0,4883800,30700,4853100,1158269,2024.05.16
29,Gonna Love You,Parmalee,1855,-50,1905,141,0,4828100,-48800,4876900,367608,2024.05.16
30,Austin,Dasha,1285,-48,1333,88,0,4627900,45700,4582200,13363380,2024.05.16
31,"Love You, Miss You, Mean It",Luke Bryan,1474,29,1445,124,0,4572800,91300,4481500,2638810,2024.05.16
32,Drinkin' Problems,Dillon Carmichael,1678,-32,1710,139,0,4154000,62300,4091700,47773,2024.05.16
33,Sounds Like The Radio,Zach Top,1542,81,1461,132,0,3999100,96700,3902400,670571,2024.05.16
34,Tie Up,Zac Brown Band,976,-6,982,89,0,3911200,-41900,3953100,558239,2024.05.16
35,Bigger Houses,Dan + Shay,1541,-3,1544,138,0,3801400,-180600,3982000,1416837,2024.05.16
36,American Girl,Dierks Bentley,1294,91,1203,135,0,3618500,325400,3293100,588108,2024.05.16
37,A Bar Song (Tipsy),Shaboozey,1032,463,569,109,0,3553800,1086800,2467000,41339715,2024.05.16
38,Cowboy Songs,George Birge,1105,-38,1143,110,0,3032600,-63800,3096400,601701,2024.05.16
39,Called Crazy,Kassi Ashton,667,45,622,39,0,2980900,226500,2754400,73674,2024.05.16
40,Find Another Bar,Chris Lane,1182,61,1121,130,0,2436000,102400,2333600,115325,2024.05.16
41,Boys Back Home,Dylan Marlowe Feat. Dylan Scott,933,-20,953,99,0,2415000,123700,2291300,2755059,2024.05.16
42,Damn Good Day To Leave,Riley Green,814,-73,887,87,0,2296000,-123300,2419300,1274856,2024.05.16
43,Miles On It,Marshmello & Kane Brown,826,-566,1392,103,0,2128500,-2571000,4699500,13425783,2024.05.16
44,This Town's Been Too Good To Us,Dylan Scott,829,31,798,88,0,2090300,19600,2070700,2710038,2024.05.16
45,Breakin' In Boots,Matt Stell,994,-14,1008,109,0,2053000,56700,1996300,1024669,2024.05.16
46,Forever To Me,Cole Swindell,606,33,573,72,0,1821800,88300,1733500,1419808,2024.05.16
47,Whatcha See Is Whatcha Get,Chris Janson,850,-35,885,100,0,1816000,-105300,1921300,202084,2024.05.16
48,Think I’m In Love With You,Chris Stapleton,654,39,615,77,0,1788600,131400,1657200,6314613,2024.05.16
49,Drinkin' Buddies,"Lee Brice, Hailey Whitters, And Nate Smith",525,20,505,87,0,1733300,78400,1654900,1090532,2024.05.16
50,Love You Back,Lady A,822,-22,844,118,0,1701200,29900,1671300,123169,2024.05.16
51,Life With You,Kelsey Hart,791,34,757,85,0,1443000,17600,1425400,2316355,2024.05.16
52,Friends Like That,John Morgan Feat. Jason Aldean,595,-1,596,67,0,1403000,48900,1354100,887394,2024.05.16
53,I Tried A Ring On,Tigirlily Gold,837,-15,852,97,0,1379900,-109000,1488900,767265,2024.05.16
54,Wranglers,Miranda Lambert,539,-554,1093,70,0,1337600,-2233400,3571000,2153841,2024.05.16
55,I'm In Love,Hailey Whitters,608,-9,617,72,0,1260900,-8700,1269600,212922,2024.05.16
56,Single Again,Josh Ross,457,2,455,69,0,833000,61500,771500,2409801,2024.05.16
57,King Of Country Music,Ryan Larkins,402,-12,414,66,0,788200,36000,752200,9751,2024.05.16
58,Country Back,Randy Houser,501,-15,516,68,0,780200,-30900,811100,98857,2024.05.16
59,Wine Into Whiskey,Tucker Wetmore,246,2,244,23,0,780100,-10900,791000,6660749,2024.05.16
60,Make Me Wanna Smoke,Runaway June,413,-7,420,45,0,762400,-6700,769100,13601,2024.05.16
61,Last Rodeo,Restless Road,380,-39,419,45,0,741600,-135500,877100,497130,2024.05.16
62,Dance Like No One’s Watching,Gabby Barrett,331,24,307,32,0,654100,6900,647200,921550,2024.05.16
63,The Devil I Know,Ashley McBryde,341,-35,376,42,0,557800,-133600,691400,357278,2024.05.16
64,Break Mine,Brothers Osborne,267,-70,337,34,0,526400,-319500,845900,385505,2024.05.16
65,This Heart,Corey Kent,372,-11,383,47,0,524800,-35100,559900,2028651,2024.05.16
66,Spin You Around (1/24),Morgan Wallen,134,-5,139,6,0,490400,106700,383700,6969464,2024.05.16
67,Roulette On The Heart,Conner Smith,292,9,283,45,0,449300,84300,365000,918421,2024.05.16
68,Good On You,Priscilla Block,279,21,258,41,0,439300,-47900,487200,860783,2024.05.16
69,Things I Take For Granted,Larry Fleet,281,-8,289,44,0,436700,6500,430200,1389034,2024.05.16
70,Neon Baby,Annie Bosko,366,29,337,49,0,405900,-48700,454600,19244,2024.05.16
71,I Ain'T A Cowgirl,Tiera Kennedy,105,105,0,57,0,387000,387000,0,53304,2024.05.16
72,No Caller Id,Megan Moroney,147,-5,152,7,0,382000,-21300,403300,4022876,2024.05.16
73,Everything I Need,Chayce Beckham,267,37,230,42,0,348200,56000,292200,242426,2024.05.16
74,Hometown Home,Locash,146,79,67,37,0,298300,110400,187900,174064,2024.05.16
75,Devil You Know,Tyler Braden,218,2,216,27,0,277100,-68100,345200,4851631,2024.05.16
76,Pray All The Way Home,Austin Snell,109,54,55,20,0,220000,67600,152400,1072342,2024.05.16
77,Uh-huh (Ajá),Frank Ray,196,62,134,32,0,206300,76700,129600,88455,2024.05.16
78,Floating In The Night,Judah & The Lion,48,48,0,47,0,203000,203000,0,262393,2024.05.16
79,Wind Up Missin' You,Tucker Wetmore,52,-31,83,3,0,201600,-179900,381500,7212976,2024.05.16
80,Long Dark Night,Judah & The Lion,47,47,0,47,0,201400,201400,0,246057,2024.05.16
81,Two Night Stands,Kylie Morgan,136,5,131,23,0,156700,200,156500,144685,2024.05.16
82,Bury Me In This Bar,Dalton Dover,92,73,19,20,0,150500,126400,24100,56414,2024.05.16
83,How Is She,Cole Swindell,17,11,6,1,0,120100,87700,32400,44158,2024.05.16
84,Hey Driver,Zach Bryan Feat. The War and Treaty,46,-8,54,3,0,110800,-6700,117500,6934175,2024.05.16
85,Songs About Whiskey,Anne Wilson,16,-42,58,2,0,110700,-51700,162400,318085,2024.05.16
86,Baby Daddy's Weekend,Elle King,112,30,82,19,0,104600,20300,84300,0,2024.05.16
87,Now That I Found You,Terri Clark,48,48,0,48,0,91500,91500,0,34509,2024.05.16
87,Pretty Good Living,Sarahbeth Taite,48,48,0,48,0,91500,91500,0,10916,2024.05.16
89,Wondering Why,Red Clay Strays,38,-12,50,5,0,85900,-56000,141900,5807282,2024.05.16
90,Man Upstairs,Tim Dugger,16,1,15,1,0,80200,5900,74300,19899,2024.05.16
91,Where That Came From,Randy Travis,26,-387,413,12,0,78400,-2075300,2153700,1730349,2024.05.16
92,Jolene,Beyonce,25,-4,29,1,0,76400,-4500,80900,2373331,2024.05.16
93,Young Man,Greylan James,26,-31,57,4,0,69500,-299000,368500,52357,2024.05.16
94,Ii Most Wanted,Beyonce & Miley Cyrus,44,23,21,44,0,67800,30300,37500,3767456,2024.05.16
95,Jack And Diet Coke,Redferrin,20,-11,31,3,0,63300,-29900,93200,1901462,2024.05.16
96,Strangers,Kameron Marlowe & Ella Langley,19,-31,50,4,0,58800,-81500,140300,851270,2024.05.16
97,The Star-Spangled Banner,Chris Stapleton,11,0,11,10,0,55000,16100,38900,85696,2024.05.16
98,Ol' Church Hymn,Darius Rucker Feat. Chapel Hart,9,9,0,9,0,54600,54600,0,29261,2024.05.16
99,Paying For It,Levi Hummon,51,-1,52,8,0,51400,6400,45000,82444,2024.05.16
100,Damn Good Time,Jordan Davis,5,-33,38,1,0,51100,-301700,352800,219227,2024.05.16
101,Running Out Of Time,Wyatt Flores,15,7,8,1,0,48500,23700,24800,789256,2024.05.16
102,Heaven On A Dirt Road,Jesse Felder,51,37,14,17,0,44400,32400,12000,0,2024.05.16
103,Goodbye You,Landon Parker,51,-17,68,17,0,44400,-14800,59200,1311,2024.05.16
104,Summertime Blues,Zach Bryan,19,-2,21,1,0,42800,-5800,48600,658547,2024.05.16
105,Worst Way,Riley Green,8,-39,47,1,0,42100,-37500,79600,2505073,2024.05.16
106,Dive,Luke Combs,3,-2,5,1,0,40500,-8300,48800,1589923,2024.05.16
107,Fall Of Summer,Scotty McCreery,7,7,0,4,0,38400,38400,0,788586,2024.05.16
108,Coal,Dylan Gossett,15,-3,18,1,0,38000,-26100,64100,4300602,2024.05.16
109,Country House,Sam Hunt,14,4,10,10,0,36500,9900,26600,541144,2024.05.16
110,The Architect,Kacey Musgraves,38,-18,56,8,0,36500,-3300,39800,1032956,2024.05.16
111,Heart They Didn'T Break,Maddie & Tae,26,-19,45,2,0,36500,-20500,57000,248337,2024.05.16
112,Broadway Girls,Lil Durk Feat. Morgan Wallen,9,-3,12,2,0,35700,-26000,61700,6339452,2024.05.16
113,Holy Smokes,Bailey Zimmerman,13,-3,16,2,0,35300,-15700,51000,4775954,2024.05.16
114,This Side Of The Dirt,Neon Union,34,-9,43,7,0,34800,15400,19400,30204,2024.05.16
115,Country's Cool Again,Lainey Wilson,14,2,12,2,0,33200,9400,23800,867038,2024.05.16
116,Lighten That Load,Waylon Hanel,34,-17,51,17,0,29600,-14800,44400,1157,2024.05.16
117,Oklahoma Sooner,Jake Banfield,11,-4,15,1,0,29500,-16200,45700,2717,2024.05.16
118,I Got A Problem,Drake Milligan,12,0,12,1,0,27500,4200,23300,55211,2024.05.16
119,Work Boots,Cody Johnson,2,0,2,1,0,25900,20900,5000,286671,2024.05.16
120,Roots,Austin Burke,16,-1,17,1,0,25900,-16600,42500,17826,2024.05.16
121,Leave You Alone,Kane Brown,6,6,0,6,0,25200,25200,0,248900,2024.05.16
122,Jesus Saves,Riley Green,5,-6,11,1,0,21700,-31600,53300,935407,2024.05.16
123,Would If I Could (Feat. Lainey Wilson),Ernest,9,0,9,1,0,21400,200,21200,1460124,2024.05.16
124,Ain't That Some,Morgan Wallen,3,-1,4,3,0,21100,5300,15800,5465484,2024.05.16
125,Million Little Bandaids,Caroline Jones,34,-27,61,6,0,21100,-13100,34200,40254,2024.05.16
126,Things I Never Told You,Parker Mccollum,4,4,0,4,0,20600,20600,0,154299,2024.05.16
127,Am I The Only One,Aaron Lewis,6,0,6,1,0,19100,-9600,28700,646628,2024.05.16
128,Long Live Cowgirls,Ian Munsick & Cody Johnson,13,2,11,3,0,17800,12300,5500,848623,2024.05.16
129,Steady Heart,Kameron Marlowe,4,3,1,4,0,17400,14100,3300,342593,2024.05.16
130,Porch,Scotty McCreery,4,4,0,4,0,16700,16700,0,275360,2024.05.16
131,Does Heaven Have A Creek,Elvie Shane,4,3,1,4,0,16700,12800,3900,73475,2024.05.16
132,Fall Into Place,Jeff & Sheri Easter,2,1,1,2,0,16600,9900,6700,797,2024.05.16
133,5 Leaf Clover,Luke Combs,3,3,0,1,0,16200,16200,0,2032814,2024.05.16
134,Wild Ones,Jessie Murph & Jelly Roll,11,-6,17,1,0,15700,-6700,22400,10237208,2024.05.16
135,Give Me A Sunrise,Braxton Keith,2,1,1,1,0,15500,2000,13500,41818,2024.05.16
136,State You Left Me In,Jake Worthington,2,0,2,1,0,15500,10500,5000,14923,2024.05.16
137,You In A Honky Tonk,Randall King,2,0,2,1,0,15500,9700,5800,334422,2024.05.16
138,Quittin' Time,Zach Bryan,2,0,2,1,0,15500,1100,14400,1252832,2024.05.16
139,When My Baby's In Boots,Randall King,2,-1,3,1,0,15500,-4100,19600,0,2024.05.16
140,Ghost In My Chevy,Carson Wallace,17,-17,34,17,0,14800,-14800,29600,11735,2024.05.16
141,Revival Broke Out,Gaither Vocal Band,2,2,0,2,0,14200,14200,0,1459,2024.05.16
142,Star Spangled Banner,Mickey Guyton,3,1,2,3,0,14000,9200,4800,0,2024.05.16
143,Ain'T About You,Huntergirl,17,-5,22,3,0,13900,-11600,25500,14424,2024.05.16
144,Whose Rearview,Jason Aldean,2,0,2,1,0,13600,0,13600,494309,2024.05.16
145,Sun To Me,Zach Bryan,12,6,6,2,0,12900,2300,10600,6263422,2024.05.16
146,That's Texas,Cody Johnson,2,-2,4,1,0,12200,-29100,41300,330459,2024.05.16
147,Heatin' Things Up,Josh Turner,1,1,0,1,0,11600,11600,0,396252,2024.05.16
148,Help Is On The Way,Gold City,2,1,1,2,0,11100,4400,6700,21852,2024.05.16
149,Certified,Laura Bryna,16,-3,19,1,0,11100,-300,11400,5669,2024.05.16
150,Forward,Niia,1,1,0,1,0,10600,10600,0,187,2024.05.16
151,Sunday Sermons,Anne Wilson,1,1,0,1,0,9900,9900,0,581715,2024.05.16
152,Means Something To Me,Tate Emmons,1,0,1,1,0,9900,3200,6700,531,2024.05.16
153,Red Letter Blueprint,Scotty McCreery,1,0,1,1,0,9900,2400,7500,132574,2024.05.16
153,Be The Reason,Steeles,1,0,1,1,0,9900,2400,7500,833,2024.05.16
155,Mansions,Sound Street,1,-1,2,1,0,9900,-2000,11900,649,2024.05.16
156,My God,Scotty Inman,1,-1,2,1,0,9900,-4300,14200,41985,2024.05.16
157,The Good I'Ll Do,Zach Bryan,2,0,2,1,0,9800,3700,6100,2956885,2024.05.16
158,You'll Always Be My Baby (Written For Daughters' Weddings),Alan Jackson,5,-2,7,1,0,9800,2800,7000,48629,2024.05.16
159,'98 Braves,Morgan Wallen,1,0,1,1,0,9400,4000,5400,2231061,2024.05.16
160,Go Home W U,Keith Urban & Lainey Wilson,3,-3,6,1,0,8300,-19000,27300,1258056,2024.05.16
161,Any Given Friday Night,Luke Combs,1,-1,2,1,0,8000,-8000,16000,254156,2024.05.16
162,Oklahoma Smokeshow,Zach Bryan,2,-2,4,1,0,8000,-5600,13600,7064492,2024.05.16
163,Problems,12/Oc,4,-3,7,1,0,7900,-4100,12000,1519,2024.05.16
164,I'Ve Seen Me Do It,Joe Peters,1,0,1,1,0,7800,4900,2900,429,2024.05.16
165,Do It For You,Jason Crabb,1,1,0,1,0,7500,7500,0,4260,2024.05.16
165,My Jesus,Anne Wilson,1,1,0,1,0,7500,7500,0,1518029,2024.05.16
165,Nothing But The Blood Of Jesus,Carrie Underwood,1,1,0,1,0,7500,7500,0,86560,2024.05.16
168,Meet Me At The Cross,Brian Free & Assurance,1,0,1,1,0,7500,800,6700,4799,2024.05.16
169,Here Comes Jesus,Jeff & Sheri Easter,1,0,1,1,0,7500,0,7500,21896,2024.05.16
170,Come On In,Kingdom Heirs,1,-1,2,1,0,7500,-3600,11100,2248,2024.05.16
171,Checking In,For King & Country & Lee Brice,1,-2,3,1,0,7500,-10900,18400,143767,2024.05.16
172,Sunrise Tells The Story,Midland,2,1,1,2,0,7400,6500,900,154988,2024.05.16
173,Heart Of A Small Town,Tim Dugger,1,-2,3,1,0,7400,-13400,20800,15326,2024.05.16
174,Whatever Gets You Through It,Morgan Gruber,5,2,3,1,0,7000,3300,3700,163,2024.05.16
175,"I, John",Blackwood Brothers Quartet,1,1,0,1,0,6700,6700,0,38,2024.05.16
175,Wasted Words,Craguns,1,1,0,1,0,6700,6700,0,61,2024.05.16
175,When I Lift Up My Head,High Road,1,1,0,1,0,6700,6700,0,1783,2024.05.16
175,Part Of The Family,Littles,1,1,0,1,0,6700,6700,0,0,2024.05.16
175,Sheaves (Dedicated To Isabel),Karen Peck & New River,1,1,0,1,0,6700,6700,0,4229,2024.05.16
175,Cross Over,Allens,1,1,0,1,0,6700,6700,0,20,2024.05.16
175,Breaking Boundaries,Sunday Drive,1,1,0,1,0,6700,6700,0,743,2024.05.16
175,In God's Time,Jordan Family Band,1,1,0,1,0,6700,6700,0,2916,2024.05.16
175,Joy Unspeakable,Kim Hopper,1,1,0,1,0,6700,6700,0,171,2024.05.16
175,"Ever Present, Ever Faithful",Jim & Melissa Brady,1,1,0,1,0,6700,6700,0,3157,2024.05.16
175,Waiting For Me,Truesong,1,1,0,1,0,6700,6700,0,818,2024.05.16
175,The First Song,Gordon Mote,1,1,0,1,0,6700,6700,0,445,2024.05.16
175,Be Ready,Karen Peck & New River,1,1,0,1,0,6700,6700,0,0,2024.05.16
175,I'M So Blessed,Regals,1,1,0,1,0,6700,6700,0,4,2024.05.16
175,Momma's Wall Of Fame,Michael Lusk,1,1,0,1,0,6700,6700,0,0,2024.05.16
175,Hardwood Church Pew,Kendricks,1,1,0,1,0,6700,6700,0,1,2024.05.16
175,We Are The Church,Ernie Haase & Signature Sound,1,1,0,1,0,6700,6700,0,17585,2024.05.16
192,There's A Song For That,Down East Boys,1,0,1,1,0,6700,6300,400,2637,2024.05.16
193,Peace Is,Sound,1,0,1,1,0,6700,0,6700,1193,2024.05.16
193,Unstoppable God,Kingsmen,1,0,1,1,0,6700,0,6700,6686,2024.05.16
193,Made A Mess,Tim Menzies,1,0,1,1,0,6700,0,6700,89,2024.05.16
193,Standing Tall,Booth Brothers,1,0,1,1,0,6700,0,6700,321,2024.05.16
193,Front Porch Sittin',Zane & Donna King,1,0,1,1,0,6700,0,6700,0,2024.05.16
193,Your Healing Is On The Way,Greater Vision,1,0,1,1,0,6700,0,6700,810,2024.05.16
193,Pb&J,Todd Tilghman,1,0,1,1,0,6700,0,6700,208,2024.05.16
200,The Building,Emily Ann Roberts,1,0,1,1,0,6700,-3200,9900,34563,2024.05.16
1,Where It Ends,Bailey Zimmerman,8593,1119,7474,145,0,33325600,5100100,28225500,7710584,2024.05.23
2,Halfway To Hell,Jelly Roll,7200,301,6899,145,0,26966900,1722900,25244000,4438935,2024.05.23
3,Back Then Right Now,Tyler Hubbard,6926,-1113,8039,145,0,25894700,-3587400,29482100,3196241,2024.05.23
4,Take Her Home,Kenny Chesney,6783,235,6548,145,0,25404100,1186000,24218100,1714363,2024.05.23
5,Outskirts,Sam Hunt,6071,-158,6229,141,0,25206500,-677100,25883600,1620708,2024.05.23
6,Tucson Too Late,Jordan Davis,6110,-1218,7328,142,0,23922800,-4487400,28410200,2267047,2024.05.23
7,Your Place,Ashley Cooke,5997,358,5639,145,0,21289400,1930400,19359000,1997138,2024.05.23
8,I Had Some Help,Post Malone,4901,1298,3603,144,0,19426400,3658900,15767500,55870923,2024.05.23
9,Let Your Boys Be Country,Jason Aldean,5013,444,4569,145,0,17672000,1312200,16359800,2003600,2024.05.23
10,We Ride,Bryan Martin,5034,579,4455,145,0,17634600,2155000,15479600,4751018,2024.05.23
11,Bulletproof,Nate Smith,4728,515,4213,145,0,17407400,2261800,15145600,8824873,2024.05.23
12,Young Love & Saturday Nights,Chris Young,4439,286,4153,145,0,16260000,1532600,14727400,1863501,2024.05.23
13,Dirt Cheap,Cody Johnson,4169,526,3643,144,0,15276500,1377600,13898900,5709899,2024.05.23
14,Cowgirls,Morgan Wallen,3750,716,3034,143,0,14858900,3190500,11668400,12411023,2024.05.23
15,We Don'T Fight Anymore,Carly Pearce,4258,1,4257,145,0,13540700,-99600,13640300,2804314,2024.05.23
16,Love You Again,Chase Matthew,3846,180,3666,143,0,12076600,827100,11249500,2547967,2024.05.23
17,Chevrolet,Dustin Lynch Feat. Jelly Roll,3060,54,3006,142,0,10904100,848900,10055200,2414852,2024.05.23
18,She's Somebody's Daughter,Drew Baldridge,3232,198,3034,139,0,10630900,780600,9850300,481590,2024.05.23
19,I'M Not Pretty,Megan Moroney,3313,77,3236,144,0,10527700,296300,10231400,2121988,2024.05.23
20,Can't Break Up Now,Old Dominion,2654,-218,2872,144,0,7652400,-787900,8440300,1287030,2024.05.23
21,One Bad Habit,Tim McGraw,2631,98,2533,145,0,7420500,580000,6840500,479444,2024.05.23
22,Ain't No Love In Oklahoma (From Twisters: The Album),Luke Combs,1767,1767,0,141,0,7389100,7389100,0,14992104,2024.05.23
23,This Is My Dirt,Justin Moore,2102,99,2003,143,0,6379100,591300,5787800,613839,2024.05.23
24,Messed Up As Me,Keith Urban,1892,74,1818,138,0,5507700,473200,5034500,1500476,2024.05.23
25,Dance With You,Brett Young,1850,35,1815,137,0,5343400,123700,5219700,1488316,2024.05.23
26,Hang Tight Honey,Lainey Wilson,1341,-184,1525,125,0,5312400,-1716700,7029100,3377540,2024.05.23
27,"Love You, Miss You, Mean It",Luke Bryan,1593,97,1496,127,0,5176300,598700,4577600,2526452,2024.05.23
28,Gonna Love You,Parmalee,1851,-11,1862,142,0,5085200,257100,4828100,324143,2024.05.23
29,Rodeo Man,Garth Brooks & Ronnie Dunn,2062,-82,2144,144,0,4916700,32900,4883800,1158934,2024.05.23
30,Austin,Dasha,1466,172,1294,127,0,4882900,255000,4627900,12839834,2024.05.23
31,A Bar Song (Tipsy),Shaboozey,1358,318,1040,130,0,4539100,985300,3553800,39212868,2024.05.23
32,Bigger Houses,Dan + Shay,1819,266,1553,139,0,4432000,630100,3801900,1402795,2024.05.23
33,Drinkin' Problems,Dillon Carmichael,1822,143,1679,140,0,4285900,131900,4154000,49144,2024.05.23
34,Sounds Like The Radio,Zach Top,1564,21,1543,132,0,4078700,75300,4003400,553284,2024.05.23
35,Tie Up,Zac Brown Band,1004,28,976,100,0,3986600,75400,3911200,567268,2024.05.23
36,Beautiful As You,Thomas Rhett,1120,-958,2078,107,0,3558700,-5540000,9098700,4133216,2024.05.23
37,American Girl,Dierks Bentley,1238,-65,1303,134,0,3551800,-71000,3622800,601318,2024.05.23
38,Cowboy Songs,George Birge,1284,179,1105,125,0,3531500,498900,3032600,636278,2024.05.23
39,Called Crazy,Kassi Ashton,677,10,667,42,0,3039600,58700,2980900,75430,2024.05.23
40,Miles On It,Marshmello & Kane Brown,975,136,839,112,0,2899200,770200,2129000,13148399,2024.05.23
41,Damn Good Day To Leave,Riley Green,875,61,814,92,0,2637100,341100,2296000,1363111,2024.05.23
42,Boys Back Home,Dylan Marlowe Feat. Dylan Scott,974,41,933,101,0,2494900,79900,2415000,2762337,2024.05.23
43,Find Another Bar,Chris Lane,1135,-47,1182,130,0,2425000,-11000,2436000,109809,2024.05.23
44,Breakin' In Boots,Matt Stell,1043,49,994,109,0,2265500,212500,2053000,1089202,2024.05.23
45,Think I’m In Love With You,Chris Stapleton,767,113,654,85,0,2180000,391400,1788600,7826004,2024.05.23
46,This Town's Been Too Good To Us,Dylan Scott,828,-1,829,87,0,2043500,-46800,2090300,2688960,2024.05.23
47,Whatcha See Is Whatcha Get,Chris Janson,899,49,850,97,0,1981900,165900,1816000,195363,2024.05.23
48,Forever To Me,Cole Swindell,593,-14,607,74,0,1893100,70800,1822300,1365508,2024.05.23
49,Drinkin' Buddies,"Lee Brice, Hailey Whitters, And Nate Smith",537,12,525,77,0,1749600,16300,1733300,1042758,2024.05.23
50,I Tried A Ring On,Tigirlily Gold,899,62,837,99,0,1576600,196700,1379900,957244,2024.05.23
51,Wranglers,Miranda Lambert,618,79,539,87,0,1555100,217500,1337600,2396792,2024.05.23
52,Love You Back,Lady A,729,-94,823,115,0,1481600,-220100,1701700,103703,2024.05.23
53,Friends Like That,John Morgan Feat. Jason Aldean,623,28,595,61,0,1472800,69800,1403000,896358,2024.05.23
54,Life With You,Kelsey Hart,793,2,791,86,0,1412000,-31000,1443000,2419655,2024.05.23
55,I'm In Love,Hailey Whitters,592,-16,608,70,0,1202100,-58800,1260900,220831,2024.05.23
56,Country Back,Randy Houser,522,21,501,68,0,937800,157600,780200,105598,2024.05.23
57,King Of Country Music,Ryan Larkins,431,29,402,66,0,892200,104000,788200,9234,2024.05.23
58,Single Again,Josh Ross,467,10,457,72,0,758300,-74700,833000,2609976,2024.05.23
59,Make Me Wanna Smoke,Runaway June,406,-8,414,44,0,744700,-18200,762900,14842,2024.05.23
60,This Heart,Corey Kent,425,53,372,48,0,716300,191500,524800,2117223,2024.05.23
61,Wine Into Whiskey,Tucker Wetmore,229,-17,246,22,0,708900,-71200,780100,6804258,2024.05.23
62,Dance Like No One’s Watching,Gabby Barrett,304,-27,331,31,0,578300,-75800,654100,853303,2024.05.23
63,Break Mine,Brothers Osborne,277,9,268,37,0,573900,43200,530700,404581,2024.05.23
64,Hometown Home,Locash,281,135,146,48,0,535400,237100,298300,177862,2024.05.23
65,The Devil I Know,Ashley McBryde,320,-21,341,40,0,527200,-30600,557800,382531,2024.05.23
66,Spin You Around (1/24),Morgan Wallen,132,-2,134,7,0,522800,32400,490400,6895574,2024.05.23
67,Roulette On The Heart,Conner Smith,324,32,292,49,0,502800,53500,449300,925831,2024.05.23
68,Things I Take For Granted,Larry Fleet,319,38,281,47,0,467100,30400,436700,1067770,2024.05.23
69,Neon Baby,Annie Bosko,361,-5,366,49,0,450200,44300,405900,17953,2024.05.23
70,Everything I Need,Chayce Beckham,315,48,267,57,0,433200,85000,348200,251244,2024.05.23
71,Mia Down In Mia,George Strait,74,74,0,14,0,425400,425400,0,984504,2024.05.23
72,Last Rodeo,Restless Road,170,-210,380,40,0,394500,-347100,741600,491975,2024.05.23
73,Good On You,Priscilla Block,263,-16,279,42,0,387400,-51900,439300,915194,2024.05.23
74,Color Up My World,"Hailey Whitters, Ben Rector",76,76,0,39,0,356400,356400,0,94476,2024.05.23
75,Devil You Know,Tyler Braden,245,27,218,31,0,320900,43800,277100,4940186,2024.05.23
76,No Caller Id,Megan Moroney,116,-31,147,7,0,294300,-87700,382000,3226175,2024.05.23
77,Make It Rhyme,Gary Levox,57,57,0,56,0,287200,287200,0,13625,2024.05.23
78,Wind Up Missin' You,Tucker Wetmore,73,21,52,9,0,254200,52600,201600,6288487,2024.05.23
79,Uh-huh (Ajá),Frank Ray,250,53,197,32,0,250100,43300,206800,68376,2024.05.23
80,Pray All The Way Home,Austin Snell,127,18,109,22,0,229400,9400,220000,1133271,2024.05.23
81,Bury Me In This Bar,Dalton Dover,132,40,92,24,0,197100,46600,150500,51579,2024.05.23
82,Baby Daddy's Weekend,Elle King,138,26,112,20,0,161700,57100,104600,0,2024.05.23
83,Two Night Stands,Kylie Morgan,132,-5,137,23,0,145400,-11800,157200,113801,2024.05.23
84,Strangers,Kameron Marlowe & Ella Langley,76,57,19,14,0,130700,71900,58800,1262947,2024.05.23
85,Worst Way,Riley Green,21,13,8,2,0,126200,84100,42100,3186015,2024.05.23
86,Never Been Over,Darius Rucker,71,70,1,33,0,119300,117000,2300,633035,2024.05.23
87,Young Man,Greylan James,30,4,26,4,0,118100,48600,69500,46507,2024.05.23
88,Songs About Whiskey,Anne Wilson,22,6,16,2,0,116000,5300,110700,241583,2024.05.23
89,Hey Driver,Zach Bryan Feat. The War and Treaty,45,-1,46,3,0,101900,-8900,110800,7152984,2024.05.23
90,Wondering Why,Red Clay Strays,44,6,38,5,0,98400,12500,85900,5841100,2024.05.23
91,Mama I Made It,Lauren Watkins,48,48,0,48,0,93800,93800,0,148899,2024.05.23
91,Pay Me Back In Change,MacKenzie Porter,48,48,0,48,0,93800,93800,0,4723,2024.05.23
91,If You Killed Somebody,Abby Anderson,48,48,0,48,0,93800,93800,0,137518,2024.05.23
94,Country House,Sam Hunt,31,17,14,11,0,91900,55400,36500,504943,2024.05.23
95,How Is She,Cole Swindell,16,-1,17,1,0,75600,-44500,120100,46696,2024.05.23
96,Jolene,Beyonce,20,-5,25,1,0,58200,-18200,76400,2247623,2024.05.23
97,Should'Ve Been A Cowboy,Jason Aldean,12,12,0,8,0,52100,52100,0,758755,2024.05.23
98,Summertime Blues,Zach Bryan,19,0,19,1,0,51700,8900,42800,678379,2024.05.23
99,Paying For It,Levi Hummon,55,4,51,11,0,48400,-3000,51400,87270,2024.05.23
100,Broadway Girls,Lil Durk Feat. Morgan Wallen,13,4,9,2,0,47700,12000,35700,6439646,2024.05.23
101,I Need You,Frontmen,16,16,0,16,0,45100,45100,0,660,2024.05.23
102,Running Out Of Time,Wyatt Flores,17,2,15,1,0,44200,-4300,48500,552938,2024.05.23
103,Coal,Dylan Gossett,16,1,15,1,0,42800,4800,38000,4479578,2024.05.23
104,Man Upstairs,Tim Dugger,11,-5,16,1,0,42100,-38100,80200,16127,2024.05.23
105,Oklahoma Sooner,Jake Banfield,12,1,11,1,0,38500,9000,29500,2605,2024.05.23
106,Holy Smokes,Bailey Zimmerman,13,0,13,2,0,36300,1000,35300,4968043,2024.05.23
107,Locked Up,Sam Hunt,7,7,0,7,0,35200,35200,0,935366,2024.05.23
108,Lighten That Load,Waylon Hanel,34,0,34,17,0,29600,0,29600,1307,2024.05.23
109,Goodbye You,Landon Parker,34,-17,51,17,0,29600,-14800,44400,1209,2024.05.23
109,Heaven On A Dirt Road,Jesse Felder,34,-17,51,17,0,29600,-14800,44400,0,2024.05.23
111,I Got A Problem,Drake Milligan,13,1,12,1,0,28300,800,27500,57395,2024.05.23
112,Where That Came From,Randy Travis,9,-17,26,7,0,28200,-50200,78400,1253697,2024.05.23
113,Fall Of Summer,Scotty McCreery,22,15,7,15,0,25400,-13000,38400,557703,2024.05.23
114,Am I The Only One,Aaron Lewis,5,-1,6,1,0,25300,6200,19100,675354,2024.05.23
115,Roots,Austin Burke,14,-2,16,1,0,25000,-900,25900,15107,2024.05.23
116,Would If I Could (Feat. Lainey Wilson),Ernest,13,4,9,1,0,24700,3300,21400,1337135,2024.05.23
117,Sparks Fly,Taylor Swift,8,0,8,1,0,23000,-16500,39500,272475,2024.05.23
118,You In A Honky Tonk,Randall King,4,2,2,3,0,22900,7400,15500,347597,2024.05.23
119,The Star-Spangled Banner,Chris Stapleton,8,-4,12,8,0,22800,-32200,55000,99182,2024.05.23
120,My Bar,Priscilla Block,4,4,0,1,0,21900,21900,0,126917,2024.05.23
121,Work Boots,Cody Johnson,4,2,2,2,0,21900,-4000,25900,310401,2024.05.23
122,It's All Good 'Til It Ain't,Struggle Jennings & Caitlynne Curtis,11,11,0,1,0,21000,21000,0,0,2024.05.23
123,All Things,Sound,3,2,1,3,0,21000,16600,4400,8209,2024.05.23
124,Lucky,Megan Moroney,2,2,0,1,0,20200,20200,0,322381,2024.05.23
125,'98 Braves,Morgan Wallen,3,2,1,2,0,18900,9500,9400,2319525,2024.05.23
126,When My Baby's In Boots,Randall King,2,0,2,1,0,18700,3200,15500,0,2024.05.23
127,This Side Of The Dirt,Neon Union,31,-3,34,5,0,17500,-17300,34800,25654,2024.05.23
128,Heart Of A Small Town,Tim Dugger,2,1,1,1,0,17300,9900,7400,16835,2024.05.23
129,Ain'T About You,Huntergirl,11,-6,17,4,0,17100,3200,13900,17836,2024.05.23
130,Purple Irises,Gwen Stefani & Blake Shelton,1,-2,3,1,0,16800,14700,2100,207018,2024.05.23
131,I Can'T,Reba Mcentire,4,4,0,4,0,16700,16700,0,533071,2024.05.23
132,Any Given Friday Night,Luke Combs,2,1,1,1,0,16000,8000,8000,274410,2024.05.23
133,That's Texas,Cody Johnson,2,0,2,2,0,16000,3800,12200,340993,2024.05.23
134,Love The Leavin',Drew Parker,3,3,0,2,0,15900,15900,0,251560,2024.05.23
135,Baby Do,Randall King,2,1,1,1,0,15500,11400,4100,17740,2024.05.23
135,A Little Bit Closer,Braxton Keith,2,1,1,1,0,15500,11400,4100,83724,2024.05.23
135,Open The Gate,Zach Bryan,2,1,1,1,0,15500,11400,4100,2133349,2024.05.23
138,Give Me A Sunrise,Braxton Keith,2,0,2,1,0,15500,0,15500,41569,2024.05.23
139,Dive,Luke Combs,2,-1,3,1,0,15500,-25000,40500,1635293,2024.05.23
140,Problems,12/Oc,6,2,4,1,0,14900,7000,7900,1094,2024.05.23
141,I'm Not Gonna Miss You,Glen Campbell & Elton John,2,2,0,2,0,14800,14800,0,11649,2024.05.23
142,We Ain't The Only Ones,Randy Rogers & Wade Bowen,1,1,0,1,0,14600,14600,0,0,2024.05.23
143,Up In Texas,Midland,1,0,1,1,0,14600,13700,900,296556,2024.05.23
144,The Architect,Kacey Musgraves,30,-8,38,6,0,13600,-22900,36500,907359,2024.05.23
145,Meet Me At The Cross,Brian Free & Assurance,2,1,1,1,0,13400,5900,7500,4572,2024.05.23
146,Whose Rearview,Jason Aldean,2,0,2,1,0,13400,-200,13600,501942,2024.05.23
147,Ain't That Some,Morgan Wallen,3,0,3,2,0,13400,-7700,21100,5173581,2024.05.23
148,You'll Always Be My Baby (Written For Daughters' Weddings),Alan Jackson,5,0,5,1,0,13200,3400,9800,47732,2024.05.23
149,Million Little Bandaids,Caroline Jones,19,-15,34,5,0,12900,-8200,21100,46630,2024.05.23
150,I'Ve Seen Me Do It,Joe Peters,2,1,1,1,0,12800,5000,7800,431,2024.05.23
151,Beatles And Eagles,Frontmen,2,2,0,2,0,12400,12400,0,1126,2024.05.23
152,Country's Cool Again,Lainey Wilson,11,-3,14,1,0,12300,-20900,33200,859705,2024.05.23
153,Georgia Girl,Megan Moroney,2,2,0,1,0,11300,11300,0,401385,2024.05.23
154,I Should Have Known It,Chris Stapleton,1,1,0,1,0,11300,11300,0,869323,2024.05.23
155,There Is A Name,LeFevre Quartet,2,2,0,2,0,11100,11100,0,1297,2024.05.23
156,Wings Of A Dove,Jonathan Wilburn,2,1,1,2,0,11100,6700,4400,0,2024.05.23
157,Your Healing Is On The Way,Greater Vision,2,1,1,2,0,11100,4400,6700,993,2024.05.23
157,We Are The Church,Ernie Haase & Signature Sound,2,1,1,2,0,11100,4400,6700,18977,2024.05.23
157,Waiting For Me,Truesong,2,1,1,2,0,11100,4400,6700,910,2024.05.23
157,"I, John",Blackwood Brothers Quartet,2,1,1,2,0,11100,4400,6700,42,2024.05.23
161,My God,Scotty Inman,2,1,1,2,0,11100,1200,9900,38972,2024.05.23
162,Wild Ones,Jessie Murph & Jelly Roll,7,-4,11,1,0,11100,-4600,15700,10433909,2024.05.23
163,The Good I'Ll Do,Zach Bryan,3,1,2,1,0,11000,1200,9800,3008446,2024.05.23
164,By Your Grace,Cody Johnson,2,1,1,2,0,10700,7500,3200,521557,2024.05.23
165,Sun To Me,Zach Bryan,7,-5,12,2,0,10700,-2200,12900,6615051,2024.05.23
166,Jack And Diet Coke,Redferrin,5,-15,20,2,0,10700,-52600,63300,2063813,2024.05.23
167,Park,Tyler Hubbard,1,1,0,1,0,10200,10200,0,813078,2024.05.23
167,God Made A Country Boy,Timothy Wayne,1,1,0,1,0,10200,10200,0,23035,2024.05.23
167,Heavens To Betsy,Jackson Dean,1,1,0,1,0,10200,10200,0,101079,2024.05.23
167,Hannah Ford Road,Luke Combs,1,1,0,1,0,10200,10200,0,335505,2024.05.23
171,Oklahoma Smokeshow,Zach Bryan,2,0,2,1,0,10200,2200,8000,7466748,2024.05.23
172,Certified,Laura Bryna,15,-1,16,1,0,9600,-1500,11100,11980,2024.05.23
173,Heart They Didn'T Break,Maddie & Tae,12,-14,26,1,0,9200,-27300,36500,249212,2024.05.23
174,Wreckage,Nate Smith,3,2,1,1,0,8800,7900,900,622776,2024.05.23
175,Long Live Cowgirls,Ian Munsick & Cody Johnson,12,-1,13,3,0,8800,-9000,17800,850489,2024.05.23
176,"Salt, Lime & Tequila",Ryan Griffin,3,2,1,1,0,8500,7700,800,78299,2024.05.23
177,Great Is His Faithfulness ,Collingsworth Family,1,1,0,1,0,7500,7500,0,13350,2024.05.23
178,Breathe In Girl,Elizabeth Mary,7,0,7,1,0,7000,2800,4200,65,2024.05.23
179,Hate My Heart,Carrie Underwood,1,1,0,1,0,6900,6900,0,92343,2024.05.23
180,Nothing But Love Songs,Randy Rogers Band,2,1,1,2,0,6800,2500,4300,11567,2024.05.23
181,Double Down,Cody Johnson,1,0,1,1,0,6800,200,6600,188807,2024.05.23
182,21 Days,Sara Evans,2,2,0,2,0,6700,6700,0,91005,2024.05.23
183,Carry The Glorious Gospel,Mylon Hayes Family,1,1,0,1,0,6700,6700,0,5312,2024.05.23
183,Beautiful,Nelons,1,1,0,1,0,6700,6700,0,811,2024.05.23
183,Dear Heavenly Father,11th Hour,1,1,0,1,0,6700,6700,0,5358,2024.05.23
183,Take Me To The Water,"Lauren, Amber & Kenna",1,1,0,1,0,6700,6700,0,7546,2024.05.23
183,He Forgives And Forgets,Gordon Mote,1,1,0,1,0,6700,6700,0,624,2024.05.23
183,Heaven Is Happening,Guardians,1,1,0,1,0,6700,6700,0,0,2024.05.23
183,He's Gettin' Me Ready,Darin & Brooke Aldridge Feat. The Oak Ridge Boys,1,1,0,1,0,6700,6700,0,315,2024.05.23
183,Two Or Three,Collingsworth Family,1,1,0,1,0,6700,6700,0,10005,2024.05.23
183,Nobody Like Jesus,LeFevre Quartet,1,1,0,1,0,6700,6700,0,1033,2024.05.23
183,Lord God On High,Lee Black,1,1,0,1,0,6700,6700,0,29,2024.05.23
193,The First Song,Gordon Mote,1,0,1,1,0,6700,0,6700,392,2024.05.23
193,Cross Over,Allens,1,0,1,1,0,6700,0,6700,21,2024.05.23
193,There's A Song For That,Down East Boys,1,0,1,1,0,6700,0,6700,2700,2024.05.23
193,"Ever Present, Ever Faithful",Jim & Melissa Brady,1,0,1,1,0,6700,0,6700,3251,2024.05.23
193,Wasted Words,Craguns,1,0,1,1,0,6700,0,6700,74,2024.05.23
198,Come On In,Kingdom Heirs,1,0,1,1,0,6700,-800,7500,2687,2024.05.23
199,Revival Broke Out,Gaither Vocal Band,1,-1,2,1,0,6700,-7500,14200,1360,2024.05.23
200,Good Times Go By Too Fast,Dylan Scott,2,2,0,1,0,6000,6000,0,1644692,2024.05.23
201,Rainin On Me,Wade Bowen,8,0,8,2,0,6000,0,6000,52998,2024.05.23
1,Where It Ends,Bailey Zimmerman,8673,80,8593,145,0,33618600,293000,33325600,6254691,2024.05.30
2,Halfway To Hell,Jelly Roll,7563,363,7200,145,0,28742400,1775500,26966900,4154333,2024.05.30
3,Take Her Home,Kenny Chesney,7011,228,6783,145,0,26023100,619000,25404100,1713600,2024.05.30
4,I Had Some Help,Post Malone,6144,1243,4901,144,0,23894700,4468300,19426400,48064087,2024.05.30
5,Outskirts,Sam Hunt,5626,-445,6071,140,0,23339800,-1866700,25206500,1593126,2024.05.30
6,Tucson Too Late,Jordan Davis,5316,-794,6110,142,0,21400300,-2522500,23922800,2333797,2024.05.30
7,Your Place,Ashley Cooke,6083,86,5997,145,0,21356500,67100,21289400,1975767,2024.05.30
8,Back Then Right Now,Tyler Hubbard,5327,-1599,6926,144,0,20004600,-5890100,25894700,2736488,2024.05.30
9,We Ride,Bryan Martin,5544,510,5034,145,0,19286400,1651800,17634600,4750406,2024.05.30
10,Bulletproof,Nate Smith,5085,357,4728,145,0,18616700,1209300,17407400,8362104,2024.05.30
11,Cowgirls,Morgan Wallen,4526,776,3750,143,0,18383900,3525000,14858900,13362149,2024.05.30
12,Let Your Boys Be Country,Jason Aldean,5290,277,5013,145,0,18271100,599100,17672000,2092955,2024.05.30
13,Young Love & Saturday Nights,Chris Young,4657,218,4439,145,0,17969700,1709700,16260000,1350480,2024.05.30
14,Dirt Cheap,Cody Johnson,4652,483,4169,145,0,16931700,1655200,15276500,5575989,2024.05.30
15,We Don'T Fight Anymore,Carly Pearce,4334,76,4258,144,0,13770800,230100,13540700,2782442,2024.05.30
16,Love You Again,Chase Matthew,3937,91,3846,145,0,12878800,802200,12076600,2581278,2024.05.30
17,Chevrolet,Dustin Lynch Feat. Jelly Roll,3410,350,3060,143,0,12118700,1214600,10904100,2644021,2024.05.30
18,She's Somebody's Daughter,Drew Baldridge,3549,317,3232,139,0,11867600,1236700,10630900,469294,2024.05.30
19,I'M Not Pretty,Megan Moroney,3373,60,3313,143,0,11024100,496400,10527700,2262139,2024.05.30
20,Ain't No Love In Oklahoma (From Twisters: The Album),Luke Combs,2586,819,1767,143,0,9648700,2259600,7389100,11636371,2024.05.30
21,Hang Tight Honey,Lainey Wilson,2293,952,1341,143,0,8557900,3245500,5312400,2551424,2024.05.30
22,One Bad Habit,Tim McGraw,2728,97,2631,145,0,8315500,895000,7420500,447868,2024.05.30
23,This Is My Dirt,Justin Moore,2267,165,2102,142,0,6741300,362200,6379100,599477,2024.05.30
24,A Bar Song (Tipsy),Shaboozey,1776,418,1358,135,0,6326200,1787100,4539100,40269136,2024.05.30
25,"Love You, Miss You, Mean It",Luke Bryan,1819,226,1593,140,0,5955300,779000,5176300,2684750,2024.05.30
26,Dance With You,Brett Young,2056,206,1850,139,0,5646800,303400,5343400,1089380,2024.05.30
27,Messed Up As Me,Keith Urban,1911,19,1892,139,0,5611900,104200,5507700,1156059,2024.05.30
28,Gonna Love You,Parmalee,1887,36,1851,142,0,5465600,380400,5085200,298098,2024.05.30
29,Austin,Dasha,1515,49,1466,130,0,4988700,105800,4882900,13395482,2024.05.30
30,Rodeo Man,Garth Brooks & Ronnie Dunn,2088,26,2062,144,0,4872800,-43900,4916700,1116526,2024.05.30
31,Beautiful As You,Thomas Rhett,1399,279,1120,132,0,4499600,940900,3558700,4176389,2024.05.30
32,Bigger Houses,Dan + Shay,1696,-123,1819,138,0,4289600,-142400,4432000,1490376,2024.05.30
33,Sounds Like The Radio,Zach Top,1655,91,1564,132,0,4280400,201700,4078700,571692,2024.05.30
34,Tie Up,Zac Brown Band,1071,67,1004,104,0,4056000,69400,3986600,667329,2024.05.30
35,Miles On It,Marshmello & Kane Brown,1255,280,975,114,0,3873200,974000,2899200,14370052,2024.05.30
36,Cowboy Songs,George Birge,1329,45,1284,112,0,3808900,277400,3531500,588419,2024.05.30
37,American Girl,Dierks Bentley,1343,105,1238,135,0,3758100,206300,3551800,541203,2024.05.30
38,Called Crazy,Kassi Ashton,686,9,677,45,0,3064700,25100,3039600,64534,2024.05.30
39,Boys Back Home,Dylan Marlowe Feat. Dylan Scott,1065,91,974,99,0,2855500,360600,2494900,3076807,2024.05.30
40,Damn Good Day To Leave,Riley Green,995,120,875,99,0,2852900,215800,2637100,1315612,2024.05.30
41,Find Another Bar,Chris Lane,1145,10,1135,128,0,2612200,187200,2425000,100560,2024.05.30
42,Breakin' In Boots,Matt Stell,1066,23,1043,102,0,2402700,137200,2265500,1302559,2024.05.30
43,Think I’m In Love With You,Chris Stapleton,811,44,767,86,0,2276800,96800,2180000,9315128,2024.05.30
44,This Town's Been Too Good To Us,Dylan Scott,880,52,828,88,0,2102800,59300,2043500,2532876,2024.05.30
45,Whatcha See Is Whatcha Get,Chris Janson,922,23,899,104,0,1966900,-15000,1981900,184428,2024.05.30
46,Forever To Me,Cole Swindell,621,28,593,74,0,1952000,58900,1893100,1424452,2024.05.30
47,Drinkin' Buddies,"Lee Brice, Hailey Whitters, And Nate Smith",556,19,537,85,0,1840400,90800,1749600,545223,2024.05.30
48,Wranglers,Miranda Lambert,737,119,618,97,0,1643100,88000,1555100,2478880,2024.05.30
49,I Tried A Ring On,Tigirlily Gold,925,26,899,101,0,1632200,55600,1576600,1005276,2024.05.30
50,Friends Like That,John Morgan Feat. Jason Aldean,659,36,623,64,0,1545300,72500,1472800,1043049,2024.05.30
51,Life With You,Kelsey Hart,793,0,793,85,0,1534600,122600,1412000,2446226,2024.05.30
52,Love You Back,Lady A,779,50,729,109,0,1445800,-35800,1481600,83516,2024.05.30
53,I'm In Love,Hailey Whitters,597,5,592,69,0,1373100,171000,1202100,277801,2024.05.30
54,Wind Up Missin' You,Tucker Wetmore,282,209,73,26,0,952700,698500,254200,6808522,2024.05.30
55,King Of Country Music,Ryan Larkins,442,11,431,65,0,906700,14500,892200,7684,2024.05.30
56,Country Back,Randy Houser,561,39,522,70,0,884300,-53500,937800,92748,2024.05.30
57,Single Again,Josh Ross,486,19,467,71,0,848900,90600,758300,2315983,2024.05.30
58,This Heart,Corey Kent,448,23,425,46,0,727300,11000,716300,1966078,2024.05.30
59,Roulette On The Heart,Conner Smith,358,34,324,52,0,625900,123100,502800,834144,2024.05.30
60,The Devil I Know,Ashley McBryde,359,39,320,43,0,592600,65400,527200,357075,2024.05.30
61,Hometown Home,Locash,308,27,281,50,0,583900,48500,535400,165254,2024.05.30
62,Everything I Need,Chayce Beckham,338,23,315,49,0,583900,150700,433200,246380,2024.05.30
63,Wine Into Whiskey,Tucker Wetmore,159,-70,229,14,0,562300,-146600,708900,6563091,2024.05.30
64,Dance Like No One’s Watching,Gabby Barrett,279,-25,304,31,0,524600,-53700,578300,792206,2024.05.30
65,Things I Take For Granted,Larry Fleet,327,8,319,44,0,521100,54000,467100,1012685,2024.05.30
66,Break Mine,Brothers Osborne,273,-4,277,38,0,517100,-56800,573900,370768,2024.05.30
67,Neon Baby,Annie Bosko,376,15,361,58,0,488900,38700,450200,16804,2024.05.30
68,Devil You Know,Tyler Braden,280,35,245,32,0,437300,116400,320900,4977646,2024.05.30
69,Good On You,Priscilla Block,275,12,263,44,0,403900,16500,387400,713488,2024.05.30
70,Country House,Sam Hunt,146,115,31,40,0,395600,303700,91900,480898,2024.05.30
71,Back Pew,Lily Rose,106,106,0,57,0,385600,385600,0,240783,2024.05.30
72,Spin You Around (1/24),Morgan Wallen,82,-50,132,8,0,348700,-174100,522800,5862363,2024.05.30
73,No Caller Id,Megan Moroney,114,-2,116,6,0,305200,10900,294300,2485344,2024.05.30
74,Pray All The Way Home,Austin Snell,148,21,127,30,0,281100,51700,229400,1103798,2024.05.30
75,Uh-huh (Ajá),Frank Ray,262,12,250,36,0,278600,28500,250100,41340,2024.05.30
76,Bury Me In This Bar,Dalton Dover,169,37,132,31,0,249500,52400,197100,57084,2024.05.30
77,Fall Of Summer,Scotty McCreery,122,100,22,40,0,244100,218700,25400,544200,2024.05.30
78,Young Man,Greylan James,34,4,30,3,0,205600,87500,118100,44914,2024.05.30
79,Strangers,Kameron Marlowe & Ella Langley,111,35,76,21,0,200100,69400,130700,1208399,2024.05.30
80,21 Guns,Jamey Johnson,48,48,0,32,0,188500,188500,0,627441,2024.05.30
81,Add Her To The List,Travis Denning,39,38,1,39,0,188000,185400,2600,167028,2024.05.30
82,Worst Way,Riley Green,24,3,21,2,0,184400,58200,126200,3779036,2024.05.30
83,Never Been Over,Darius Rucker,139,68,71,31,0,177100,57800,119300,592826,2024.05.30
84,Mia Down In Mia,George Strait,44,-30,74,8,0,176600,-248800,425400,562415,2024.05.30
85,Baby Daddy's Weekend,Elle King,148,10,138,21,0,176500,14800,161700,0,2024.05.30
86,Two Night Stands,Kylie Morgan,133,1,132,22,0,145000,-400,145400,140783,2024.05.30
87,Songs About Whiskey,Anne Wilson,24,2,22,3,0,141100,25100,116000,201894,2024.05.30
88,Roots,Austin Burke,33,19,14,1,0,136700,111700,25000,12400,2024.05.30
89,Pink Skies,Zach Bryan,29,29,0,8,0,134900,134900,0,31720145,2024.05.30
90,Never Leave,Bailey Zimmerman,15,15,0,15,0,132000,132000,0,490810,2024.05.30
91,Holy Smokes,Bailey Zimmerman,21,8,13,6,0,126500,90200,36300,4998846,2024.05.30
92,How Is She,Cole Swindell,18,2,16,1,0,112200,36600,75600,50839,2024.05.30
93,American Spirit,Brian Kelley,30,30,0,27,0,111300,111300,0,35458,2024.05.30
93,Checking In,For King & Country & Lee Brice,30,30,0,27,0,111300,111300,0,114767,2024.05.30
95,Tractor Time,Darryl Worley,15,15,0,15,0,99200,99200,0,67228,2024.05.30
96,Hey Driver,Zach Bryan Feat. The War and Treaty,45,0,45,4,0,98500,-3400,101900,7316744,2024.05.30
97,Leroy,Tigirlily Gold,48,48,0,48,0,93800,93800,0,80071,2024.05.30
98,The Star-Spangled Banner,Chris Stapleton,21,13,8,17,0,86400,63600,22800,157313,2024.05.30
99,God Made A Country Boy,Timothy Wayne,17,16,1,16,0,78600,68400,10200,26137,2024.05.30
100,Wondering Why,Red Clay Strays,44,0,44,4,0,73800,-24600,98400,5978292,2024.05.30
101,Where That Came From,Randy Travis,17,8,9,10,0,72000,43800,28200,1383197,2024.05.30
102,Last Rodeo,Restless Road,35,-135,170,8,0,64500,-330000,394500,512394,2024.05.30
103,Broadway Girls,Lil Durk Feat. Morgan Wallen,16,3,13,2,0,59200,11500,47700,6549012,2024.05.30
104,How Do You Choose,Scotty Hasting,9,9,0,9,0,56800,56800,0,3325,2024.05.30
105,Should'Ve Been A Cowboy,Jason Aldean,12,0,12,5,0,54700,2600,52100,516960,2024.05.30
106,Coal,Dylan Gossett,16,0,16,1,0,53300,10500,42800,4576975,2024.05.30
107,Beatles And Eagles,Frontmen,46,44,2,7,0,45700,33300,12400,902,2024.05.30
108,Paying For It,Levi Hummon,56,1,55,10,0,45400,-3000,48400,93873,2024.05.30
109,Would If I Could (Feat. Lainey Wilson),Ernest,19,6,13,2,0,44300,19600,24700,1235345,2024.05.30
110,'98 Braves,Morgan Wallen,3,0,3,2,0,43900,25000,18900,2225225,2024.05.30
111,Man Upstairs,Tim Dugger,8,-3,11,1,0,42800,700,42100,13801,2024.05.30
112,180 (Lifestyle),Morgan Wallen,3,3,0,1,0,38900,38900,0,1622881,2024.05.30
112,Devil Don't Know,Morgan Wallen,3,3,0,1,0,38900,38900,0,766760,2024.05.30
114,Country's Cool Again,Lainey Wilson,13,2,11,3,0,36500,24200,12300,750598,2024.05.30
115,Running Out Of Time,Wyatt Flores,15,-2,17,1,0,34600,-9600,44200,471192,2024.05.30
116,Summertime Blues,Zach Bryan,15,-4,19,1,0,34200,-17500,51700,716637,2024.05.30
117,Neon Star (Country Boy Lullaby),Morgan Wallen,2,2,0,1,0,33600,33600,0,2078815,2024.05.30
118,F150-50,Morgan Wallen,2,2,0,1,0,32900,32900,0,791828,2024.05.30
119,Atlantic City,Riley Green,4,4,0,2,0,30400,30400,0,333972,2024.05.30
120,Work Boots,Cody Johnson,3,-1,4,2,0,30400,8500,21900,284703,2024.05.30
121,Ghost In My Chevy,Carson Wallace,34,34,0,17,0,29600,29600,0,11540,2024.05.30
122,Heaven On A Dirt Road,Jesse Felder,34,0,34,17,0,29600,0,29600,0,2024.05.30
123,Ain't That Some,Morgan Wallen,3,0,3,2,0,29400,16000,13400,4913336,2024.05.30
124,It's All Good 'Til It Ain't,Struggle Jennings & Caitlynne Curtis,16,5,11,1,0,29200,8200,21000,0,2024.05.30
125,Quittin' Time,Zach Bryan,3,2,1,1,0,29000,24900,4100,1198346,2024.05.30
126,Oklahoma Sooner,Jake Banfield,10,-2,12,1,0,29000,-9500,38500,2648,2024.05.30
127,I Got A Problem,Drake Milligan,12,-1,13,1,0,28700,400,28300,54099,2024.05.30
128,I Could Be That Rain,Randall King,3,2,1,3,0,27300,24800,2500,430174,2024.05.30
129,Sunrise,Morgan Wallen,3,3,0,2,0,27200,27200,0,3339586,2024.05.30
130,Am I The Only One,Aaron Lewis,6,1,5,2,0,23100,-2200,25300,703793,2024.05.30
131,My Bar,Priscilla Block,4,0,4,2,0,22800,900,21900,125001,2024.05.30
132,Park,Tyler Hubbard,6,5,1,2,0,21500,11300,10200,749364,2024.05.30
133,Tennessee Numbers,Morgan Wallen,2,2,0,1,0,21300,21300,0,736362,2024.05.30
133,I Wrote The Book,Morgan Wallen,2,2,0,1,0,21300,21300,0,3799031,2024.05.30
133,Dying Man,Morgan Wallen,2,2,0,1,0,21300,21300,0,1268394,2024.05.30
136,Way Out Here,Riley Green,3,3,0,2,0,21000,21000,0,491262,2024.05.30
137,Jesus Saves,Riley Green,3,1,2,2,0,21000,15300,5700,794205,2024.05.30
138,Here And Her,Travis Denning,4,4,0,4,0,20800,20800,0,46314,2024.05.30
139,Sun To Me,Zach Bryan,12,5,7,3,0,19800,9100,10700,6673227,2024.05.30
140,Long Live Cowgirls,Ian Munsick & Cody Johnson,12,0,12,3,0,19700,10900,8800,797906,2024.05.30
141,We Are The Church,Ernie Haase & Signature Sound,3,1,2,3,0,18600,7500,11100,14899,2024.05.30
141,My God,Scotty Inman,3,1,2,3,0,18600,7500,11100,34246,2024.05.30
143,Sparks Fly,Taylor Swift,7,-1,8,1,0,18600,-4400,23000,260670,2024.05.30
144,The Architect,Kacey Musgraves,38,8,30,6,0,18500,4900,13600,744368,2024.05.30
145,Third Rock From The Sun,"HIXTAPE & Joe Diffie Feat. Brooks & Dunn, Blake Shelton & HARDY",1,1,0,1,0,17600,17600,0,0,2024.05.30
146,Sunrise Tells The Story,Midland,2,1,1,1,0,17600,16700,900,171696,2024.05.30
147,That's Texas,Cody Johnson,2,0,2,1,0,17600,1600,16000,311015,2024.05.30
148,Heart Of A Small Town,Tim Dugger,2,0,2,1,0,17400,100,17300,20225,2024.05.30
149,Don't Think Jesus,Morgan Wallen,1,1,0,1,0,16900,16900,0,1008241,2024.05.30
150,Roads That Go Nowhere,Travis Denning,4,4,0,4,0,16700,16700,0,81835,2024.05.30
151,Southern Rock,Travis Denning,6,6,0,1,0,16400,16400,0,883376,2024.05.30
152,Heart Shaped Box,Nate Smith,10,10,0,8,0,16300,16300,0,48560,2024.05.30
153,Heart They Didn'T Break,Maddie & Tae,16,4,12,2,0,16000,6800,9200,224232,2024.05.30
154,This Side Of The Dirt,Neon Union,30,-1,31,5,0,15200,-2300,17500,22361,2024.05.30
155,Star Spangled Banner,Mickey Guyton,2,1,1,2,0,14800,11600,3200,0,2024.05.30
156,Lighten That Load,Waylon Hanel,17,-17,34,17,0,14800,-14800,29600,1057,2024.05.30
156,Goodbye You,Landon Parker,17,-17,34,17,0,14800,-14800,29600,852,2024.05.30
158,Messed Around,Huser Brother Band,1,1,0,1,0,14600,14600,0,1707,2024.05.30
158,When Love Comes Around,Wade Bowen,1,1,0,1,0,14600,14600,0,8657,2024.05.30
160,Up In Texas,Midland,1,0,1,1,0,14600,0,14600,188027,2024.05.30
161,He Pilots My Ship,Tribute Quartet,2,2,0,2,0,14200,14200,0,7327,2024.05.30
162,When My Baby's In Boots,Randall King,1,-1,2,1,0,13500,-5200,18700,0,2024.05.30
163,You In A Honky Tonk,Randall King,1,-3,4,1,0,13500,-9400,22900,346830,2024.05.30
164,I Found You,Nate Smith,8,8,0,8,0,13400,13400,0,220374,2024.05.30
165,I'Ve Seen Me Do It,Joe Peters,2,0,2,1,0,12800,0,12800,370,2024.05.30
166,Waiting For Me,Truesong,3,1,2,3,0,12300,1200,11100,767,2024.05.30
167,Wine Country,Hannah Ellis,4,3,1,2,0,11500,10600,900,23451,2024.05.30
168,Not Today,Mitchell Tenpenny,3,2,1,2,0,11500,7000,4500,1005053,2024.05.30
169,If You Killed Somebody,Abby Anderson,1,-47,48,1,0,11300,-82500,93800,123964,2024.05.30
170,Help Is On The Way,Gold City,2,1,1,2,0,11100,6700,4400,20487,2024.05.30
171,There Is A Name,LeFevre Quartet,2,0,2,2,0,11100,0,11100,1205,2024.05.30
171,Your Healing Is On The Way,Greater Vision,2,0,2,2,0,11100,0,11100,781,2024.05.30
173,Problems,12/Oc,4,-2,6,1,0,11000,-3900,14900,1307,2024.05.30
174,You'll Always Be My Baby (Written For Daughters' Weddings),Alan Jackson,6,1,5,1,0,10800,-2400,13200,43980,2024.05.30
175,What Would You Do?,Tucker Wetmore,3,3,0,1,0,10400,10400,0,2843850,2024.05.30
176,Heartbreaker,Warren Zeiders,1,1,0,1,0,10200,10200,0,3049983,2024.05.30
176,Foot Out The Door,Dillon Carmichael,1,1,0,1,0,10200,10200,0,5383,2024.05.30
178,Oklahoma Smokeshow,Zach Bryan,4,2,2,2,0,10100,-100,10200,7258829,2024.05.30
179,Because He Lives,Carrie Underwood,1,1,0,1,0,9900,9900,0,49136,2024.05.30
179,Hell Or High Water,Bailey Zimmerman,1,1,0,1,0,9900,9900,0,4276174,2024.05.30
179,Memories Of Home,Authentic Unlimited,1,1,0,1,0,9900,9900,0,1941,2024.05.30
179,"Given, Buried, Risen",Legacy Five,1,1,0,1,0,9900,9900,0,516,2024.05.30
179,Be The Reason,Steeles,1,1,0,1,0,9900,9900,0,846,2024.05.30
179,Anywhere Jesus Is,Scotty Inman,1,1,0,1,0,9900,9900,0,795,2024.05.30
179,Make The Morning Worth The Midnight,Gaither Vocal Band,1,1,0,1,0,9900,9900,0,10522,2024.05.30
186,Gone But Not Forgotten,Brantley Gilbert,2,1,1,1,0,9300,3600,5700,78396,2024.05.30
187,"Salt, Lime & Tequila",Ryan Griffin,3,0,3,1,0,8800,300,8500,87395,2024.05.30
188,Record High,Randall King,2,1,1,1,0,8600,4300,4300,22653,2024.05.30
189,Any Given Friday Night,Luke Combs,1,-1,2,1,0,8000,-8000,16000,261157,2024.05.30
190,Certified,Laura Bryna,12,-3,15,1,0,8000,-1600,9600,11954,2024.05.30
191,Buckles And Broken Hearts,Joe Peters,1,0,1,1,0,7800,4900,2900,997,2024.05.30
192,Good Morning Mercy,Jason Crabb,1,1,0,1,0,7500,7500,0,217495,2024.05.30
192,God's Been Good,LeFevre Quartet,1,1,0,1,0,7500,7500,0,886,2024.05.30
192,Address Change Notification,Southbound,1,1,0,1,0,7500,7500,0,4173,2024.05.30
192,The Building,Emily Ann Roberts,1,1,0,1,0,7500,7500,0,30610,2024.05.30
192,Here Comes Jesus,Jeff & Sheri Easter,1,1,0,1,0,7500,7500,0,18369,2024.05.30
197,Raise The Roof,Christian Beck,4,1,3,1,0,7500,4200,3300,184,2024.05.30
198,By Your Grace,Cody Johnson,1,-1,2,1,0,7500,-3200,10700,503200,2024.05.30
199,Classic,Ernest,5,3,2,1,0,7300,5600,1700,26837,2024.05.30
200,Damn Good Time,Jordan Davis,2,2,0,1,0,7200,7200,0,223179,2024.05.30
1,Halfway To Hell,Jelly Roll,8694,1131,7563,145,0,33325200,4582800,28742400,4047695,2024.06.06
2,Where It Ends,Bailey Zimmerman,7472,-1201,8673,144,0,29773200,-3845400,33618600,5885136,2024.06.06
3,I Had Some Help,Post Malone,6926,782,6144,144,0,26929800,3035100,23894700,46127056,2024.06.06
4,Take Her Home,Kenny Chesney,7198,187,7011,145,0,26699800,676700,26023100,1605793,2024.06.06
5,Your Place,Ashley Cooke,6426,343,6083,145,0,22723800,1367300,21356500,1890415,2024.06.06
6,Outskirts,Sam Hunt,5335,-291,5626,139,0,22146800,-1193000,23339800,1573427,2024.06.06
7,Cowgirls,Morgan Wallen,5180,654,4526,145,0,20450700,2066800,18383900,13524287,2024.06.06
8,We Ride,Bryan Martin,5811,267,5544,145,0,19991300,704900,19286400,4745547,2024.06.06
9,Bulletproof,Nate Smith,5261,176,5085,145,0,19417000,800300,18616700,7945538,2024.06.06
10,Let Your Boys Be Country,Jason Aldean,5538,248,5290,145,0,19356100,1085000,18271100,2030642,2024.06.06
11,Young Love & Saturday Nights,Chris Young,4773,116,4657,144,0,17960900,-8800,17969700,1145265,2024.06.06
12,Dirt Cheap,Cody Johnson,4717,65,4652,145,0,17494100,562400,16931700,5483931,2024.06.06
13,We Don'T Fight Anymore,Carly Pearce,4361,27,4334,145,0,13534900,-235900,13770800,2690333,2024.06.06
14,Love You Again,Chase Matthew,4068,131,3937,145,0,13228600,349800,12878800,2486486,2024.06.06
15,She's Somebody's Daughter,Drew Baldridge,3776,227,3549,144,0,12880800,1013200,11867600,496457,2024.06.06
16,Chevrolet,Dustin Lynch Feat. Jelly Roll,3594,184,3410,145,0,12486200,367500,12118700,2937849,2024.06.06
17,Ain't No Love In Oklahoma (From Twisters: The Album),Luke Combs,3313,727,2586,145,0,12397400,2748700,9648700,11305255,2024.06.06
18,I'M Not Pretty,Megan Moroney,3382,9,3373,142,0,10816700,-207400,11024100,2139725,2024.06.06
19,Hang Tight Honey,Lainey Wilson,2571,278,2293,145,0,9251000,693100,8557900,3162231,2024.06.06
20,One Bad Habit,Tim McGraw,2844,116,2728,145,0,8797100,481600,8315500,427811,2024.06.06
21,This Is My Dirt,Justin Moore,2566,299,2267,143,0,7799400,1058100,6741300,509053,2024.06.06
22,A Bar Song (Tipsy),Shaboozey,2213,437,1776,140,0,7799000,1472800,6326200,40102645,2024.06.06
23,"Love You, Miss You, Mean It",Luke Bryan,1922,103,1819,140,0,6371100,415800,5955300,2557139,2024.06.06
24,Gonna Love You,Parmalee,2107,220,1887,142,0,6052800,587200,5465600,304908,2024.06.06
25,Messed Up As Me,Keith Urban,2081,170,1911,140,0,5916300,304400,5611900,996157,2024.06.06
26,Austin,Dasha,1744,229,1515,133,0,5679700,691000,4988700,15300229,2024.06.06
27,Dance With You,Brett Young,2044,-12,2056,139,0,5641600,-5200,5646800,1153226,2024.06.06
28,Rodeo Man,Garth Brooks & Ronnie Dunn,2132,44,2088,144,0,4950800,78000,4872800,1005683,2024.06.06
29,Beautiful As You,Thomas Rhett,1484,85,1399,131,0,4714700,215100,4499600,4642270,2024.06.06
30,Sounds Like The Radio,Zach Top,1732,77,1655,135,0,4711200,430800,4280400,724394,2024.06.06
31,Bigger Houses,Dan + Shay,1785,89,1696,142,0,4688100,398500,4289600,1394138,2024.06.06
32,Cowboy Songs,George Birge,1441,112,1329,125,0,4206100,397200,3808900,544088,2024.06.06
33,Tie Up,Zac Brown Band,1163,92,1071,120,0,4071800,15800,4056000,596277,2024.06.06
34,Miles On It,Marshmello & Kane Brown,1319,64,1255,119,0,4016300,143100,3873200,14243320,2024.06.06
35,American Girl,Dierks Bentley,1363,20,1343,135,0,3792500,34400,3758100,553642,2024.06.06
36,Boys Back Home,Dylan Marlowe Feat. Dylan Scott,1195,130,1065,103,0,3351800,496300,2855500,3283528,2024.06.06
37,Called Crazy,Kassi Ashton,727,41,686,47,0,3292600,227900,3064700,74021,2024.06.06
38,Damn Good Day To Leave,Riley Green,1065,70,995,105,0,3069400,216500,2852900,1174511,2024.06.06
39,Breakin' In Boots,Matt Stell,1206,140,1066,113,0,2891900,489200,2402700,1217115,2024.06.06
40,Find Another Bar,Chris Lane,1198,53,1145,130,0,2496300,-115900,2612200,96221,2024.06.06
41,Think I’m In Love With You,Chris Stapleton,864,53,811,88,0,2484000,207200,2276800,8675914,2024.06.06
42,This Town's Been Too Good To Us,Dylan Scott,885,5,880,94,0,2258900,156100,2102800,2753162,2024.06.06
43,Whatcha See Is Whatcha Get,Chris Janson,946,24,922,103,0,2168900,202000,1966900,159729,2024.06.06
44,Forever To Me,Cole Swindell,666,45,621,74,0,2145300,193300,1952000,1487053,2024.06.06
45,Friends Like That,John Morgan Feat. Jason Aldean,770,111,659,71,0,1886300,341000,1545300,907996,2024.06.06
46,Wranglers,Miranda Lambert,757,20,737,108,0,1848800,205700,1643100,2071023,2024.06.06
47,Drinkin' Buddies,"Lee Brice, Hailey Whitters, And Nate Smith",565,9,556,89,0,1826300,-14100,1840400,438438,2024.06.06
48,Life With You,Kelsey Hart,868,75,793,87,0,1671400,136800,1534600,2427386,2024.06.06
49,I Tried A Ring On,Tigirlily Gold,965,40,925,102,0,1665700,33500,1632200,941122,2024.06.06
50,Wind Up Missin' You,Tucker Wetmore,416,134,282,33,0,1458200,505500,952700,6351642,2024.06.06
51,I'm In Love,Hailey Whitters,572,-25,597,64,0,1373900,800,1373100,242835,2024.06.06
52,Country Back,Randy Houser,563,2,561,69,0,1073900,189600,884300,95121,2024.06.06
53,King Of Country Music,Ryan Larkins,446,4,442,59,0,958400,51700,906700,8707,2024.06.06
54,Single Again,Josh Ross,503,17,486,72,0,863400,14500,848900,2330032,2024.06.06
55,This Heart,Corey Kent,480,32,448,52,0,849600,122300,727300,2020434,2024.06.06
56,Hometown Home,Locash,344,36,308,50,0,714700,130800,583900,153780,2024.06.06
57,Everything I Need,Chayce Beckham,373,35,338,53,0,654400,70500,583900,239304,2024.06.06
58,Roulette On The Heart,Conner Smith,377,19,358,53,0,651900,26000,625900,806424,2024.06.06
59,Country House,Sam Hunt,242,96,146,43,0,625300,229700,395600,505281,2024.06.06
60,Devil You Know,Tyler Braden,320,40,280,36,0,583600,146300,437300,4692706,2024.06.06
61,The Devil I Know,Ashley McBryde,324,-35,359,40,0,573500,-19100,592600,637728,2024.06.06
62,Neon Baby,Annie Bosko,366,-10,376,49,0,565300,76400,488900,17561,2024.06.06
63,Fall Of Summer,Scotty McCreery,318,196,122,61,0,564600,320500,244100,466216,2024.06.06
64,Break Mine,Brothers Osborne,283,10,273,40,0,563600,46500,517100,358877,2024.06.06
65,Things I Take For Granted,Larry Fleet,337,10,327,47,0,554600,33500,521100,938342,2024.06.06
66,Dance Like No One’s Watching,Gabby Barrett,280,1,279,32,0,518700,-5900,524600,750430,2024.06.06
67,Holy Smokes,Bailey Zimmerman,87,66,21,11,0,483800,357300,126500,4775330,2024.06.06
68,Good On You,Priscilla Block,293,18,275,44,0,476700,72800,403900,635438,2024.06.06
69,Wine Into Whiskey,Tucker Wetmore,120,-39,159,11,0,439400,-122900,562300,6010546,2024.06.06
70,Risen Road,Ashley Monroe,105,105,0,57,0,379600,379600,0,54954,2024.06.06
71,Strangers,Kameron Marlowe & Ella Langley,211,100,111,35,0,378200,178100,200100,2516953,2024.06.06
72,Mia Down In Mia,George Strait,66,22,44,8,0,339900,163300,176600,482130,2024.06.06
73,Bury Me In This Bar,Dalton Dover,197,28,169,30,0,320600,71100,249500,58589,2024.06.06
74,Pray All The Way Home,Austin Snell,159,11,148,23,0,310100,29000,281100,1036791,2024.06.06
75,Uh-huh (Ajá),Frank Ray,282,20,262,40,0,291500,12900,278600,32148,2024.06.06
76,No Caller Id,Megan Moroney,96,-18,114,7,0,277200,-28000,305200,2426594,2024.06.06
77,Never Been Over,Darius Rucker,185,46,139,39,0,260700,83600,177100,441236,2024.06.06
78,Spin You Around (1/24),Morgan Wallen,68,-14,82,5,0,242500,-106200,348700,5954867,2024.06.06
79,Pink Skies,Zach Bryan,55,26,29,6,0,195700,60800,134900,28756168,2024.06.06
80,Sweet Dreams,Koe Wetzel,71,70,1,9,0,183800,179000,4800,9546554,2024.06.06
81,I Could Be That Rain,Randall King,89,86,3,17,0,175600,148300,27300,389291,2024.06.06
82,Two Night Stands,Kylie Morgan,148,15,133,23,0,173500,28500,145000,84166,2024.06.06
83,Baby Daddy's Weekend,Elle King,162,14,148,24,0,167100,-9400,176500,82011,2024.06.06
84,Worst Way,Riley Green,21,-3,24,1,0,141500,-42900,184400,3770434,2024.06.06
85,Beatles And Eagles,Frontmen,116,70,46,19,0,139000,93300,45700,1010,2024.06.06
86,Young Man,Greylan James,30,-4,34,4,0,130200,-75400,205600,43345,2024.06.06
87,Roots,Austin Burke,35,2,33,1,0,129700,-7000,136700,9063,2024.06.06
88,Songs About Whiskey,Anne Wilson,24,0,24,3,0,117500,-23600,141100,202476,2024.06.06
89,Hey Driver,Zach Bryan Feat. The War and Treaty,38,-7,45,3,0,98300,-200,98500,6803772,2024.06.06
90,Bad Boy,Huntergirl,48,48,0,48,0,91500,91500,0,37735,2024.06.06
91,How Is She,Cole Swindell,15,-3,18,1,0,91100,-21100,112200,55048,2024.06.06
92,Wondering Why,Red Clay Strays,34,-10,44,5,0,82700,8900,73800,6194866,2024.06.06
93,Running Out Of Time,Wyatt Flores,17,2,15,1,0,61500,26900,34600,448032,2024.06.06
94,The Star-Spangled Banner,Chris Stapleton,14,-7,21,13,0,61300,-25100,86400,96141,2024.06.06
95,Don't Think Jesus,Morgan Wallen,10,9,1,10,0,57600,40700,16900,947997,2024.06.06
96,Paying For It,Levi Hummon,62,6,56,10,0,57200,11800,45400,90264,2024.06.06
97,Broadway Girls,Lil Durk Feat. Morgan Wallen,12,-4,16,2,0,57100,-2100,59200,6099140,2024.06.06
98,Where That Came From,Randy Travis,10,-7,17,5,0,56400,-15600,72000,1251311,2024.06.06
99,Praise The Lord,Breland,9,9,0,9,0,54600,54600,0,156870,2024.06.06
100,Love The Leavin',Drew Parker,4,4,0,2,0,54000,54000,0,136402,2024.06.06
101,Man Upstairs,Tim Dugger,12,4,8,1,0,52900,10100,42800,10668,2024.06.06
102,Park,Tyler Hubbard,18,12,6,2,0,50400,28900,21500,782124,2024.06.06
103,Last Rodeo,Restless Road,28,-7,35,6,0,49200,-15300,64500,483869,2024.06.06
104,My Bar,Priscilla Block,9,5,4,6,0,48800,26000,22800,123150,2024.06.06
105,Goodbye You,Landon Parker,51,34,17,17,0,44400,29600,14800,1037,2024.06.06
106,Would If I Could (Feat. Lainey Wilson),Ernest,17,-2,19,1,0,41200,-3100,44300,1164973,2024.06.06
107,Go Home W U,Keith Urban & Lainey Wilson,16,14,2,13,0,36300,31700,4600,899491,2024.06.06
108,Oklahoma Sooner,Jake Banfield,11,1,10,1,0,33700,4700,29000,3119,2024.06.06
109,Whiskey Bent,Cody Johnson,12,12,0,12,0,32700,32700,0,517213,2024.06.06
110,Heaven On A Dirt Road,Jesse Felder,34,0,34,17,0,29600,0,29600,0,2024.06.06
110,Ghost In My Chevy,Carson Wallace,34,0,34,17,0,29600,0,29600,11191,2024.06.06
112,Work Boots,Cody Johnson,3,0,3,1,0,29000,-1400,30400,270333,2024.06.06
113,That's Texas,Cody Johnson,3,1,2,1,0,28900,11300,17600,312606,2024.06.06
114,Sparks Fly,Taylor Swift,8,1,7,1,0,26800,8200,18600,262129,2024.06.06
115,Keepin' The Lights On,Kameron Marlowe,5,5,0,5,0,25300,25300,0,199189,2024.06.06
116,I Got A Problem,Drake Milligan,13,1,12,1,0,24000,-4700,28700,54507,2024.06.06
117,It's All Good 'Til It Ain't,Struggle Jennings & Caitlynne Curtis,12,-4,16,1,0,21500,-7700,29200,0,2024.06.06
118,The Architect,Kacey Musgraves,26,-12,38,5,0,21000,2500,18500,966027,2024.06.06
119,The Man He Sees In Me,Luke Combs,1,1,0,1,0,18700,18700,0,448009,2024.06.06
120,Sunrise Tells The Story,Midland,2,0,2,1,0,18700,1100,17600,147184,2024.06.06
121,Help Is On The Way,Gold City,3,1,2,3,0,18600,7500,11100,17281,2024.06.06
122,When My Baby's In Boots,Randall King,3,2,1,1,0,18500,5000,13500,0,2024.06.06
123,Damn Good Time,Jordan Davis,5,3,2,1,0,17900,10700,7200,212519,2024.06.06
124,Roads That Go Nowhere,Travis Denning,4,0,4,4,0,17400,700,16700,57274,2024.06.06
125,We Ain't The Only Ones,Randy Rogers & Wade Bowen,2,2,0,2,0,17100,17100,0,0,2024.06.06
126,Ain't That Some,Morgan Wallen,2,-1,3,1,0,16800,-12600,29400,4900124,2024.06.06
127,21 Days,Sara Evans,4,4,0,4,0,16700,16700,0,34207,2024.06.06
128,Any Given Friday Night,Luke Combs,2,1,1,1,0,16000,8000,8000,263915,2024.06.06
129,Give Me A Sunrise,Braxton Keith,2,1,1,1,0,15500,11400,4100,46185,2024.06.06
130,Over Drinkin' Under Thinkin',Drake Milligan,1,1,0,1,0,14600,14600,0,75780,2024.06.06
131,Dive,Luke Combs,1,0,1,1,0,14600,13700,900,1508903,2024.06.06
132,Meet Me At The Cross,Brian Free & Assurance,2,1,1,2,0,14200,7500,6700,4637,2024.06.06
133,Girl In Your Songs,Twinnie,16,16,0,16,0,14000,14000,0,3243,2024.06.06
134,You'll Always Be My Baby (Written For Daughters' Weddings),Alan Jackson,6,0,6,1,0,14000,3200,10800,48319,2024.06.06
135,I'Ve Seen Me Do It,Joe Peters,3,1,2,1,0,13300,500,12800,416,2024.06.06
136,Problems,12/Oc,4,0,4,1,0,13200,2200,11000,2437,2024.06.06
137,Learning To Fly,Eli Young Band,2,2,0,2,0,12400,12400,0,132650,2024.06.06
138,Whatever Gets You Through It,Morgan Gruber,6,2,4,1,0,12200,5500,6700,176,2024.06.06
139,Am I The Only One,Aaron Lewis,3,-3,6,1,0,12100,-11000,23100,658878,2024.06.06
140,Long Live Cowgirls,Ian Munsick & Cody Johnson,14,2,12,4,0,12000,-7700,19700,782747,2024.06.06
141,Think About There,Greater Vision,2,1,1,2,0,11900,7500,4400,9198,2024.06.06
141,He Bought Me,Old Paths,2,1,1,2,0,11900,7500,4400,313,2024.06.06
143,Country's Cool Again,Lainey Wilson,6,-7,13,1,0,11200,-25300,36500,764714,2024.06.06
144,"I, John",Blackwood Brothers Quartet,2,2,0,2,0,11100,11100,0,50,2024.06.06
144,Come On In,Kingdom Heirs,2,2,0,2,0,11100,11100,0,2103,2024.06.06
146,Your Healing Is On The Way,Greater Vision,2,0,2,2,0,11100,0,11100,970,2024.06.06
147,We Are The Church,Ernie Haase & Signature Sound,2,-1,3,2,0,11100,-7500,18600,17174,2024.06.06
148,A Song Was Born,Luke Combs,1,1,0,1,0,10200,10200,0,154838,2024.06.06
148,Mama,Kolby Cooper,1,1,0,1,0,10200,10200,0,494387,2024.06.06
150,Red Letter Blueprint,Scotty McCreery,1,1,0,1,0,9900,9900,0,75137,2024.06.06
150,Your Sins Are Forgiven,Down East Boys,1,1,0,1,0,9900,9900,0,1094,2024.06.06
150,The Way (New Horizon),Gaither Vocal Band,1,1,0,1,0,9900,9900,0,322,2024.06.06
150,New Name Written Down In Glory,Avenue,1,1,0,1,0,9900,9900,0,107,2024.06.06
150,Homeland,Justified Quartet,1,1,0,1,0,9900,9900,0,87,2024.06.06
150,Shot Glass,Randall King,1,1,0,1,0,9900,9900,0,11355,2024.06.06
156,This Side Of The Dirt,Neon Union,26,-4,30,4,0,9900,-5300,15200,22284,2024.06.06
157,Coal,Dylan Gossett,2,-14,16,1,0,9600,-43700,53300,4063368,2024.06.06
158,Southern Rock,Travis Denning,9,3,6,1,0,9500,-6900,16400,632525,2024.06.06
159,"Poor, Poor Pitiful Me","Lainey Wilson, Terri Clark",1,1,0,1,0,9400,9400,0,205117,2024.06.06
160,Heart They Didn'T Break,Maddie & Tae,14,-2,16,1,0,9100,-6900,16000,228286,2024.06.06
161,Certified,Laura Bryna,14,2,12,1,0,9000,1000,8000,11119,2024.06.06
162,Build A Bridge,Ashley Cooke,4,1,3,1,0,8600,2500,6100,8602,2024.06.06
163,Sun To Me,Zach Bryan,8,-4,12,2,0,8500,-11300,19800,6634609,2024.06.06
164,Heart Of A Small Town,Tim Dugger,2,0,2,1,0,8400,-9000,17400,16762,2024.06.06
165,5 Leaf Clover,Luke Combs,3,3,0,2,0,8000,8000,0,1682554,2024.06.06
166,Me + All Your Reasons,Morgan Wallen,1,1,0,1,0,8000,8000,0,1219309,2024.06.06
167,Jesus Saves,Riley Green,1,-2,3,1,0,7800,-13200,21000,757992,2024.06.06
168,Blonde,Avery Anna,1,1,0,1,0,7600,7600,0,212866,2024.06.06
169,Looks Like Jesus,Brian Free & Assurance,1,1,0,1,0,7500,7500,0,791,2024.06.06
169,Friend In Jesus,CAIN,1,1,0,1,0,7500,7500,0,58150,2024.06.06
169,Mansions,Sound Street,1,1,0,1,0,7500,7500,0,733,2024.06.06
169,Great Is Thy Faithfulness,Carrie Underwood Feat. Cece Winans,1,1,0,1,0,7500,7500,0,84625,2024.06.06
169,On And On,Wes Hampton,1,1,0,1,0,7500,7500,0,164,2024.06.06
169,Scars In Heaven,Casting Crowns,1,1,0,1,0,7500,7500,0,424409,2024.06.06
175,Means Something To Me,Tate Emmons,1,0,1,1,0,7500,800,6700,522,2024.06.06
176,Here Comes Jesus,Jeff & Sheri Easter,1,0,1,1,0,7500,0,7500,19636,2024.06.06
177,Memories Of Home,Authentic Unlimited,1,0,1,1,0,7500,-2400,9900,2254,2024.06.06
178,Checking In,For King & Country & Lee Brice,1,-29,30,1,0,7500,-103800,111300,106466,2024.06.06
179,'98 Braves,Morgan Wallen,1,-2,3,1,0,7400,-36500,43900,2202812,2024.06.06
180,Days That End In Why,Morgan Wallen,5,1,4,1,0,6900,3000,3900,811085,2024.06.06
181,Fake Id,Sydney Mack,4,1,3,1,0,6800,3100,3700,804,2024.06.06
182,Should'Ve Been A Cowboy,Jason Aldean,4,-8,12,1,0,6800,-47900,54700,385981,2024.06.06
183,You In A Honky Tonk,Randall King,3,2,1,2,0,6700,-6800,13500,326692,2024.06.06
184,Door Wide Open,Gordon Mote,1,1,0,1,0,6700,6700,0,350,2024.06.06
184,Praying For The Prodigal,Kingsmen,1,1,0,1,0,6700,6700,0,694,2024.06.06
184,I Met Somebody On The Way To The Cemetery,Mark Bishop,1,1,0,1,0,6700,6700,0,0,2024.06.06
184,Heaven Is Happening,Guardians,1,1,0,1,0,6700,6700,0,0,2024.06.06
184,Part Of The Family,Littles,1,1,0,1,0,6700,6700,0,0,2024.06.06
184,Where You'Ve Walked,Lauren Talley,1,1,0,1,0,6700,6700,0,1012,2024.06.06
184,Preach The Word,Steve Ladd,1,1,0,1,0,6700,6700,0,81,2024.06.06
184,Two Or Three,Collingsworth Family,1,1,0,1,0,6700,6700,0,10011,2024.06.06
184,Dear Heavenly Father,11th Hour,1,1,0,1,0,6700,6700,0,3475,2024.06.06
184,Sanding Off The Edges,Tim Menzies,1,1,0,1,0,6700,6700,0,198,2024.06.06
184,Forgiven,Joseph Habedank,1,1,0,1,0,6700,6700,0,3210,2024.06.06
184,There's A Song For That,Down East Boys,1,1,0,1,0,6700,6700,0,2665,2024.06.06
184,Peace Is,Sound,1,1,0,1,0,6700,6700,0,1018,2024.06.06
184,Only Passing Through,Taylors,1,1,0,1,0,6700,6700,0,0,2024.06.06
184,There Is,Hyssongs,1,1,0,1,0,6700,6700,0,21,2024.06.06
199,After All,Mark Trammell Quartet,1,0,1,1,0,6700,6300,400,1716,2024.06.06
200,Mountain With A View,Kelsea Ballerini,5,0,5,1,0,6700,3200,3500,330110,2024.06.06
201,Be Ready,Karen Peck & New River,1,0,1,1,0,6700,0,6700,4,2024.06.06
201,When I Lift Up My Head,High Road,1,0,1,1,0,6700,0,6700,2902,2024.06.06
201,Blue Collar Gospel,Jerry Salley,1,0,1,1,0,6700,0,6700,0,2024.06.06
201,Fall Into Place,Jeff & Sheri Easter,1,0,1,1,0,6700,0,6700,665,2024.06.06
201,Cross Over,Allens,1,0,1,1,0,6700,0,6700,24,2024.06.06
201,Revival Broke Out,Gaither Vocal Band,1,0,1,1,0,6700,0,6700,1448,2024.06.06
201,Front Porch Sittin',Zane & Donna King,1,0,1,1,0,6700,0,6700,0,2024.06.06
201,He Forgives And Forgets,Gordon Mote,1,0,1,1,0,6700,0,6700,498,2024.06.06
201,Made A Mess,Tim Menzies,1,0,1,1,0,6700,0,6700,128,2024.06.06
210,He Pilots My Ship,Tribute Quartet,1,-1,2,1,0,6700,-7500,14200,2170,2024.06.06
1,Take Her Home,Kenny Chesney,8252,1054,7198,145,0,30088600,3388800,26699800,1743618,2024.06.13
2,I Had Some Help,Post Malone,7457,531,6926,144,0,29682800,2753000,26929800,43715711,2024.06.13
3,Where It Ends,Bailey Zimmerman,6665,-807,7472,142,0,27086200,-2687000,29773200,5801094,2024.06.13
4,Halfway To Hell,Jelly Roll,7053,-1641,8694,145,0,26580000,-6745200,33325200,4443114,2024.06.13
5,Your Place,Ashley Cooke,6560,134,6426,145,0,22915900,192100,22723800,1933517,2024.06.13
6,Cowgirls,Morgan Wallen,5882,702,5180,145,0,22657700,2207000,20450700,15261118,2024.06.13
7,We Ride,Bryan Martin,5878,67,5811,145,0,20854100,862800,19991300,4819038,2024.06.13
8,Outskirts,Sam Hunt,4951,-384,5335,137,0,20732300,-1414500,22146800,1540399,2024.06.13
9,Bulletproof,Nate Smith,5368,107,5261,145,0,19288800,-128200,19417000,8095981,2024.06.13
10,Let Your Boys Be Country,Jason Aldean,5507,-31,5538,145,0,19228600,-127500,19356100,2127939,2024.06.13
11,Young Love & Saturday Nights,Chris Young,4870,97,4773,145,0,17981800,20900,17960900,848234,2024.06.13
12,Dirt Cheap,Cody Johnson,4669,-48,4717,145,0,17434700,-59400,17494100,5919839,2024.06.13
13,Ain't No Love In Oklahoma (From Twisters: The Album),Luke Combs,3579,266,3313,145,0,13902300,1504900,12397400,12102746,2024.06.13
14,She's Somebody's Daughter,Drew Baldridge,3964,188,3776,144,0,13671700,790900,12880800,504167,2024.06.13
15,Love You Again,Chase Matthew,4088,20,4068,145,0,13392500,163900,13228600,2247325,2024.06.13
16,We Don'T Fight Anymore,Carly Pearce,4153,-208,4361,145,0,13190100,-344800,13534900,3056550,2024.06.13
17,Chevrolet,Dustin Lynch Feat. Jelly Roll,3782,188,3594,144,0,13086800,600600,12486200,3083128,2024.06.13
18,I'M Not Pretty,Megan Moroney,3459,77,3382,143,0,11084000,267300,10816700,1998149,2024.06.13
19,A Bar Song (Tipsy),Shaboozey,2856,643,2213,143,0,10600900,2801900,7799000,41303228,2024.06.13
20,Hang Tight Honey,Lainey Wilson,2961,390,2571,145,0,10448700,1197700,9251000,3709980,2024.06.13
21,One Bad Habit,Tim McGraw,2939,95,2844,145,0,9142700,345600,8797100,609377,2024.06.13
22,This Is My Dirt,Justin Moore,2731,165,2566,144,0,8834500,1035100,7799400,519266,2024.06.13
23,I Am Not Okay,Jelly Roll,1601,1601,0,118,0,7054800,7054800,0,2403159,2024.06.13
24,"Love You, Miss You, Mean It",Luke Bryan,2139,217,1922,140,0,6955700,584600,6371100,2900964,2024.06.13
25,Austin,Dasha,1898,154,1744,136,0,6503600,823900,5679700,15631064,2024.06.13
26,Gonna Love You,Parmalee,2049,-58,2107,143,0,6248700,195900,6052800,315373,2024.06.13
27,Messed Up As Me,Keith Urban,2060,-21,2081,140,0,5826500,-89800,5916300,1619381,2024.06.13
28,Dance With You,Brett Young,1949,-95,2044,139,0,5576000,-65600,5641600,662334,2024.06.13
29,Beautiful As You,Thomas Rhett,1605,121,1484,132,0,5016700,302000,4714700,5215254,2024.06.13
30,Rodeo Man,Garth Brooks & Ronnie Dunn,2058,-74,2132,144,0,4869500,-81300,4950800,1007762,2024.06.13
31,Sounds Like The Radio,Zach Top,1658,-74,1732,137,0,4664900,-46300,4711200,841880,2024.06.13
32,Bigger Houses,Dan + Shay,1701,-84,1785,138,0,4623500,-64600,4688100,1355954,2024.06.13
33,Miles On It,Marshmello & Kane Brown,1383,64,1319,132,0,4065700,49400,4016300,13246457,2024.06.13
34,American Girl,Dierks Bentley,1374,11,1363,135,0,3856700,64200,3792500,571834,2024.06.13
35,Cowboy Songs,George Birge,1319,-122,1441,113,0,3840200,-365900,4206100,573858,2024.06.13
36,Damn Good Day To Leave,Riley Green,1165,100,1065,111,0,3485700,416300,3069400,1220708,2024.06.13
37,Boys Back Home,Dylan Marlowe Feat. Dylan Scott,1184,-11,1195,106,0,3354000,2200,3351800,3448922,2024.06.13
38,Called Crazy,Kassi Ashton,736,9,727,46,0,3294800,2200,3292600,464241,2024.06.13
39,SIX FEET UNDER (Caleigh's Song),Hardy,828,828,0,97,0,3126700,3126700,0,2475875,2024.06.13
40,Breakin' In Boots,Matt Stell,1184,-22,1206,127,0,2968000,76100,2891900,1221695,2024.06.13
41,Tie Up,Zac Brown Band,1031,-132,1163,122,0,2954400,-1117400,4071800,597308,2024.06.13
42,Think I’m In Love With You,Chris Stapleton,946,82,864,92,0,2886000,402000,2484000,9475163,2024.06.13
43,Find Another Bar,Chris Lane,1179,-19,1198,131,0,2464400,-31900,2496300,102635,2024.06.13
44,Whatcha See Is Whatcha Get,Chris Janson,997,51,946,106,0,2444200,275300,2168900,163661,2024.06.13
45,This Town's Been Too Good To Us,Dylan Scott,911,26,885,94,0,2334500,75600,2258900,2499852,2024.06.13
46,Forever To Me,Cole Swindell,676,10,666,75,0,2231800,86500,2145300,1462813,2024.06.13
47,Friends Like That,John Morgan Feat. Jason Aldean,811,41,770,71,0,2039200,152900,1886300,944326,2024.06.13
48,Wind Up Missin' You,Tucker Wetmore,574,158,416,54,0,1925100,466900,1458200,7876409,2024.06.13
49,Wranglers,Miranda Lambert,783,26,757,98,0,1908300,59500,1848800,2158593,2024.06.13
50,I Tried A Ring On,Tigirlily Gold,962,-3,965,100,0,1766600,100900,1665700,867915,2024.06.13
51,Drinkin' Buddies,"Lee Brice, Hailey Whitters, And Nate Smith",571,6,565,86,0,1721000,-105300,1826300,446578,2024.06.13
52,Life With You,Kelsey Hart,847,-21,868,87,0,1616200,-55200,1671400,2486066,2024.06.13
53,Country Back,Randy Houser,594,31,563,77,0,1005800,-68100,1073900,102562,2024.06.13
54,King Of Country Music,Ryan Larkins,439,-7,446,63,0,915500,-42900,958400,9179,2024.06.13
55,This Heart,Corey Kent,460,-20,480,55,0,809900,-39700,849600,1393893,2024.06.13
56,Single Again,Josh Ross,509,6,503,72,0,809600,-53800,863400,2568672,2024.06.13
57,Fall Of Summer,Scotty McCreery,389,71,318,66,0,774600,210000,564600,430561,2024.06.13
58,Hometown Home,Locash,438,94,344,72,0,765600,50900,714700,226752,2024.06.13
59,Devil You Know,Tyler Braden,332,12,320,39,0,726600,143000,583600,4834568,2024.06.13
60,Roulette On The Heart,Conner Smith,409,32,377,57,0,723100,71200,651900,764726,2024.06.13
61,Holy Smokes,Bailey Zimmerman,209,122,87,24,0,697300,213500,483800,5366859,2024.06.13
62,Everything I Need,Chayce Beckham,385,12,373,55,0,685300,30900,654400,240138,2024.06.13
63,Break Mine,Brothers Osborne,295,12,283,40,0,592200,28600,563600,369253,2024.06.13
64,Country House,Sam Hunt,283,41,242,45,0,591900,-33400,625300,533583,2024.06.13
65,Things I Take For Granted,Larry Fleet,347,10,337,45,0,569900,15300,554600,907970,2024.06.13
66,Neon Baby,Annie Bosko,355,-11,366,48,0,542800,-22500,565300,16517,2024.06.13
67,The Devil I Know,Ashley McBryde,321,-3,324,40,0,535100,-38400,573500,645629,2024.06.13
68,Good On You,Priscilla Block,298,5,293,44,0,498400,21700,476700,804890,2024.06.13
69,Sweet Dreams,Koe Wetzel,174,103,71,14,0,468400,284600,183800,11982266,2024.06.13
70,Pray All The Way Home,Austin Snell,173,14,159,23,0,437200,127100,310100,1089085,2024.06.13
71,Strangers,Kameron Marlowe & Ella Langley,254,43,211,33,0,399000,20800,378200,2296488,2024.06.13
72,Dance Like No One’s Watching,Gabby Barrett,260,-20,280,31,0,389900,-128800,518700,425629,2024.06.13
73,Pink Skies,Zach Bryan,98,43,55,9,0,380400,184700,195700,27697740,2024.06.13
74,Mia Down In Mia,George Strait,58,-8,66,6,0,317600,-22300,339900,478311,2024.06.13
75,Uh-huh (Ajá),Frank Ray,275,-7,282,37,0,300400,8900,291500,33324,2024.06.13
76,Bury Me In This Bar,Dalton Dover,253,56,197,47,0,293800,-26800,320600,42855,2024.06.13
77,Wanna Be Loved,Red Clay Strays,57,57,0,56,0,285600,285600,0,3898709,2024.06.13
78,I Could Be That Rain,Randall King,130,41,89,17,0,255100,79500,175600,384706,2024.06.13
79,Never Been Over,Darius Rucker,186,1,185,31,0,225000,-35700,260700,460193,2024.06.13
80,Baby Daddy's Weekend,Elle King,176,14,162,26,0,196200,29100,167100,77737,2024.06.13
81,Wine Into Whiskey,Tucker Wetmore,60,-60,120,10,0,196200,-243200,439400,7373458,2024.06.13
82,Spin You Around (1/24),Morgan Wallen,66,-2,68,5,0,195000,-47500,242500,6204184,2024.06.13
83,No Caller Id,Megan Moroney,73,-23,96,3,0,178700,-98500,277200,2349750,2024.06.13
84,Young Man,Greylan James,36,6,30,3,0,174800,44600,130200,43165,2024.06.13
85,Two Night Stands,Kylie Morgan,130,-18,148,22,0,165000,-8500,173500,91615,2024.06.13
86,Worst Way,Riley Green,22,1,21,2,0,158600,17100,141500,4448612,2024.06.13
87,Beatles And Eagles,Frontmen,174,58,116,27,0,148100,9100,139000,1243,2024.06.13
88,Roots,Austin Burke,31,-4,35,1,0,132600,2900,129700,9804,2024.06.13
89,Songs About Whiskey,Anne Wilson,22,-2,24,3,0,132000,14500,117500,203254,2024.06.13
90,Iris,Mitchell Tenpenny,40,40,0,40,0,119500,119500,0,934373,2024.06.13
91,How Is She,Cole Swindell,20,5,15,1,0,109600,18500,91100,51426,2024.06.13
92,Wondering Why,Red Clay Strays,35,1,34,4,0,106900,24200,82700,6391863,2024.06.13
93,Broadway Girls,Lil Durk Feat. Morgan Wallen,26,14,12,11,0,103000,45900,57100,6173952,2024.06.13
94,Diamond And A Baby,Sarahbeth Taite,48,48,0,48,0,91500,91500,0,15008,2024.06.13
95,Workin' On A Beautiful Song,Lucie Silvas & John Osborne,47,47,0,47,0,91000,91000,0,0,2024.06.13
96,Truck On Fire,Carly Pearce,20,20,0,17,0,80000,80000,0,1531062,2024.06.13
97,What Would You Do?,Tucker Wetmore,17,17,0,16,0,78600,78600,0,2941562,2024.06.13
98,Indifferent,Megan Moroney,13,13,0,1,0,76600,76600,0,4201724,2024.06.13
99,Hey Driver,Zach Bryan Feat. The War and Treaty,29,-9,38,3,0,70300,-28000,98300,5819690,2024.06.13
100,Park,Tyler Hubbard,20,2,18,7,0,70200,19800,50400,806670,2024.06.13
101,The Star-Spangled Banner,Chris Stapleton,17,3,14,17,0,63200,1900,61300,98528,2024.06.13
102,When My Baby's In Boots,Randall King,4,1,3,1,0,56200,37700,18500,0,2024.06.13
103,The Man He Sees In Me,Luke Combs,15,14,1,7,0,53600,34900,18700,8487077,2024.06.13
104,My Place,Carly Pearce,14,14,0,12,0,53000,53000,0,125952,2024.06.13
105,Fault Line,Carly Pearce,13,13,0,11,0,51400,51400,0,184548,2024.06.13
105,Oklahoma,Carly Pearce,13,13,0,11,0,51400,51400,0,192959,2024.06.13
107,Country Music Made Me Do It,Carly Pearce,11,11,0,9,0,49900,49900,0,112689,2024.06.13
108,That's Texas,Cody Johnson,4,1,3,2,0,49500,20600,28900,305417,2024.06.13
109,Where That Came From,Randy Travis,9,-1,10,3,0,44900,-11500,56400,1145804,2024.06.13
110,Running Out Of Time,Wyatt Flores,17,0,17,1,0,44200,-17300,61500,457117,2024.06.13
111,Oklahoma Sooner,Jake Banfield,13,2,11,1,0,39800,6100,33700,3319,2024.06.13
112,Man Upstairs,Tim Dugger,8,-4,12,1,0,36100,-16800,52900,10783,2024.06.13
113,You In A Honky Tonk,Randall King,3,0,3,2,0,32300,25600,6700,323694,2024.06.13
114,Lighten That Load,Waylon Hanel,34,34,0,17,0,29600,29600,0,988,2024.06.13
115,Girl In Your Songs,Twinnie,33,17,16,17,0,29500,15500,14000,2820,2024.06.13
116,Goodbye You,Landon Parker,33,-18,51,17,0,29500,-14900,44400,774,2024.06.13
117,We Ain't The Only Ones,Randy Rogers & Wade Bowen,2,0,2,1,0,29200,12100,17100,0,2024.06.13
118,Paying For It,Levi Hummon,39,-23,62,9,0,29100,-28100,57200,89027,2024.06.13
119,Would If I Could (Feat. Lainey Wilson),Ernest,10,-7,17,1,0,28500,-12700,41200,1215237,2024.06.13
120,Acres,Brian Kelley,4,4,0,3,0,26100,26100,0,154771,2024.06.13
121,It's All Good 'Til It Ain't,Struggle Jennings & Caitlynne Curtis,13,1,12,1,0,26100,4600,21500,0,2024.06.13
122,Man On The Moon,Megan Moroney,16,16,0,3,0,25500,25500,0,2636363,2024.06.13
123,Am I The Only One,Aaron Lewis,6,3,3,2,0,23900,11800,12100,652204,2024.06.13
124,Work Boots,Cody Johnson,3,0,3,1,0,22800,-6200,29000,274800,2024.06.13
125,I Got A Problem,Drake Milligan,11,-2,13,1,0,20700,-3300,24000,54539,2024.06.13
126,I Just Wanna Be Mad,"Terri Clark, Cody Johnson",4,3,1,4,0,20600,16100,4500,276295,2024.06.13
127,You'll Always Be My Baby (Written For Daughters' Weddings),Alan Jackson,8,2,6,1,0,19200,5200,14000,49747,2024.06.13
128,Come On In,Kingdom Heirs,3,1,2,3,0,18600,7500,11100,2363,2024.06.13
129,Help Is On The Way,Gold City,3,0,3,3,0,18600,0,18600,15112,2024.06.13
130,Damn Good Time,Jordan Davis,5,0,5,1,0,17900,0,17900,215599,2024.06.13
131,"Poor, Poor Pitiful Me","Lainey Wilson, Terri Clark",4,3,1,4,0,17400,8000,9400,103312,2024.06.13
132,Here Comes Jesus,Jeff & Sheri Easter,2,1,1,1,0,17400,9900,7500,18315,2024.06.13
133,Last Rodeo,Restless Road,16,-12,28,6,0,17400,-31800,49200,518004,2024.06.13
134,Ain't That Some,Morgan Wallen,2,0,2,1,0,16800,0,16800,4851707,2024.06.13
135,Forgiven,Joseph Habedank,2,1,1,2,0,16600,9900,6700,2735,2024.06.13
136,Up In Texas,Midland,4,1,3,2,0,16300,10400,5900,95712,2024.06.13
137,Any Given Friday Night,Luke Combs,2,0,2,1,0,16000,0,16000,263973,2024.06.13
138,The Good I'Ll Do,Zach Bryan,3,3,0,1,0,15800,15800,0,2598383,2024.06.13
139,Dive,Luke Combs,2,1,1,1,0,15500,900,14600,1523501,2024.06.13
140,Give Me A Sunrise,Braxton Keith,2,0,2,1,0,15500,0,15500,55364,2024.06.13
141,Not Today,Mitchell Tenpenny,10,3,7,2,0,15400,11900,3500,463104,2024.06.13
142,Heaven On A Dirt Road,Jesse Felder,17,-17,34,17,0,14800,-14800,29600,0,2024.06.13
142,Ghost In My Chevy,Carson Wallace,17,-17,34,17,0,14800,-14800,29600,10565,2024.06.13
144,Follow,William Beckmann,1,1,0,1,0,14600,14600,0,5058,2024.06.13
145,Baby Do,Randall King,1,0,1,1,0,14600,13700,900,16427,2024.06.13
146,Love The Leavin',Drew Parker,1,-3,4,1,0,14600,-39400,54000,184854,2024.06.13
147,Revival Broke Out,Gaither Vocal Band,2,1,1,2,0,14200,7500,6700,1236,2024.06.13
148,Whose Rearview,Jason Aldean,2,1,1,1,0,13400,6800,6600,469471,2024.06.13
149,Days That End In Why,Morgan Wallen,7,2,5,2,0,13200,6300,6900,801174,2024.06.13
150,Good Day To Have A Great Day,Russell Dickerson,4,3,1,1,0,12500,9400,3100,480629,2024.06.13
151,This Side Of The Dirt,Neon Union,22,-4,26,5,0,12100,2200,9900,22121,2024.06.13
152,Breathe In Girl,Elizabeth Mary,7,1,6,1,0,12000,8600,3400,136,2024.06.13
153,There Is A Name,LeFevre Quartet,2,1,1,2,0,11900,7500,4400,1106,2024.06.13
154,Whatever Gets You Through It,Morgan Gruber,8,2,6,1,0,11400,-800,12200,151,2024.06.13
155,Midwest Rock & Roll,Ryan Hurd,1,1,0,1,0,11300,11300,0,166869,2024.06.13
156,He Pilots My Ship,Tribute Quartet,2,1,1,2,0,11100,4400,6700,765,2024.06.13
157,"I, John",Blackwood Brothers Quartet,2,0,2,2,0,11100,0,11100,44,2024.06.13
157,We Are The Church,Ernie Haase & Signature Sound,2,0,2,2,0,11100,0,11100,17844,2024.06.13
159,Oklahoma Smokeshow,Zach Bryan,4,3,1,1,0,10700,4700,6000,7471806,2024.06.13
160,Certified,Laura Bryna,14,0,14,1,0,10600,1600,9000,10772,2024.06.13
161,Whiskey Sour,Kane Brown,1,1,0,1,0,10100,10100,0,215573,2024.06.13
161,Dear Georgia,Kane Brown,1,1,0,1,0,10100,10100,0,87285,2024.06.13
163,Jesus Does,Lore Family,1,1,0,1,0,9900,9900,0,866,2024.06.13
164,Problems,12/Oc,5,1,4,1,0,8500,-4700,13200,2174,2024.06.13
165,John Deere Green,"HIXTAPE Feat. HARDY, Morgan Wallen, Joe Diffie",1,1,0,1,0,8300,8300,0,0,2024.06.13
166,Classic,Ernest,6,1,5,1,0,7900,3600,4300,25463,2024.06.13
167,Sun To Me,Zach Bryan,6,-2,8,1,0,7900,-600,8500,6915060,2024.06.13
168,My Bar,Priscilla Block,2,-7,9,1,0,7700,-41100,48800,119174,2024.06.13
169,Keepin' The Lights On,Kameron Marlowe,1,-4,5,1,0,7600,-17700,25300,127119,2024.06.13
170,By Your Grace,Cody Johnson,1,1,0,1,0,7500,7500,0,493333,2024.06.13
170,Sunday Sermons,Anne Wilson,1,1,0,1,0,7500,7500,0,555475,2024.06.13
170,Gettin' Ready To Breathe,Wes Hampton,1,1,0,1,0,7500,7500,0,18595,2024.06.13
173,Waiting For Me,Truesong,1,0,1,1,0,7500,3100,4400,708,2024.06.13
174,Mansions,Sound Street,1,0,1,1,0,7500,0,7500,711,2024.06.13
174,Checking In,For King & Country & Lee Brice,1,0,1,1,0,7500,0,7500,99040,2024.06.13
176,"Salt, Lime & Tequila",Ryan Griffin,1,1,0,1,0,7200,7200,0,82498,2024.06.13
177,Heart They Didn'T Break,Maddie & Tae,12,-2,14,1,0,6900,-2200,9100,216227,2024.06.13
178,Should'Ve Been A Cowboy,Jason Aldean,4,0,4,1,0,6800,0,6800,297936,2024.06.13
179,Heading In A New Direction,Elaine Roy,1,0,1,1,0,6700,6300,400,0,2024.06.13
180,When I Lift Up My Head,High Road,1,0,1,1,0,6700,0,6700,1792,2024.06.13
180,Sanding Off The Edges,Tim Menzies,1,0,1,1,0,6700,0,6700,244,2024.06.13
180,Part Of The Family,Littles,1,0,1,1,0,6700,0,6700,0,2024.06.13
180,After All,Mark Trammell Quartet,1,0,1,1,0,6700,0,6700,1831,2024.06.13
180,Fall Into Place,Jeff & Sheri Easter,1,0,1,1,0,6700,0,6700,817,2024.06.13
180,Dear Heavenly Father,11th Hour,1,0,1,1,0,6700,0,6700,2708,2024.06.13
180,There's A Song For That,Down East Boys,1,0,1,1,0,6700,0,6700,3016,2024.06.13
180,Door Wide Open,Gordon Mote,1,0,1,1,0,6700,0,6700,299,2024.06.13
180,Blue Collar Gospel,Jerry Salley,1,0,1,1,0,6700,0,6700,0,2024.06.13
180,Cross Over,Allens,1,0,1,1,0,6700,0,6700,13,2024.06.13
180,Peace Is,Sound,1,0,1,1,0,6700,0,6700,976,2024.06.13
180,Heaven Is Happening,Guardians,1,0,1,1,0,6700,0,6700,0,2024.06.13
180,Two Or Three,Collingsworth Family,1,0,1,1,0,6700,0,6700,9455,2024.06.13
180,Where You'Ve Walked,Lauren Talley,1,0,1,1,0,6700,0,6700,1016,2024.06.13
180,Made A Mess,Tim Menzies,1,0,1,1,0,6700,0,6700,152,2024.06.13
180,Preach The Word,Steve Ladd,1,0,1,1,0,6700,0,6700,75,2024.06.13
180,Be Ready,Karen Peck & New River,1,0,1,1,0,6700,0,6700,33756,2024.06.13
180,I Met Somebody On The Way To The Cemetery,Mark Bishop,1,0,1,1,0,6700,0,6700,0,2024.06.13
180,Praying For The Prodigal,Kingsmen,1,0,1,1,0,6700,0,6700,661,2024.06.13
199,My God,Scotty Inman,1,-1,2,1,0,6700,1900,4800,39511,2024.06.13
200,Your Healing Is On The Way,Greater Vision,1,-1,2,1,0,6700,-4400,11100,1009,2024.06.13
201,Meet Me At The Cross,Brian Free & Assurance,1,-1,2,1,0,6700,-7500,14200,4783,2024.06.13
1,I Had Some Help,Post Malone,7961,504,7457,144,0,31537000,1854200,29682800,40612423,2024.06.20
2,Your Place,Ashley Cooke,7747,1187,6560,145,0,27104000,4188100,22915900,1629855,2024.06.20
3,Cowgirls,Morgan Wallen,6877,995,5882,145,0,26299400,3641700,22657700,15975420,2024.06.20
4,Where It Ends,Bailey Zimmerman,6208,-457,6665,141,0,26016800,-1069400,27086200,5832301,2024.06.20
5,Take Her Home,Kenny Chesney,5799,-2453,8252,145,0,21776400,-8312200,30088600,1812016,2024.06.20
6,We Ride,Bryan Martin,6066,188,5878,145,0,21375000,520900,20854100,4751290,2024.06.20
7,Halfway To Hell,Jelly Roll,5670,-1383,7053,143,0,21159700,-5420300,26580000,3239644,2024.06.20
8,Bulletproof,Nate Smith,5374,6,5368,145,0,19782800,494000,19288800,7567120,2024.06.20
9,Let Your Boys Be Country,Jason Aldean,5705,198,5507,145,0,19736900,508300,19228600,2382770,2024.06.20
10,Young Love & Saturday Nights,Chris Young,5104,234,4870,145,0,18944800,963000,17981800,879137,2024.06.20
11,Dirt Cheap,Cody Johnson,4947,278,4669,145,0,17668000,233300,17434700,6324177,2024.06.20
12,She's Somebody's Daughter,Drew Baldridge,4491,527,3964,144,0,15628000,1956300,13671700,498971,2024.06.20
13,Ain't No Love In Oklahoma (From Twisters: The Album),Luke Combs,4044,465,3579,145,0,15116800,1214500,13902300,9752088,2024.06.20
14,We Don'T Fight Anymore,Carly Pearce,4484,331,4153,145,0,14445300,1255200,13190100,2700887,2024.06.20
15,Chevrolet,Dustin Lynch Feat. Jelly Roll,4007,225,3782,145,0,14148600,1061800,13086800,3175028,2024.06.20
16,Love You Again,Chase Matthew,4202,114,4088,145,0,14102900,710400,13392500,2430560,2024.06.20
17,A Bar Song (Tipsy),Shaboozey,3463,607,2856,144,0,13858400,3257500,10600900,40695105,2024.06.20
18,I'M Not Pretty,Megan Moroney,3431,-28,3459,144,0,11032400,-51600,11084000,2169119,2024.06.20
19,Hang Tight Honey,Lainey Wilson,2880,-81,2961,145,0,10333300,-115400,10448700,3528646,2024.06.20
20,This Is My Dirt,Justin Moore,2941,210,2731,144,0,9389800,555300,8834500,553739,2024.06.20
21,One Bad Habit,Tim McGraw,2867,-72,2939,145,0,9383200,240500,9142700,649183,2024.06.20
22,Austin,Dasha,2082,184,1898,139,0,7616100,1112500,6503600,14865349,2024.06.20
23,"Love You, Miss You, Mean It",Luke Bryan,2255,116,2139,143,0,7282500,326800,6955700,2937685,2024.06.20
24,Messed Up As Me,Keith Urban,2182,122,2060,140,0,6192300,365800,5826500,1488339,2024.06.20
25,Gonna Love You,Parmalee,2027,-22,2049,143,0,6005700,-243000,6248700,313065,2024.06.20
26,Dance With You,Brett Young,2092,143,1949,140,0,5684700,108700,5576000,655942,2024.06.20
27,Beautiful As You,Thomas Rhett,1705,100,1605,136,0,5514600,497900,5016700,5676365,2024.06.20
28,Sounds Like The Radio,Zach Top,1779,121,1658,137,0,5083800,418900,4664900,896401,2024.06.20
29,Bigger Houses,Dan + Shay,1812,111,1701,138,0,4848400,224900,4623500,1465907,2024.06.20
30,I Am Not Okay,Jelly Roll,1058,-543,1601,103,0,4575100,-2479700,7054800,11320670,2024.06.20
31,Over When We'Re Sober,Brantley Gilbert,977,977,0,92,0,4223400,4223400,0,439,2024.06.20
32,Miles On It,Marshmello & Kane Brown,1374,-9,1383,134,0,4147600,81900,4065700,13331825,2024.06.20
33,American Girl,Dierks Bentley,1401,27,1374,134,0,4071100,214400,3856700,619287,2024.06.20
34,Cowboy Songs,George Birge,1361,42,1319,123,0,3968400,128200,3840200,656857,2024.06.20
35,Damn Good Day To Leave,Riley Green,1200,35,1165,114,0,3739400,253700,3485700,1180864,2024.06.20
36,Boys Back Home,Dylan Marlowe Feat. Dylan Scott,1164,-20,1184,106,0,3456900,102900,3354000,3447935,2024.06.20
37,Called Crazy,Kassi Ashton,727,-9,736,49,0,3218700,-76100,3294800,310472,2024.06.20
38,Think I’m In Love With You,Chris Stapleton,1016,70,946,94,0,3016300,130300,2886000,7558124,2024.06.20
39,Wind Up Missin' You,Tucker Wetmore,831,257,574,70,0,2728200,803100,1925100,7355391,2024.06.20
40,Breakin' In Boots,Matt Stell,1213,29,1184,116,0,2596700,-371300,2968000,1191679,2024.06.20
41,Whatcha See Is Whatcha Get,Chris Janson,1026,29,997,110,0,2543100,98900,2444200,192526,2024.06.20
42,Find Another Bar,Chris Lane,1273,94,1179,132,0,2542300,77900,2464400,114556,2024.06.20
43,This Town's Been Too Good To Us,Dylan Scott,978,67,911,102,0,2488400,153900,2334500,2558909,2024.06.20
44,Friends Like That,John Morgan Feat. Jason Aldean,857,46,811,83,0,2320400,281200,2039200,986231,2024.06.20
45,Forever To Me,Cole Swindell,705,29,676,77,0,2310700,78900,2231800,1495781,2024.06.20
46,Tie Up,Zac Brown Band,999,-32,1031,123,0,2214800,-739600,2954400,646060,2024.06.20
47,I Tried A Ring On,Tigirlily Gold,1022,60,962,106,0,2059500,292900,1766600,932411,2024.06.20
48,Wranglers,Miranda Lambert,767,-16,783,97,0,1901300,-7000,1908300,2097528,2024.06.20
49,Drinkin' Buddies,"Lee Brice, Hailey Whitters, And Nate Smith",561,-10,571,87,0,1735300,14300,1721000,449387,2024.06.20
50,Life With You,Kelsey Hart,850,3,847,89,0,1656400,40200,1616200,2591783,2024.06.20
51,SIX FEET UNDER (Caleigh's Song),Hardy,487,-341,828,72,0,1584500,-1542200,3126700,1841360,2024.06.20
52,Devil You Know,Tyler Braden,399,67,332,43,0,1030600,304000,726600,5196225,2024.06.20
53,Country Back,Randy Houser,608,14,594,75,0,984600,-21200,1005800,96060,2024.06.20
54,Hometown Home,Locash,481,43,438,67,0,917500,151900,765600,200166,2024.06.20
55,King Of Country Music,Ryan Larkins,407,-32,439,61,0,895900,-19600,915500,11628,2024.06.20
56,Holy Smokes,Bailey Zimmerman,278,69,209,33,0,889700,192400,697300,5206907,2024.06.20
57,Fall Of Summer,Scotty McCreery,400,11,389,68,0,876600,102000,774600,369922,2024.06.20
58,This Heart,Corey Kent,477,17,460,54,0,838000,28100,809900,1364300,2024.06.20
59,Single Again,Josh Ross,480,-29,509,73,0,735400,-74200,809600,2634295,2024.06.20
60,Everything I Need,Chayce Beckham,399,14,385,56,0,709400,24100,685300,228821,2024.06.20
61,Roulette On The Heart,Conner Smith,394,-15,409,56,0,616100,-107000,723100,761251,2024.06.20
62,Country House,Sam Hunt,285,2,283,49,0,587600,-4300,591900,517414,2024.06.20
63,Things I Take For Granted,Larry Fleet,338,-9,347,48,0,567800,-2100,569900,949581,2024.06.20
64,Break Mine,Brothers Osborne,289,-6,295,39,0,556000,-36200,592200,348860,2024.06.20
65,Neon Baby,Annie Bosko,353,-2,355,47,0,544900,2100,542800,16134,2024.06.20
66,The Devil I Know,Ashley McBryde,322,1,321,38,0,515400,-19700,535100,743609,2024.06.20
67,Good On You,Priscilla Block,283,-15,298,43,0,456400,-42000,498400,829314,2024.06.20
68,Sweet Dreams,Koe Wetzel,164,-10,174,15,0,409700,-58700,468400,10206283,2024.06.20
69,Pray All The Way Home,Austin Snell,154,-19,173,31,0,408800,-28400,437200,1009511,2024.06.20
70,Strangers,Kameron Marlowe & Ella Langley,278,24,254,43,0,403100,4100,399000,2247672,2024.06.20
71,Bury Me In This Bar,Dalton Dover,294,41,253,48,0,386200,92400,293800,40606,2024.06.20
72,Dance Like No One’s Watching,Gabby Barrett,245,-15,260,31,0,348800,-41100,389900,424934,2024.06.20
73,Uh-huh (Ajá),Frank Ray,271,-4,275,38,0,300600,200,300400,33158,2024.06.20
74,The Man He Sees In Me,Luke Combs,75,60,15,10,0,294700,241100,53600,11244455,2024.06.20
75,Sad Girl Summer,Maddie & Tae,57,57,0,56,0,284100,284100,0,474049,2024.06.20
76,Pink Skies,Zach Bryan,91,-7,98,7,0,283600,-96800,380400,25488014,2024.06.20
77,Beatles And Eagles,Frontmen,190,16,174,28,0,263900,115800,148100,1042,2024.06.20
78,Young Man,Greylan James,46,10,36,3,0,243600,68800,174800,40362,2024.06.20
79,Never Been Over,Darius Rucker,179,-7,186,32,0,234200,9200,225000,454081,2024.06.20
80,Mia Down In Mia,George Strait,37,-21,58,5,0,216900,-100700,317600,460787,2024.06.20
81,Opening Act,Raging Idiots,39,39,0,39,0,188000,188000,0,0,2024.06.20
81,Better Things To Do,"Ashley Mcbryde, Terri Clark",39,39,0,39,0,188000,188000,0,19309,2024.06.20
83,I Could Be That Rain,Randall King,140,10,130,17,0,177000,-78100,255100,357622,2024.06.20
84,Baby Daddy's Weekend,Elle King,167,-9,176,29,0,176400,-19800,196200,59217,2024.06.20
85,Spin You Around (1/24),Morgan Wallen,55,-11,66,15,0,159200,-35800,195000,6155434,2024.06.20
86,Songs About Whiskey,Anne Wilson,24,2,22,3,0,144000,12000,132000,204152,2024.06.20
87,Two Night Stands,Kylie Morgan,115,-15,130,22,0,143600,-21400,165000,99893,2024.06.20
88,Park,Tyler Hubbard,83,63,20,21,0,138900,68700,70200,769801,2024.06.20
89,Roots,Austin Burke,32,1,31,1,0,119800,-12800,132600,9604,2024.06.20
90,How Is She,Cole Swindell,18,-2,20,1,0,112800,3200,109600,48360,2024.06.20
91,Big Blue Sky,Jackson Dean,23,23,0,21,0,109600,109600,0,183425,2024.06.20
92,Wine Into Whiskey,Tucker Wetmore,32,-28,60,3,0,108200,-88000,196200,8374115,2024.06.20
93,Wondering Why,Red Clay Strays,34,-1,35,4,0,103300,-3600,106900,5053103,2024.06.20
94,Counterfeit You,Nikita Karmen,48,48,0,48,0,93300,93300,0,4645,2024.06.20
94,Whether You Love Me Or Not,Meghan Patrick,48,48,0,48,0,93300,93300,0,75765,2024.06.20
96,Worst Way,Riley Green,19,-3,22,2,0,90500,-68100,158600,4598568,2024.06.20
97,Take You With Me,Luke Combs,17,17,0,16,0,78500,78500,0,332563,2024.06.20
98,Where That Came From,Randy Travis,10,1,9,3,0,73400,28500,44900,1097511,2024.06.20
99,Love The Leavin',Drew Parker,47,46,1,10,0,67800,53200,14600,201075,2024.06.20
100,Take Me Out To The Ballgame,Luke Combs,12,12,0,4,0,67500,67500,0,3208365,2024.06.20
101,Remember Him That Way,Luke Combs,15,14,1,5,0,67100,62400,4700,11293371,2024.06.20
102,Hey Driver,Zach Bryan Feat. The War and Treaty,29,0,29,3,0,66500,-3800,70300,6055912,2024.06.20
103,Good Day To Have A Great Day,Russell Dickerson,17,13,4,1,0,59100,46600,12500,484687,2024.06.20
104,No Caller Id,Megan Moroney,23,-50,73,3,0,54400,-124300,178700,2102381,2024.06.20
105,The Star-Spangled Banner,Chris Stapleton,10,-7,17,10,0,51800,-11400,63200,97557,2024.06.20
106,Broadway Girls,Lil Durk Feat. Morgan Wallen,15,-11,26,2,0,49700,-53300,103000,6178683,2024.06.20
107,Whoever You Turn Out To Be,Luke Combs,8,8,0,2,0,44700,44700,0,3813880,2024.06.20
108,Huntin' By Yourself,Luke Combs,6,6,0,2,0,43700,43700,0,4881756,2024.06.20
109,Man Upstairs,Tim Dugger,9,1,8,1,0,42500,6400,36100,11631,2024.06.20
110,Man On The Moon,Megan Moroney,9,-7,16,1,0,40100,14600,25500,2208481,2024.06.20
111,Work Boots,Cody Johnson,3,0,3,1,0,39400,16600,22800,254682,2024.06.20
112,Running Out Of Time,Wyatt Flores,15,-2,17,1,0,38000,-6200,44200,406451,2024.06.20
113,Ride Around Heaven,Luke Combs,8,8,0,4,0,36700,36700,0,3209055,2024.06.20
114,It's All Good 'Til It Ain't,Struggle Jennings & Caitlynne Curtis,18,5,13,1,0,35100,9000,26100,0,2024.06.20
115,Truck On Fire,Carly Pearce,8,-12,20,8,0,32900,-47100,80000,739833,2024.06.20
116,Paying For It,Levi Hummon,39,0,39,9,0,31100,2000,29100,88617,2024.06.20
117,You In A Honky Tonk,Randall King,3,0,3,2,0,30600,-1700,32300,329368,2024.06.20
118,Daddy's Truck,Conner Sweet,34,34,0,17,0,29600,29600,0,6569,2024.06.20
119,I Got A Problem,Drake Milligan,13,2,11,1,0,29200,8500,20700,53542,2024.06.20
120,Am I The Only One,Aaron Lewis,5,-1,6,1,0,28600,4700,23900,626311,2024.06.20
121,Oklahoma Sooner,Jake Banfield,9,-4,13,1,0,28500,-11300,39800,3404,2024.06.20
122,Not Today,Mitchell Tenpenny,16,6,10,11,0,28400,13000,15400,341678,2024.06.20
123,Just To Say We Did,Kenny Chesney,4,4,0,3,0,26100,26100,0,303003,2024.06.20
124,Front Door Famous,Luke Combs,4,4,0,3,0,24100,24100,0,5374857,2024.06.20
125,Acres,Brian Kelley,8,4,4,4,0,23300,-2800,26100,169056,2024.06.20
126,All I Ever Do Is Leave,Luke Combs,3,3,0,1,0,21600,21600,0,3491262,2024.06.20
127,My God,Scotty Inman,3,2,1,3,0,21000,14300,6700,32813,2024.06.20
128,Porch,Scotty McCreery,4,4,0,4,0,20800,20800,0,49984,2024.06.20
128,Those Boots (Deddy's Song),Lainey Wilson,4,4,0,4,0,20800,20800,0,144313,2024.06.20
130,My Place,Carly Pearce,7,-7,14,7,0,20700,-32300,53000,85716,2024.06.20
131,Indifferent,Megan Moroney,5,-8,13,1,0,20600,-56000,76600,4039512,2024.06.20
132,Long Live Cowgirls,Ian Munsick & Cody Johnson,13,2,11,4,0,20200,16300,3900,755731,2024.06.20
133,What Would You Do?,Tucker Wetmore,8,-9,17,1,0,19900,-58700,78600,2745972,2024.06.20
134,A Little Bit Closer,Braxton Keith,3,2,1,1,0,19600,18700,900,132438,2024.06.20
135,Give Me A Sunrise,Braxton Keith,3,1,2,1,0,19600,4100,15500,67098,2024.06.20
136,Fiddle In The Band,Kane Brown,2,2,0,2,0,19100,19100,0,867331,2024.06.20
137,That's Texas,Cody Johnson,3,-1,4,1,0,18500,-31000,49500,289451,2024.06.20
138,Country Music Made Me Do It,Carly Pearce,6,-5,11,6,0,18200,-31700,49900,54125,2024.06.20
139,Sunrise Tells The Story,Midland,2,0,2,1,0,17600,15800,1800,159997,2024.06.20
140,Little Miss Runner Up,Gretchen Wilson,3,3,0,3,0,16900,16900,0,67727,2024.06.20
141,On The Boat Again,Jake Owen,2,2,0,1,0,16000,16000,0,128151,2024.06.20
142,Any Given Friday Night,Luke Combs,2,0,2,1,0,16000,0,16000,246375,2024.06.20
143,"Salt, Lime & Tequila",Ryan Griffin,4,3,1,1,0,15700,8500,7200,82626,2024.06.20
144,Baby Do,Randall King,1,0,1,1,0,14600,0,14600,16744,2024.06.20
145,Up In Texas,Midland,1,-3,4,1,0,14600,-1700,16300,81516,2024.06.20
146,When My Baby's In Boots,Randall King,1,-3,4,1,0,14600,-41600,56200,0,2024.06.20
147,Ain't That Some,Morgan Wallen,3,1,2,2,0,14500,-2300,16800,5111489,2024.06.20
148,Damn Good Time,Jordan Davis,4,-1,5,1,0,14400,-3500,17900,251804,2024.06.20
149,Waiting For Me,Truesong,2,1,1,2,0,14300,6800,7500,747,2024.06.20
150,Wasted Words,Craguns,2,2,0,2,0,14200,14200,0,65,2024.06.20
151,My Bar,Priscilla Block,4,2,2,2,0,13000,5300,7700,121206,2024.06.20
152,Heart They Didn'T Break,Maddie & Tae,14,2,12,2,0,12700,5800,6900,207675,2024.06.20
153,Whatever Gets You Through It,Morgan Gruber,8,0,8,1,0,12700,1300,11400,339,2024.06.20
154,Star Spangled Banner,Mickey Guyton,2,1,1,2,0,12400,9200,3200,0,2024.06.20
155,'98 Braves,Morgan Wallen,3,2,1,2,0,11200,8600,2600,2108286,2024.06.20
156,Wings Of A Dove,Jonathan Wilburn,2,1,1,2,0,11100,6700,4400,0,2024.06.20
157,We Are The Church,Ernie Haase & Signature Sound,2,0,2,2,0,11100,0,11100,21451,2024.06.20
157,He Pilots My Ship,Tribute Quartet,2,0,2,2,0,11100,0,11100,885,2024.06.20
157,"I, John",Blackwood Brothers Quartet,2,0,2,2,0,11100,0,11100,43,2024.06.20
160,Help Is On The Way,Gold City,2,-1,3,2,0,11100,-7500,18600,18988,2024.06.20
161,Fox In The Henhouse,Luke Combs,1,1,0,1,0,10200,10200,0,143807,2024.06.20
162,Honky Tonk Hardwood Floors,Cody Johnson,1,1,0,1,0,10100,10100,0,107075,2024.06.20
163,The Good I'Ll Do,Zach Bryan,4,1,3,1,0,10000,-5800,15800,2675000,2024.06.20
164,Do It For You,Jason Crabb,1,1,0,1,0,9900,9900,0,3724,2024.06.20
164,Means Something To Me,Tate Emmons,1,1,0,1,0,9900,9900,0,510,2024.06.20
164,I'm So Blessed,CAIN,1,1,0,1,0,9900,9900,0,698436,2024.06.20
167,Sunday Sermons,Anne Wilson,1,0,1,1,0,9900,2400,7500,557811,2024.06.20
168,You'll Always Be My Baby (Written For Daughters' Weddings),Alan Jackson,5,-3,8,1,0,9800,-9400,19200,52036,2024.06.20
169,Certified,Laura Bryna,13,-1,14,1,0,9600,-1000,10600,7510,2024.06.20
170,Record High,Randall King,3,3,0,2,0,9500,9500,0,22281,2024.06.20
171,Oklahoma Smokeshow,Zach Bryan,3,-1,4,2,0,9400,-1300,10700,7385490,2024.06.20
172,Heartfirst,Kelsea Ballerini,3,2,1,2,0,9200,3900,5300,337573,2024.06.20
173,My America (I Still Believe),Danny Gokey,5,2,3,1,0,9000,6400,2600,6531,2024.06.20
174,Miss My Daddy,Tyler Hubbard,1,1,0,1,0,8500,8500,0,14920,2024.06.20
175,My Old Man Was Right,Luke Combs,1,1,0,1,0,8300,8300,0,3079247,2024.06.20
176,Already Had It,Tucker Wetmore,2,2,0,1,0,8000,8000,0,707960,2024.06.20
177,Buckles And Broken Hearts,Joe Peters,1,1,0,1,0,7800,7800,0,788,2024.06.20
178,I'Ve Seen Me Do It,Joe Peters,1,0,1,1,0,7800,2500,5300,308,2024.06.20
179,God's Been Good,LeFevre Quartet,1,1,0,1,0,7500,7500,0,892,2024.06.20
179,What God Can Do,Endless Highway,1,1,0,1,0,7500,7500,0,201,2024.06.20
181,Checking In,For King & Country & Lee Brice,1,0,1,1,0,7500,0,7500,100650,2024.06.20
182,Here Comes Jesus,Jeff & Sheri Easter,1,-1,2,1,0,7500,-9900,17400,18058,2024.06.20
183,Heart Of A Small Town,Tim Dugger,1,-1,2,1,0,7400,5400,2000,21577,2024.06.20
184,Problems,12/Oc,3,-2,5,1,0,7300,-1200,8500,1471,2024.06.20
185,Build A Bridge,Ashley Cooke,3,0,3,1,0,7100,1000,6100,7272,2024.06.20
186,Rainin On Me,Wade Bowen,9,2,7,3,0,7000,2500,4500,17936,2024.06.20
187,Last Rodeo,Restless Road,7,-9,16,3,0,7000,-10400,17400,322679,2024.06.20
188,Double Down,Cody Johnson,1,1,0,1,0,6800,6800,0,142560,2024.06.20
189,Nothing But Love Songs,Randy Rogers Band,2,1,1,2,0,6800,2500,4300,9065,2024.06.20
190,Should'Ve Been A Cowboy,Jason Aldean,4,0,4,1,0,6800,0,6800,218705,2024.06.20
191,Whose Rearview,Jason Aldean,1,-1,2,1,0,6800,-6600,13400,499844,2024.06.20
192,The Only Way He Knew How,Jeff & Sheri Easter,1,1,0,1,0,6700,6700,0,592,2024.06.20
192,My Constant Savior,Donna Ulisse,1,1,0,1,0,6700,6700,0,37,2024.06.20
192,It Won't Be Long,Poet Voices,1,1,0,1,0,6700,6700,0,9607,2024.06.20
192,I'M Forgiven,Kingdom Heirs,1,1,0,1,0,6700,6700,0,2515,2024.06.20
192,Pb&J,Todd Tilghman,1,1,0,1,0,6700,6700,0,266,2024.06.20
192,Hole In The Heart,Nelons,1,1,0,1,0,6700,6700,0,0,2024.06.20
192,Jesus In A Faded Ford,Nathan Woodard,1,1,0,1,0,6700,6700,0,11,2024.06.20
199,He Forgives And Forgets,Gordon Mote,1,0,1,1,0,6700,6300,400,503,2024.06.20
199,Front Porch Sittin',Zane & Donna King,1,0,1,1,0,6700,6300,400,0,2024.06.20
201,Meet Me At The Cross,Brian Free & Assurance,1,0,1,1,0,6700,0,6700,5054,2024.06.20
201,Cross Over,Allens,1,0,1,1,0,6700,0,6700,18,2024.06.20
201,Be Ready,Karen Peck & New River,1,0,1,1,0,6700,0,6700,24825,2024.06.20
201,After All,Mark Trammell Quartet,1,0,1,1,0,6700,0,6700,1552,2024.06.20
201,When I Lift Up My Head,High Road,1,0,1,1,0,6700,0,6700,2038,2024.06.20
201,Fall Into Place,Jeff & Sheri Easter,1,0,1,1,0,6700,0,6700,689,2024.06.20
201,Your Healing Is On The Way,Greater Vision,1,0,1,1,0,6700,0,6700,763,2024.06.20
201,There's A Song For That,Down East Boys,1,0,1,1,0,6700,0,6700,2472,2024.06.20
201,Heaven Is Happening,Guardians,1,0,1,1,0,6700,0,6700,0,2024.06.20
201,Part Of The Family,Littles,1,0,1,1,0,6700,0,6700,0,2024.06.20
211,Revival Broke Out,Gaither Vocal Band,1,-1,2,1,0,6700,-7500,14200,1208,2024.06.20
212,Forgiven,Joseph Habedank,1,-1,2,1,0,6700,-9900,16600,2682,2024.06.20
1,I Had Some Help,Post Malone,8163,202,7961,144,0,32447700,910700,31537000,39526339,2024.06.27
2,Cowgirls,Morgan Wallen,7707,830,6877,145,0,29231700,2932300,26299400,16235521,2024.06.27
3,We Ride,Bryan Martin,6263,197,6066,145,0,22505900,1130900,21375000,4707078,2024.06.27
4,Bulletproof,Nate Smith,5636,262,5374,145,0,20442200,659400,19782800,6901892,2024.06.27
5,Let Your Boys Be Country,Jason Aldean,5885,180,5705,145,0,20313900,577000,19736900,2551537,2024.06.27
6,Your Place,Ashley Cooke,5227,-2520,7747,145,0,19398400,-7705600,27104000,1930189,2024.06.27
7,Young Love & Saturday Nights,Chris Young,5169,65,5104,145,0,19383700,438900,18944800,825228,2024.06.27
8,We Don'T Fight Anymore,Carly Pearce,6021,1537,4484,145,0,18619600,4174300,14445300,2569931,2024.06.27
9,Dirt Cheap,Cody Johnson,5202,255,4947,145,0,18429000,761000,17668000,6348777,2024.06.27
10,She's Somebody's Daughter,Drew Baldridge,4824,333,4491,144,0,17145800,1517800,15628000,499449,2024.06.27
11,A Bar Song (Tipsy),Shaboozey,4283,820,3463,144,0,17103100,3244700,13858400,41597706,2024.06.27
12,Ain't No Love In Oklahoma (From Twisters: The Album),Luke Combs,4283,239,4044,145,0,15539100,422300,15116800,8786445,2024.06.27
13,Chevrolet,Dustin Lynch Feat. Jelly Roll,4178,171,4007,144,0,14705900,557300,14148600,3152149,2024.06.27
14,Love You Again,Chase Matthew,4052,-150,4202,145,0,13701000,-401900,14102900,1973080,2024.06.27
15,I'M Not Pretty,Megan Moroney,3592,161,3431,144,0,11430900,398500,11032400,2119799,2024.06.27
16,Hang Tight Honey,Lainey Wilson,3021,141,2880,145,0,10661800,328500,10333300,4000585,2024.06.27
17,One Bad Habit,Tim McGraw,2994,127,2867,145,0,9835100,451900,9383200,558441,2024.06.27
18,This Is My Dirt,Justin Moore,3000,59,2941,144,0,9442400,52600,9389800,544846,2024.06.27
19,Austin,Dasha,2504,422,2082,140,0,9157900,1541800,7616100,14448331,2024.06.27
20,"Love You, Miss You, Mean It",Luke Bryan,2427,172,2255,143,0,7814700,532200,7282500,2723369,2024.06.27
21,I Am Not Okay,Jelly Roll,1667,609,1058,125,0,6870300,2295200,4575100,11781622,2024.06.27
22,Messed Up As Me,Keith Urban,2255,73,2182,140,0,6426900,234600,6192300,1464938,2024.06.27
23,Gonna Love You,Parmalee,2151,124,2027,144,0,6264300,258600,6005700,297211,2024.06.27
24,Beautiful As You,Thomas Rhett,1938,233,1705,136,0,6082100,567500,5514600,5397545,2024.06.27
25,Dance With You,Brett Young,2038,-54,2092,140,0,5448500,-236200,5684700,641590,2024.06.27
26,Cowboys Cry Too,Kelsea Ballerini,1191,1191,0,98,0,5071700,5071700,0,0,2024.06.27
27,Bigger Houses,Dan + Shay,1896,84,1812,139,0,5064700,216300,4848400,1329615,2024.06.27
28,Sounds Like The Radio,Zach Top,1764,-15,1779,137,0,4868300,-215500,5083800,891554,2024.06.27
29,Miles On It,Marshmello & Kane Brown,1552,178,1374,135,0,4601200,453600,4147600,13468965,2024.06.27
30,American Girl,Dierks Bentley,1457,56,1401,135,0,4337300,266200,4071100,660631,2024.06.27
31,Damn Good Day To Leave,Riley Green,1398,198,1200,125,0,4268500,529100,3739400,1250840,2024.06.27
32,Cowboy Songs,George Birge,1468,107,1361,131,0,3835600,-132800,3968400,606395,2024.06.27
33,Boys Back Home,Dylan Marlowe Feat. Dylan Scott,1203,39,1164,110,0,3613800,156900,3456900,3161436,2024.06.27
34,Called Crazy,Kassi Ashton,791,64,727,52,0,3403200,184500,3218700,443529,2024.06.27
35,Think I’m In Love With You,Chris Stapleton,1065,49,1016,100,0,3311500,295200,3016300,6380083,2024.06.27
36,Wind Up Missin' You,Tucker Wetmore,990,159,831,72,0,3082600,354400,2728200,7513938,2024.06.27
37,Pour Me A Drink,Post Malone,633,632,1,46,0,2803900,2799100,4800,19436995,2024.06.27
38,Whatcha See Is Whatcha Get,Chris Janson,1097,71,1026,110,0,2673000,129900,2543100,174120,2024.06.27
39,Find Another Bar,Chris Lane,1233,-40,1273,132,0,2659300,117000,2542300,101824,2024.06.27
40,Breakin' In Boots,Matt Stell,1216,3,1213,116,0,2580800,-15900,2596700,1144529,2024.06.27
41,Friends Like That,John Morgan Feat. Jason Aldean,914,57,857,89,0,2432600,112200,2320400,849998,2024.06.27
42,Forever To Me,Cole Swindell,790,85,705,82,0,2373300,62600,2310700,1465996,2024.06.27
43,This Town's Been Too Good To Us,Dylan Scott,952,-26,978,99,0,2324200,-164200,2488400,2273831,2024.06.27
44,SIX FEET UNDER (Caleigh's Song),Hardy,642,155,487,77,0,2212900,628400,1584500,1578425,2024.06.27
45,Tie Up,Zac Brown Band,1047,48,999,125,0,2143100,-71700,2214800,856040,2024.06.27
46,Wranglers,Miranda Lambert,819,52,767,99,0,2062000,160700,1901300,1800034,2024.06.27
47,Drinkin' Buddies,"Lee Brice, Hailey Whitters, And Nate Smith",628,67,561,82,0,2027000,291700,1735300,449630,2024.06.27
48,I Tried A Ring On,Tigirlily Gold,1080,58,1022,127,0,2008800,-50700,2059500,780372,2024.06.27
49,Life With You,Kelsey Hart,860,10,850,89,0,1773900,117500,1656400,2089854,2024.06.27
50,Country Back,Randy Houser,699,91,608,78,0,1220000,235400,984600,86399,2024.06.27
51,Devil You Know,Tyler Braden,444,45,399,53,0,1092500,61900,1030600,4816417,2024.06.27
52,Hometown Home,Locash,523,42,481,79,0,1074000,156500,917500,175283,2024.06.27
53,Fall Of Summer,Scotty McCreery,453,53,400,68,0,1033100,156500,876600,605468,2024.06.27
54,Holy Smokes,Bailey Zimmerman,319,41,278,45,0,1006300,116600,889700,5344077,2024.06.27
55,Single Again,Josh Ross,522,42,480,74,0,810200,74800,735400,2582948,2024.06.27
56,This Heart,Corey Kent,463,-14,477,54,0,744600,-93400,838000,1212773,2024.06.27
57,Country House,Sam Hunt,329,44,285,64,0,743600,156000,587600,511088,2024.06.27
58,Everything I Need,Chayce Beckham,410,11,399,57,0,699800,-9600,709400,203604,2024.06.27
59,Roulette On The Heart,Conner Smith,423,29,394,57,0,657800,41700,616100,677387,2024.06.27
60,King Of Country Music,Ryan Larkins,400,-7,407,62,0,643800,-252100,895900,10574,2024.06.27
61,Over When We'Re Sober,Brantley Gilbert,157,-820,977,38,0,640600,-3582800,4223400,1687028,2024.06.27
62,The Devil I Know,Ashley McBryde,334,12,322,38,0,577800,62400,515400,708406,2024.06.27
63,Neon Baby,Annie Bosko,366,13,353,48,0,575600,30700,544900,15759,2024.06.27
64,Break Mine,Brothers Osborne,301,12,289,44,0,550600,-5400,556000,333099,2024.06.27
65,Strangers,Kameron Marlowe & Ella Langley,379,101,278,45,0,548800,145700,403100,2278319,2024.06.27
66,Things I Take For Granted,Larry Fleet,339,1,338,47,0,523200,-44600,567800,680899,2024.06.27
67,Dance Like No One’s Watching,Gabby Barrett,306,61,245,43,0,381200,32400,348800,397747,2024.06.27
68,Good On You,Priscilla Block,253,-30,283,42,0,374000,-82400,456400,697379,2024.06.27
69,Pink Skies,Zach Bryan,116,25,91,7,0,349900,66300,283600,22225885,2024.06.27
70,Pray All The Way Home,Austin Snell,138,-16,154,22,0,348300,-60500,408800,940562,2024.06.27
71,Bury Me In This Bar,Dalton Dover,279,-15,294,48,0,342000,-44200,386200,40166,2024.06.27
72,Park,Tyler Hubbard,201,118,83,32,0,315500,176600,138900,1161981,2024.06.27
73,Counterfeit You,Nikita Karmen,57,9,48,56,0,287400,194100,93300,4861,2024.06.27
74,Uh-huh (Ajá),Frank Ray,258,-13,271,39,0,263400,-37200,300600,30136,2024.06.27
75,Beatles And Eagles,Frontmen,200,10,190,30,0,259800,-4100,263900,862,2024.06.27
76,Young Man,Greylan James,42,-4,46,3,0,248100,4500,243600,39080,2024.06.27
77,Never Been Over,Darius Rucker,188,9,179,33,0,226100,-8100,234200,301785,2024.06.27
78,Sweet Dreams,Koe Wetzel,134,-30,164,15,0,223400,-186300,409700,8639652,2024.06.27
79,Baby Daddy's Weekend,Elle King,207,40,167,33,0,220800,44400,176400,57372,2024.06.27
80,Spin You Around (1/24),Morgan Wallen,59,4,55,3,0,178400,19200,159200,5996180,2024.06.27
81,I Could Be That Rain,Randall King,114,-26,140,18,0,158200,-18800,177000,332299,2024.06.27
82,Acres,Brian Kelley,131,123,8,34,0,155900,132600,23300,171933,2024.06.27
83,Mia Down In Mia,George Strait,23,-14,37,5,0,145900,-71000,216900,353736,2024.06.27
84,Wine Into Whiskey,Tucker Wetmore,31,-1,32,3,0,141200,33000,108200,7763279,2024.06.27
85,Worst Way,Riley Green,28,9,19,2,0,137700,47200,90500,5108604,2024.06.27
86,How Is She,Cole Swindell,21,3,18,1,0,132700,19900,112800,50074,2024.06.27
87,Songs About Whiskey,Anne Wilson,18,-6,24,2,0,132100,-11900,144000,195392,2024.06.27
88,Better Things To Do,"Ashley Mcbryde, Terri Clark",18,-21,39,17,0,121500,-66500,188000,18129,2024.06.27
89,Wondering Why,Red Clay Strays,33,-1,34,5,0,109000,5700,103300,4827720,2024.06.27
90,"Poor, Poor Pitiful Me","Lainey Wilson, Terri Clark",15,15,0,15,0,107900,107900,0,89780,2024.06.27
91,I Just Wanna Be Mad,"Terri Clark, Cody Johnson",14,14,0,14,0,96600,96600,0,883041,2024.06.27
92,Love The Leavin',Drew Parker,89,42,47,19,0,93700,25900,67800,161163,2024.06.27
93,Unbroke,Sara Evans,48,48,0,48,0,91500,91500,0,5873,2024.06.27
93,Fingertips,Lexie Hayden,48,48,0,48,0,91500,91500,0,407,2024.06.27
95,Hey Driver,Zach Bryan Feat. The War and Treaty,33,4,29,3,0,84300,17800,66500,6131127,2024.06.27
96,Marlboro Reds,Karley Scott Collins,17,17,0,16,0,78600,78600,0,12091,2024.06.27
97,Roots,Austin Burke,19,-13,32,1,0,74200,-45600,119800,9037,2024.06.27
98,Broadway Girls,Lil Durk Feat. Morgan Wallen,14,-1,15,2,0,69000,19300,49700,6387290,2024.06.27
99,Two Night Stands,Kylie Morgan,48,-67,115,10,0,50800,-92800,143600,74676,2024.06.27
100,Leave You Alone,Kane Brown,11,11,0,6,0,47400,47400,0,197963,2024.06.27
101,The Man He Sees In Me,Luke Combs,12,-63,75,2,0,43700,-251000,294700,6094998,2024.06.27
102,Running Out Of Time,Wyatt Flores,17,2,15,1,0,42600,4600,38000,375602,2024.06.27
103,Oklahoma Sooner,Jake Banfield,12,3,9,1,0,39800,11300,28500,2939,2024.06.27
104,Just To Say We Did,Kenny Chesney,10,6,4,6,0,36300,10200,26100,286067,2024.06.27
105,Man Upstairs,Tim Dugger,8,-1,9,1,0,34700,-7800,42500,10192,2024.06.27
106,Mind Of A Country Boy,Luke Bryan,8,7,1,2,0,34600,33200,1400,1267258,2024.06.27
107,The Star-Spangled Banner,Chris Stapleton,11,1,10,8,0,34100,-17700,51800,95211,2024.06.27
108,It's All Good 'Til It Ain't,Struggle Jennings & Caitlynne Curtis,17,-1,18,1,0,33400,-1700,35100,0,2024.06.27
109,I Got A Problem,Drake Milligan,13,0,13,1,0,32300,3100,29200,50407,2024.06.27
110,Work Boots,Cody Johnson,3,0,3,1,0,32200,-7200,39400,252903,2024.06.27
111,What Would You Do?,Tucker Wetmore,13,5,8,1,0,32100,12200,19900,1974369,2024.06.27
112,Paying For It,Levi Hummon,29,-10,39,7,0,28000,-3100,31100,88089,2024.06.27
113,The Little Things,George Strait,5,5,0,5,0,26900,26900,0,826644,2024.06.27
114,High Road,"Koe Wetzel, Jessie Murph",4,4,0,3,0,26600,26600,0,1702,2024.06.27
115,Sunrise Tells The Story,Midland,2,0,2,1,0,25900,8300,17600,156813,2024.06.27
116,Dive,Luke Combs,3,1,2,1,0,24900,19900,5000,1400276,2024.06.27
117,My Bar,Priscilla Block,3,-1,4,3,0,23200,10200,13000,124722,2024.06.27
118,I'Ve Seen Me Do It,Joe Peters,4,3,1,1,0,22300,14500,7800,351,2024.06.27
119,Indifferent,Megan Moroney,6,1,5,1,0,22000,1400,20600,3646413,2024.06.27
120,Summertime Blues,Zach Bryan,11,5,6,1,0,21700,17600,4100,667242,2024.06.27
121,You In A Honky Tonk,Randall King,3,0,3,3,0,21500,-9100,30600,333109,2024.06.27
122,Grease,Lainey Wilson,4,3,1,4,0,20800,19800,1000,143537,2024.06.27
123,Rock Paper Scissors,Carly Pearce,4,4,0,4,0,20600,20600,0,132908,2024.06.27
124,Country Music Made Me Do It,Carly Pearce,6,0,6,6,0,18200,0,18200,43740,2024.06.27
125,'98 Braves,Morgan Wallen,2,-1,3,2,0,17300,6100,11200,2091705,2024.06.27
126,Slow Dance,Scotty McCreery,4,4,0,4,0,16700,16700,0,130105,2024.06.27
127,A Little Bit Closer,Braxton Keith,3,0,3,1,0,16400,-3200,19600,162334,2024.06.27
128,Any Given Friday Night,Luke Combs,2,0,2,1,0,16000,0,16000,219994,2024.06.27
129,Ain't That Some,Morgan Wallen,2,-1,3,1,0,15900,1400,14500,5146858,2024.06.27
130,Down In Georgia,Josh Turner,3,3,0,2,0,15500,15500,0,245619,2024.06.27
131,Up In Texas,Midland,2,1,1,1,0,15500,900,14600,75998,2024.06.27
132,Would If I Could (Feat. Lainey Wilson),Ernest,6,3,3,1,0,15400,10500,4900,1142954,2024.06.27
133,The Good I'Ll Do,Zach Bryan,4,0,4,1,0,14800,4800,10000,2580400,2024.06.27
134,Star Spangled Banner,Mickey Guyton,2,0,2,2,0,14800,2400,12400,0,2024.06.27
135,Whiskey Bent,Cody Johnson,1,1,0,1,0,14600,14600,0,717476,2024.06.27
136,Fiddle In The Band,Kane Brown,1,-1,2,1,0,14600,-4500,19100,808847,2024.06.27
137,Heart They Didn'T Break,Maddie & Tae,14,0,14,2,0,14500,1800,12700,205721,2024.06.27
138,Thunder,Jim & Melissa Brady,2,2,0,2,0,14200,14200,0,179,2024.06.27
139,Oklahoma Smokeshow,Zach Bryan,5,2,3,3,0,14100,4700,9400,7320657,2024.06.27
140,Man On The Moon,Megan Moroney,5,-4,9,1,0,13800,-26300,40100,1666988,2024.06.27
141,Where That Came From,Randy Travis,3,-7,10,1,0,13800,-59600,73400,971667,2024.06.27
142,When My Baby's In Boots,Randall King,1,0,1,1,0,13500,-1100,14600,0,2024.06.27
143,Part Of The Family,Littles,2,1,1,1,0,13400,6700,6700,0,2024.06.27
144,Relapse,Warren Zeiders,2,2,0,2,0,13200,13200,0,5190493,2024.06.27
145,You Look Like You Love Me,Ella Langley & Riley Green,3,3,0,2,0,12900,12900,0,8573923,2024.06.27
146,Certified,Laura Bryna,16,3,13,1,0,12400,2800,9600,7479,2024.06.27
147,Change The Game,Cody Jinks,2,2,0,2,0,12300,12300,0,78071,2024.06.27
148,Oklahoma,Carly Pearce,8,3,5,1,0,11700,8400,3300,130999,2024.06.27
149,Am I The Only One,Aaron Lewis,3,-2,5,1,0,11600,-17000,28600,613078,2024.06.27
150,He Pilots My Ship,Tribute Quartet,2,0,2,2,0,11100,0,11100,5002,2024.06.27
150,Help Is On The Way,Gold City,2,0,2,2,0,11100,0,11100,20466,2024.06.27
150,Wings Of A Dove,Jonathan Wilburn,2,0,2,2,0,11100,0,11100,0,2024.06.27
153,Waiting For Me,Truesong,2,0,2,2,0,11100,-3200,14300,860,2024.06.27
154,Damn Good Time,Jordan Davis,3,-1,4,1,0,10800,-3600,14400,258813,2024.06.27
155,Blue Collar Gospel,Jerry Salley,2,2,0,2,0,10600,10600,0,0,2024.06.27
156,Back 40 Back,Luke Combs,1,1,0,1,0,10200,10200,0,191540,2024.06.27
157,People In The Back,Cody Johnson,1,1,0,1,0,10100,10100,0,160500,2024.06.27
158,Heart Of A Small Town,Tim Dugger,1,0,1,1,0,9900,2500,7400,18778,2024.06.27
159,In Jesus Name (God Of Possible),Katy Nichole,1,1,0,1,0,9200,9200,0,1314948,2024.06.27
159,God Be The Glory,We Are Messengers,1,1,0,1,0,9200,9200,0,377430,2024.06.27
159,My God Is Still The Same,Sanctus Real,1,1,0,1,0,9200,9200,0,609795,2024.06.27
159,We Are The Champions/We Will Rock You,Dolly Parton,1,1,0,1,0,9200,9200,0,12779,2024.06.27
163,Truck On Fire,Carly Pearce,3,-5,8,1,0,8700,-24200,32900,1152416,2024.06.27
164,Record High,Randall King,2,-1,3,1,0,8600,-900,9500,22604,2024.06.27
165,Not Today,Mitchell Tenpenny,5,-11,16,2,0,8400,-20000,28400,320766,2024.06.27
166,If She Wants A Cowboy,Zach Bryan,2,2,0,1,0,8100,8100,0,726153,2024.06.27
167,My Place,Carly Pearce,4,-3,7,2,0,8000,-12700,20700,70103,2024.06.27
168,Long Live Cowgirls,Ian Munsick & Cody Johnson,11,-2,13,3,0,7900,-12300,20200,719249,2024.06.27
169,Running Out Of Time,Casey Donahew,2,2,0,2,0,7700,7700,0,49187,2024.06.27
170,"Salt, Lime & Tequila",Ryan Griffin,2,-2,4,1,0,7700,-8000,15700,79032,2024.06.27
171,Good Day To Have A Great Day,Russell Dickerson,2,-15,17,2,0,7600,-51500,59100,471930,2024.06.27
172,The God I Know,Erwins,1,1,0,1,0,7500,7500,0,4108,2024.06.27
172,My Jesus,Anne Wilson,1,1,0,1,0,7500,7500,0,1369496,2024.06.27
172,Living Water Bread Of Life,Ben Rochester Family,1,1,0,1,0,7500,7500,0,1055,2024.06.27
175,Sun To Me,Zach Bryan,5,0,5,2,0,7500,3600,3900,7030424,2024.06.27
176,Rainin On Me,Wade Bowen,8,-1,9,2,0,7000,0,7000,17122,2024.06.27
177,Breathe In Girl,Elizabeth Mary,6,-2,8,1,0,6800,1200,5600,105,2024.06.27
178,Jeans & Jesus,Sound,1,1,0,1,0,6700,6700,0,0,2024.06.27
178,Middle Of Nowhere,Southbound,1,1,0,1,0,6700,6700,0,2835,2024.06.27
178,Up,Westward Road,1,1,0,1,0,6700,6700,0,33,2024.06.27
178,Jericho,Joseph Habedank,1,1,0,1,0,6700,6700,0,1181,2024.06.27
178,Made A Mess,Tim Menzies,1,1,0,1,0,6700,6700,0,165,2024.06.27
178,Looks Like Jesus,Brian Free & Assurance,1,1,0,1,0,6700,6700,0,825,2024.06.27
178,Two Or Three,Collingsworth Family,1,1,0,1,0,6700,6700,0,7844,2024.06.27
178,He Is Good To Me,Taylors,1,1,0,1,0,6700,6700,0,0,2024.06.27
178,Door Wide Open,Gordon Mote,1,1,0,1,0,6700,6700,0,400,2024.06.27
178,Red Words,Erwins,1,1,0,1,0,6700,6700,0,2492,2024.06.27
178,The Building,Emily Ann Roberts,1,1,0,1,0,6700,6700,0,28389,2024.06.27
178,Preach The Word,Steve Ladd,1,1,0,1,0,6700,6700,0,92,2024.06.27
178,Dear Heavenly Father,11th Hour,1,1,0,1,0,6700,6700,0,2249,2024.06.27
191,Hole In The Heart,Nelons,1,0,1,1,0,6700,0,6700,0,2024.06.27
191,When I Lift Up My Head,High Road,1,0,1,1,0,6700,0,6700,7404,2024.06.27
191,He Forgives And Forgets,Gordon Mote,1,0,1,1,0,6700,0,6700,598,2024.06.27
191,Fall Into Place,Jeff & Sheri Easter,1,0,1,1,0,6700,0,6700,763,2024.06.27
191,There's A Song For That,Down East Boys,1,0,1,1,0,6700,0,6700,5838,2024.06.27
191,Be Ready,Karen Peck & New River,1,0,1,1,0,6700,0,6700,28610,2024.06.27
191,Your Healing Is On The Way,Greater Vision,1,0,1,1,0,6700,0,6700,809,2024.06.27
191,Cross Over,Allens,1,0,1,1,0,6700,0,6700,17,2024.06.27
191,My Constant Savior,Donna Ulisse,1,0,1,1,0,6700,0,6700,18,2024.06.27
200,Here Comes Jesus,Jeff & Sheri Easter,1,0,1,1,0,6700,-800,7500,16633,2024.06.27
201,"I, John",Blackwood Brothers Quartet,1,-1,2,1,0,6700,-4400,11100,42,2024.06.27
1,I Had Some Help,Post Malone,8532,369,8163,144,0,32598200,150500,32447700,38523717,2024.07.04
2,Cowgirls,Morgan Wallen,8110,403,7707,145,0,30388900,1157200,29231700,17943892,2024.07.04
3,Let Your Boys Be Country,Jason Aldean,7482,1597,5885,145,0,24810300,4496400,20313900,2392489,2024.07.04
4,Where It Ends,Bailey Zimmerman,6131,-288,6419,141,0,24560900,-1881200,26442100,6364039,2024.07.04
5,We Ride,Bryan Martin,6452,189,6263,145,0,22597500,91600,22505900,5048021,2024.07.04
6,A Bar Song (Tipsy),Shaboozey,5398,1115,4283,144,0,20539100,3436000,17103100,45861230,2024.07.04
7,Bulletproof,Nate Smith,5901,265,5636,145,0,19925800,-516400,20442200,6923058,2024.07.04
8,Young Love & Saturday Nights,Chris Young,5522,353,5169,145,0,18911700,-472000,19383700,950561,2024.07.04
9,Dirt Cheap,Cody Johnson,5404,202,5202,145,0,18608500,179500,18429000,7367520,2024.07.04
10,She's Somebody's Daughter,Drew Baldridge,5269,445,4824,144,0,18313200,1167400,17145800,529436,2024.07.04
11,Ain't No Love In Oklahoma (From Twisters: The Album),Luke Combs,4637,354,4283,145,0,16197600,658500,15539100,9373866,2024.07.04
12,Chevrolet,Dustin Lynch Feat. Jelly Roll,4661,483,4178,145,0,16054200,1348300,14705900,3478553,2024.07.04
13,Love You Again,Chase Matthew,4301,249,4052,145,0,13852600,151600,13701000,1957015,2024.07.04
14,I'M Not Pretty,Megan Moroney,4003,411,3592,145,0,11874000,443100,11430900,2122825,2024.07.04
15,Hang Tight Honey,Lainey Wilson,3343,322,3021,145,0,11302800,641000,10661800,3861751,2024.07.04
16,This Is My Dirt,Justin Moore,3202,202,3000,144,0,9968100,525700,9442400,546178,2024.07.04
17,One Bad Habit,Tim McGraw,3022,28,2994,145,0,9640600,-194500,9835100,599564,2024.07.04
18,Austin,Dasha,2773,269,2504,139,0,9268900,111000,9157900,12583869,2024.07.04
19,"Love You, Miss You, Mean It",Luke Bryan,2763,336,2427,144,0,8262700,448000,7814700,2839488,2024.07.04
20,I Am Not Okay,Jelly Roll,1873,206,1667,141,0,6829500,-40800,6870300,12138284,2024.07.04
21,Messed Up As Me,Keith Urban,2356,101,2255,141,0,6518700,91800,6426900,1512839,2024.07.04
22,Gonna Love You,Parmalee,2336,185,2151,144,0,6444200,179900,6264300,303425,2024.07.04
23,Beautiful As You,Thomas Rhett,1998,60,1938,136,0,6125200,43100,6082100,5522108,2024.07.04
24,Coming Home,Old Dominion,1499,1497,2,123,0,5823200,5819600,3600,2295096,2024.07.04
25,Bigger Houses,Dan + Shay,1978,82,1896,139,0,5278600,213900,5064700,1214938,2024.07.04
26,Dance With You,Brett Young,2045,7,2038,140,0,5103800,-344700,5448500,653386,2024.07.04
27,Sounds Like The Radio,Zach Top,1819,55,1764,137,0,4821200,-47100,4868300,992067,2024.07.04
28,Miles On It,Marshmello & Kane Brown,1690,138,1552,135,0,4487600,-113600,4601200,13760592,2024.07.04
29,Lies Lies Lies,Morgan Wallen,937,937,0,96,0,4126400,4126400,0,34371,2024.07.04
30,Damn Good Day To Leave,Riley Green,1594,196,1398,135,0,4062600,-205900,4268500,1184251,2024.07.04
31,American Girl,Dierks Bentley,1454,-3,1457,141,0,3809700,-527600,4337300,269031,2024.07.04
32,Think I’m In Love With You,Chris Stapleton,1211,146,1065,104,0,3675000,363500,3311500,6853849,2024.07.04
33,Cowboy Songs,George Birge,1472,4,1468,132,0,3637800,-197800,3835600,577249,2024.07.04
34,Boys Back Home,Dylan Marlowe Feat. Dylan Scott,1287,84,1203,114,0,3442100,-171700,3613800,3227460,2024.07.04
35,Wind Up Missin' You,Tucker Wetmore,1087,97,990,90,0,3367600,285000,3082600,6891244,2024.07.04
36,Called Crazy,Kassi Ashton,810,19,791,49,0,3086300,-316900,3403200,321713,2024.07.04
37,Breakin' In Boots,Matt Stell,1380,164,1216,123,0,2813000,232200,2580800,715058,2024.07.04
38,Whatcha See Is Whatcha Get,Chris Janson,1135,38,1097,113,0,2558000,-115000,2673000,178616,2024.07.04
39,Find Another Bar,Chris Lane,1288,55,1233,132,0,2556400,-102900,2659300,93898,2024.07.04
40,SIX FEET UNDER (Caleigh's Song),Hardy,714,72,642,83,0,2386900,174000,2212900,1896500,2024.07.04
41,Friends Like That,John Morgan Feat. Jason Aldean,936,22,914,86,0,2380500,-52100,2432600,829961,2024.07.04
42,This Town's Been Too Good To Us,Dylan Scott,967,15,952,115,0,2251500,-72700,2324200,2406237,2024.07.04
43,Pour Me A Drink,Post Malone,589,-44,633,41,0,2205300,-598600,2803900,16755316,2024.07.04
44,Forever To Me,Cole Swindell,797,7,790,78,0,2172800,-200500,2373300,1447260,2024.07.04
45,Tie Up,Zac Brown Band,1117,70,1047,125,0,2164900,21800,2143100,812316,2024.07.04
46,Wranglers,Miranda Lambert,859,40,819,98,0,1958100,-103900,2062000,1825786,2024.07.04
47,Drinkin' Buddies,"Lee Brice, Hailey Whitters, And Nate Smith",640,12,628,86,0,1891100,-135900,2027000,475026,2024.07.04
48,I Tried A Ring On,Tigirlily Gold,1018,-62,1080,101,0,1878800,-130000,2008800,808747,2024.07.04
49,Life With You,Kelsey Hart,942,82,860,91,0,1678300,-95600,1773900,2016862,2024.07.04
50,Cowboys Cry Too,Kelsea Ballerini,401,-790,1191,77,0,1394400,-3677300,5071700,8682779,2024.07.04
51,Country Back,Randy Houser,672,-27,699,78,0,1109100,-110900,1220000,84622,2024.07.04
52,Fall Of Summer,Scotty McCreery,481,28,453,67,0,1058900,25800,1033100,551655,2024.07.04
53,Holy Smokes,Bailey Zimmerman,355,36,319,39,0,989200,-17100,1006300,5042058,2024.07.04
54,Hometown Home,Locash,544,21,523,78,0,982200,-91800,1074000,138540,2024.07.04
55,Devil You Know,Tyler Braden,448,4,444,46,0,913800,-178700,1092500,4868060,2024.07.04
56,This Heart,Corey Kent,489,26,463,55,0,748700,4100,744600,1311387,2024.07.04
57,Single Again,Josh Ross,526,4,522,74,0,748300,-61900,810200,2594990,2024.07.04
58,Everything I Need,Chayce Beckham,434,24,410,58,0,708400,8600,699800,324546,2024.07.04
59,Country House,Sam Hunt,354,25,329,73,0,602500,-141100,743600,549769,2024.07.04
60,Neon Baby,Annie Bosko,386,20,366,48,0,546100,-29500,575600,17814,2024.07.04
61,Roulette On The Heart,Conner Smith,396,-27,423,54,0,535500,-122300,657800,642393,2024.07.04
62,Park,Tyler Hubbard,251,50,201,37,0,530300,214800,315500,1049786,2024.07.04
63,Break Mine,Brothers Osborne,289,-12,301,44,0,490600,-60000,550600,322137,2024.07.04
64,The Devil I Know,Ashley McBryde,301,-33,334,37,0,476900,-100900,577800,608855,2024.07.04
65,Things I Take For Granted,Larry Fleet,324,-15,339,48,0,476700,-46500,523200,650925,2024.07.04
66,Strangers,Kameron Marlowe & Ella Langley,348,-31,379,44,0,428800,-120000,548800,2205593,2024.07.04
67,King Of Country Music,Ryan Larkins,365,-35,400,61,0,425100,-218700,643800,11517,2024.07.04
68,Over When We'Re Sober,Brantley Gilbert,207,50,157,44,0,413100,-227500,640600,1339360,2024.07.04
69,Good On You,Priscilla Block,246,-7,253,40,0,348900,-25100,374000,818348,2024.07.04
70,Pink Skies,Zach Bryan,113,-3,116,7,0,301200,-48700,349900,22163541,2024.07.04
71,Young Man,Greylan James,51,9,42,3,0,299200,51100,248100,45088,2024.07.04
72,Pray All The Way Home,Austin Snell,141,3,138,29,0,286100,-62200,348300,812281,2024.07.04
73,Beatles And Eagles,Frontmen,222,22,200,31,0,285600,25800,259800,949,2024.07.04
74,It's Been A Year,Ashley Cooke,57,57,0,56,0,284800,284800,0,96323,2024.07.04
75,Take Forever (Hally's Song),Cooper Alan,57,57,0,56,0,278200,278200,0,776863,2024.07.04
76,Dance Like No One’s Watching,Gabby Barrett,314,8,306,42,0,274100,-107100,381200,370997,2024.07.04
77,Bury Me In This Bar,Dalton Dover,255,-24,279,48,0,272800,-69200,342000,37034,2024.07.04
78,Just To Say We Did,Kenny Chesney,76,66,10,7,0,272700,236400,36300,286905,2024.07.04
79,Uh-huh (Ajá),Frank Ray,269,11,258,40,0,270400,7000,263400,31714,2024.07.04
80,Baby Daddy's Weekend,Elle King,220,13,207,35,0,243800,23000,220800,53608,2024.07.04
81,Never Been Over,Darius Rucker,191,3,188,35,0,232400,6300,226100,268229,2024.07.04
82,Acres,Brian Kelley,241,110,131,37,0,207400,51500,155900,168312,2024.07.04
83,I Could Be That Rain,Randall King,137,23,114,18,0,171000,12800,158200,318497,2024.07.04
84,Girl In The Mirror,Megan Moroney,39,39,0,39,0,170000,170000,0,483627,2024.07.04
85,Wine Into Whiskey,Tucker Wetmore,31,0,31,3,0,169500,28300,141200,7992590,2024.07.04
86,Worst Way,Riley Green,27,-1,28,2,0,156400,18700,137700,4675120,2024.07.04
87,Spin You Around (1/24),Morgan Wallen,47,-12,59,5,0,147300,-31100,178400,6010654,2024.07.04
88,Love The Leavin',Drew Parker,123,34,89,20,0,142700,49000,93700,156605,2024.07.04
89,How Is She,Cole Swindell,20,-1,21,1,0,141500,8800,132700,52718,2024.07.04
90,The Star-Spangled Banner,Chris Stapleton,30,19,11,20,0,136500,102400,34100,519407,2024.07.04
91,Girls Night Out,"Reba McEntire, Carly Pearce, Jennifer Nettles, Gabby Barrett",17,17,0,17,0,133800,133800,0,3650,2024.07.04
92,Sweet Dreams,Koe Wetzel,85,-49,134,12,0,131000,-92400,223400,7203970,2024.07.04
93,Roots,Austin Burke,31,12,19,1,0,130700,56500,74200,7063,2024.07.04
94,Mia Down In Mia,George Strait,18,-5,23,3,0,128600,-17300,145900,307125,2024.07.04
95,Songs About Whiskey,Anne Wilson,22,4,18,4,0,115100,-17000,132100,214675,2024.07.04
96,Mind Of A Country Boy,Luke Bryan,18,10,8,2,0,83000,48400,34600,918261,2024.07.04
97,Wondering Why,Red Clay Strays,26,-7,33,4,0,80900,-28100,109000,5016056,2024.07.04
98,The Hill,Caylee Hammack,47,46,1,47,0,76000,73400,2600,37863,2024.07.04
99,I Don'T Wanna Dance,Kassi Ashton,46,46,0,46,0,75500,75500,0,27579,2024.07.04
100,Hey Driver,Zach Bryan Feat. The War and Treaty,34,1,33,1,0,75000,-9300,84300,6140211,2024.07.04
101,Hurricane,Castellows,17,17,0,16,0,74400,74400,0,418201,2024.07.04
102,Running Out Of Time,Wyatt Flores,16,-1,17,1,0,69600,27000,42600,372534,2024.07.04
103,Work Boots,Cody Johnson,4,1,3,1,0,61500,29300,32200,273272,2024.07.04
104,Broadway Girls,Lil Durk Feat. Morgan Wallen,18,4,14,2,0,58200,-10800,69000,6586870,2024.07.04
105,Make You Mine,Marynn Taylor,4,4,0,1,0,57900,57900,0,14943,2024.07.04
106,The Man He Sees In Me,Luke Combs,8,-4,12,1,0,43000,-700,43700,4899329,2024.07.04
107,Man Upstairs,Tim Dugger,7,-1,8,1,0,40100,5400,34700,11947,2024.07.04
108,Two Night Stands,Kylie Morgan,40,-8,48,9,0,39800,-11000,50800,54835,2024.07.04
109,Where That Came From,Randy Travis,4,1,3,2,0,39200,25400,13800,873448,2024.07.04
110,Money On Me,Morgan Wallen,15,15,0,15,0,36500,36500,0,541955,2024.07.04
111,'98 Braves,Morgan Wallen,4,2,2,4,0,36500,19200,17300,2120756,2024.07.04
112,What Would You Do?,Tucker Wetmore,13,0,13,1,0,34000,1900,32100,1872507,2024.07.04
113,Oklahoma Sooner,Jake Banfield,10,-2,12,1,0,33900,-5900,39800,3221,2024.07.04
114,Ain'T About You,Huntergirl,2,2,0,1,0,33200,33200,0,15462,2024.07.04
115,Leave You Alone,Kane Brown,14,3,11,14,0,31800,-15600,47400,192864,2024.07.04
116,180 (Lifestyle),Morgan Wallen,2,2,0,1,0,29500,29500,0,1582275,2024.07.04
117,It's All Good 'Til It Ain't,Struggle Jennings & Caitlynne Curtis,16,-1,17,1,0,27600,-5800,33400,0,2024.07.04
118,Long Live Cowgirls,Ian Munsick & Cody Johnson,13,2,11,4,0,27200,19300,7900,762119,2024.07.04
119,John Deere Green,"HIXTAPE Feat. HARDY, Morgan Wallen, Joe Diffie",4,4,0,1,0,26800,26800,0,0,2024.07.04
120,A Little Bit Closer,Braxton Keith,2,-1,3,1,0,25500,9100,16400,195526,2024.07.04
121,Dive,Luke Combs,2,-1,3,1,0,25500,600,24900,1378544,2024.07.04
122,I Got A Problem,Drake Milligan,13,0,13,1,0,25400,-6900,32300,51946,2024.07.04
123,New To Country,Bailey Zimmerman,9,9,0,3,0,25200,25200,0,5675189,2024.07.04
124,Happy Birthday America,Toby Keith,3,2,1,2,0,23600,19100,4500,113934,2024.07.04
125,That's Texas,Cody Johnson,3,3,0,2,0,22900,22900,0,302582,2024.07.04
126,He Pilots My Ship,Tribute Quartet,3,1,2,3,0,21700,10600,11100,5486,2024.07.04
127,Ain't That Some,Morgan Wallen,3,1,2,2,0,20000,4100,15900,5458103,2024.07.04
128,When My Baby's In Boots,Randall King,1,0,1,1,0,19900,6400,13500,0,2024.07.04
129,Neon Star (Country Boy Lullaby),Morgan Wallen,2,1,1,1,0,19700,13800,5900,2047480,2024.07.04
130,We Are The Church,Ernie Haase & Signature Sound,3,2,1,3,0,19300,14900,4400,24295,2024.07.04
131,Heartbreak King,Ian Munsick,10,10,0,8,0,18400,18400,0,83173,2024.07.04
132,Heart Of A Small Town,Tim Dugger,2,1,1,1,0,17300,7400,9900,38249,2024.07.04
133,My America (I Still Believe),Danny Gokey,8,4,4,1,0,17200,10800,6400,19210,2024.07.04
134,You'll Always Be My Baby (Written For Daughters' Weddings),Alan Jackson,5,2,3,1,0,17000,15600,1400,49826,2024.07.04
135,Am I The Only One,Aaron Lewis,5,2,3,2,0,16900,5300,11600,677459,2024.07.04
136,Church,Jelly Roll,1,1,0,1,0,16600,16600,0,784331,2024.07.04
137,White Buffalo,Ian Munsick,9,9,0,8,0,16400,16400,0,99646,2024.07.04
138,red,HARDY Feat. Morgan Wallen,2,2,0,1,0,16400,16400,0,0,2024.07.04
139,"Salt, Lime & Tequila",Ryan Griffin,2,0,2,1,0,15900,8200,7700,86484,2024.07.04
140,Meet Me At The Cross,Brian Free & Assurance,2,2,0,2,0,15500,15500,0,6240,2024.07.04
141,Any Given Friday Night,Luke Combs,2,0,2,1,0,14600,-1400,16000,222876,2024.07.04
142,Sunrise,Morgan Wallen,1,1,0,1,0,14300,14300,0,3216696,2024.07.04
142,Third Rock From The Sun,"HIXTAPE & Joe Diffie Feat. Brooks & Dunn, Blake Shelton & HARDY",1,1,0,1,0,14300,14300,0,0,2024.07.04
144,Devil Don't Know,Morgan Wallen,1,0,1,1,0,14300,10600,3700,678362,2024.07.04
145,Goodbye You,Landon Parker,17,17,0,17,0,13800,13800,0,860,2024.07.04
146,In God's Time,Jordan Family Band,2,1,1,2,0,13700,9300,4400,3003,2024.07.04
147,Daddy's Truck,Conner Sweet,4,4,0,1,0,13600,13600,0,6512,2024.07.04
148,Oklahoma Sun,Koe Wetzel,3,1,2,1,0,13200,7300,5900,145452,2024.07.04
149,Loud and Heavy,Cody Jinks,4,2,2,2,0,12900,9300,3600,1547652,2024.07.04
150,You Can Make It,Will Smith,1,1,0,1,0,12800,12800,0,664839,2024.07.04
151,Would If I Could (Feat. Lainey Wilson),Ernest,6,0,6,1,0,12500,-2900,15400,1092103,2024.07.04
152,Star Spangled Banner,Mickey Guyton,2,0,2,2,0,12300,-2500,14800,0,2024.07.04
153,Honky Tonk Roll,Wade Bowen,3,0,3,1,0,12100,5900,6200,1965,2024.07.04
154,My God,Scotty Inman,2,2,0,2,0,11800,11800,0,32504,2024.07.04
155,Your Healing Is On The Way,Greater Vision,2,1,1,2,0,11800,5100,6700,1598,2024.07.04
156,Help Is On The Way,Gold City,2,0,2,2,0,11800,700,11100,15547,2024.07.04
157,The Good I'Ll Do,Zach Bryan,3,-1,4,1,0,11800,-3000,14800,2650579,2024.07.04
158,Paying For It,Levi Hummon,20,-9,29,3,0,11600,-16400,28000,88270,2024.07.04
159,My Bar,Priscilla Block,4,1,3,3,0,10300,-12900,23200,121586,2024.07.04
160,American Nights,Zach Bryan,4,4,0,1,0,9900,9900,0,3178006,2024.07.04
161,Sunday Sermons,Anne Wilson,1,1,0,1,0,9900,9900,0,456296,2024.07.04
161,Do It For You,Jason Crabb,1,1,0,1,0,9900,9900,0,3463,2024.07.04
163,Forgiven,Joseph Habedank,1,0,1,1,0,9900,9500,400,6774,2024.07.04
164,Here Comes Jesus,Jeff & Sheri Easter,1,0,1,1,0,9900,3200,6700,17092,2024.07.04
165,"Poor, Poor Pitiful Me","Lainey Wilson, Terri Clark",1,-14,15,1,0,9100,-98800,107900,59095,2024.07.04
166,Heartfirst,Kelsea Ballerini,2,1,1,1,0,9000,8000,1000,418389,2024.07.04
167,Truck On Fire,Carly Pearce,1,-2,3,1,0,8900,200,8700,1153117,2024.07.04
168,Country's Cool Again,Lainey Wilson,1,1,0,1,0,8500,8500,0,456929,2024.07.04
169,You Look Like You Love Me,Ella Langley & Riley Green,2,-1,3,2,0,8300,-4600,12900,11024584,2024.07.04
170,The Great American Bar Scene,Zach Bryan,2,2,0,1,0,8100,8100,0,2294003,2024.07.04
171,28th Of June,Megan Moroney,1,1,0,1,0,7900,7900,0,621884,2024.07.04
172,John 3:16 Is Calling Out To You,Perrys,1,1,0,1,0,7500,7500,0,1299,2024.07.04
172,Say Yes I Am,Lauren Talley,1,1,0,1,0,7500,7500,0,558,2024.07.04
172,Come And See,Mylon Hayes Family,1,1,0,1,0,7500,7500,0,2624,2024.07.04
172,All Of My Help,Erwins,1,1,0,1,0,7500,7500,0,1044,2024.07.04
176,Looks Like Jesus,Brian Free & Assurance,1,0,1,1,0,7500,800,6700,706,2024.07.04
176,Middle Of Nowhere,Southbound,1,0,1,1,0,7500,800,6700,4376,2024.07.04
176,The Building,Emily Ann Roberts,1,0,1,1,0,7500,800,6700,28049,2024.07.04
179,Moth To A Flame,Morgan Wade,1,1,0,1,0,7300,7300,0,760204,2024.07.04
179,Killin' Time,Craig Campbell,1,1,0,1,0,7300,7300,0,2779,2024.07.04
181,Certified,Laura Bryna,15,-1,16,1,0,7200,-5200,12400,8650,2024.07.04
182,Oklahoma,Carly Pearce,8,0,8,1,0,6500,-5200,11700,131334,2024.07.04
183,The End,Endless Highway,1,1,0,1,0,6200,6200,0,1469,2024.07.04
183,Great Is Thy Faithfulness,Carrie Underwood Feat. Cece Winans,1,1,0,1,0,6200,6200,0,81303,2024.07.04
183,A Good Day Coming On,Kingdom Heirs,1,1,0,1,0,6200,6200,0,0,2024.07.04
183,Warmin' Up,Perrys,1,1,0,1,0,6200,6200,0,4628,2024.07.04
183,Make Me A Mop,Cody Johnson,1,1,0,1,0,6200,6200,0,89960,2024.07.04
188,Back To The Garden,Erwins,1,0,1,1,0,6200,1800,4400,0,2024.07.04
188,There Is A Name,LeFevre Quartet,1,0,1,1,0,6200,1800,4400,6006,2024.07.04
188,There's Always A Place At The Table,Sunday Drive,1,0,1,1,0,6200,1800,4400,1035,2024.07.04
188,Think About There,Greater Vision,1,0,1,1,0,6200,1800,4400,7405,2024.07.04
188,I Think I'Ll Just Go On,Perrys,1,0,1,1,0,6200,1800,4400,6910,2024.07.04
188,He Grew The Tree,Guardians Quartet,1,0,1,1,0,6200,1800,4400,929,2024.07.04
194,Whatever Gets You Through It,Morgan Gruber,6,0,6,1,0,6200,1600,4600,213,2024.07.04
195,"I, John",Blackwood Brothers Quartet,1,0,1,1,0,6200,-500,6700,31,2024.07.04
196,Boy From Anderson County,Kolby Cooper,2,2,0,1,0,5900,5900,0,25229,2024.07.04
197,Rust,Corey Kent,1,1,0,1,0,5700,5700,0,292262,2024.07.04
198,Heart They Didn'T Break,Maddie & Tae,15,1,14,1,0,5700,-8800,14500,200297,2024.07.04
199,Heading In A New Direction,Elaine Roy,1,1,0,1,0,5600,5600,0,0,2024.07.04
199,A Hundred Different Altars,Steeles,1,1,0,1,0,5600,5600,0,2164,2024.07.04
199,Take Me To The Water,"Lauren, Amber & Kenna",1,1,0,1,0,5600,5600,0,9437,2024.07.04
199,Saved People,Scotty Inman,1,1,0,1,0,5600,5600,0,394,2024.07.04
199,When We Step Inside The Gates / Inside The Gate,Bruce Sechrest,1,1,0,1,0,5600,5600,0,6,2024.07.04
199,I'M Gonna Sing,Alex Miller,1,1,0,1,0,5600,5600,0,312,2024.07.04
199,Land Of The Free,Home Free,1,1,0,1,0,5600,5600,0,4888,2024.07.04
206,Revival Broke Out,Gaither Vocal Band,1,0,1,1,0,5600,5200,400,2211,2024.07.04
207,Give Me A Sunrise,Braxton Keith,1,0,1,1,0,5600,1500,4100,100007,2024.07.04
208,There's A Song For That,Down East Boys,1,0,1,1,0,5600,-1100,6700,5207,2024.07.04
208,Fall Into Place,Jeff & Sheri Easter,1,0,1,1,0,5600,-1100,6700,1945,2024.07.04
208,When I Lift Up My Head,High Road,1,0,1,1,0,5600,-1100,6700,6813,2024.07.04
208,Cross Over,Allens,1,0,1,1,0,5600,-1100,6700,301,2024.07.04
208,Made A Mess,Tim Menzies,1,0,1,1,0,5600,-1100,6700,845,2024.07.04
208,Be Ready,Karen Peck & New River,1,0,1,1,0,5600,-1100,6700,18381,2024.07.04
208,My Constant Savior,Donna Ulisse,1,0,1,1,0,5600,-1100,6700,13,2024.07.04
208,Jeans & Jesus,Sound,1,0,1,1,0,5600,-1100,6700,0,2024.07.04
208,He Forgives And Forgets,Gordon Mote,1,0,1,1,0,5600,-1100,6700,537,2024.07.04
208,Red Words,Erwins,1,0,1,1,0,5600,-1100,6700,3426,2024.07.04
218,Wings Of A Dove,Jonathan Wilburn,1,-1,2,1,0,5600,-5500,11100,0,2024.07.04
1,I Had Some Help,Post Malone,8582,50,8532,145,0,33017000,418800,32598200,33340264,2024.07.11
2,Cowgirls,Morgan Wallen,8362,252,8110,145,0,31567300,1178400,30388900,15409895,2024.07.11
3,We Ride,Bryan Martin,7707,1255,6452,145,0,26529100,3931600,22597500,4309520,2024.07.11
4,A Bar Song (Tipsy),Shaboozey,6309,911,5398,144,0,23770200,3231100,20539100,40126140,2024.07.11
5,Where It Ends,Bailey Zimmerman,5853,-278,6131,140,0,23077700,-1483200,24560900,5519540,2024.07.11
6,Bulletproof,Nate Smith,6038,137,5901,145,0,20500600,574800,19925800,6073044,2024.07.11
7,Dirt Cheap,Cody Johnson,5734,330,5404,145,0,19590300,981800,18608500,6261683,2024.07.11
8,She's Somebody's Daughter,Drew Baldridge,5562,293,5269,145,0,19251600,938400,18313200,489752,2024.07.11
9,Young Love & Saturday Nights,Chris Young,5650,128,5522,145,0,19010000,98300,18911700,814901,2024.07.11
10,Ain't No Love In Oklahoma (From Twisters: The Album),Luke Combs,4983,346,4637,145,0,17463600,1266000,16197600,9287516,2024.07.11
11,Chevrolet,Dustin Lynch Feat. Jelly Roll,5067,406,4661,144,0,17359200,1305000,16054200,3054722,2024.07.11
12,Let Your Boys Be Country,Jason Aldean,4784,-2698,7482,145,0,17326700,-7483600,24810300,2025302,2024.07.11
13,Love You Again,Chase Matthew,4360,59,4301,145,0,14282600,430000,13852600,1854834,2024.07.11
14,Hang Tight Honey,Lainey Wilson,3754,411,3343,145,0,12476300,1173500,11302800,3901026,2024.07.11
15,This Is My Dirt,Justin Moore,3396,194,3202,145,0,10868300,900200,9968100,499296,2024.07.11
16,One Bad Habit,Tim McGraw,3327,305,3022,145,0,10706500,1065900,9640600,500251,2024.07.11
17,"Love You, Miss You, Mean It",Luke Bryan,3182,419,2763,143,0,10352600,2089900,8262700,2350001,2024.07.11
18,Austin,Dasha,2986,213,2773,141,0,10135700,866800,9268900,11125438,2024.07.11
19,I Am Not Okay,Jelly Roll,2271,398,1873,144,0,7655100,825600,6829500,10178417,2024.07.11
20,Beautiful As You,Thomas Rhett,2319,321,1998,140,0,7134600,1009400,6125200,4769747,2024.07.11
21,Messed Up As Me,Keith Urban,2462,106,2356,141,0,6912400,393700,6518700,1251543,2024.07.11
22,Gonna Love You,Parmalee,2524,188,2336,144,0,6711700,267500,6444200,276249,2024.07.11
23,Bigger Houses,Dan + Shay,2127,149,1978,143,0,6155100,876500,5278600,1116509,2024.07.11
24,Miles On It,Marshmello & Kane Brown,2018,328,1690,140,0,6080400,1592800,4487600,12663530,2024.07.11
25,Dance With You,Brett Young,2090,45,2045,141,0,5283100,179300,5103800,535132,2024.07.11
26,Sounds Like The Radio,Zach Top,1846,27,1819,141,0,4971700,150500,4821200,861172,2024.07.11
27,Lies Lies Lies,Morgan Wallen,927,-10,937,105,0,4465000,338600,4126400,26962396,2024.07.11
28,Damn Good Day To Leave,Riley Green,1764,170,1594,136,0,4441800,379200,4062600,1371248,2024.07.11
29,American Girl,Dierks Bentley,1578,124,1454,141,0,4267900,458200,3809700,195554,2024.07.11
30,Cowboy Songs,George Birge,1692,220,1472,133,0,4106900,469100,3637800,519435,2024.07.11
31,Wind Up Missin' You,Tucker Wetmore,1162,75,1087,89,0,3920600,553000,3367600,6683868,2024.07.11
32,Think I’m In Love With You,Chris Stapleton,1326,115,1211,113,0,3869000,194000,3675000,5563877,2024.07.11
33,Boys Back Home,Dylan Marlowe Feat. Dylan Scott,1507,220,1287,132,0,3851600,409500,3442100,2675348,2024.07.11
34,Pour Me A Drink,Post Malone,792,203,589,64,0,3031000,825700,2205300,12604452,2024.07.11
35,Called Crazy,Kassi Ashton,836,26,810,51,0,3008600,-77700,3086300,382407,2024.07.11
36,Breakin' In Boots,Matt Stell,1432,52,1380,122,0,2935800,122800,2813000,529000,2024.07.11
37,Find Another Bar,Chris Lane,1347,59,1288,132,0,2632400,76000,2556400,73162,2024.07.11
38,Whatcha See Is Whatcha Get,Chris Janson,1172,37,1135,134,0,2588600,30600,2558000,148223,2024.07.11
39,This Town's Been Too Good To Us,Dylan Scott,1100,133,967,125,0,2464800,213300,2251500,2108819,2024.07.11
40,Forever To Me,Cole Swindell,827,30,797,78,0,2269200,96400,2172800,1025938,2024.07.11
41,SIX FEET UNDER (Caleigh's Song),Hardy,737,23,714,91,0,2255500,-131400,2386900,1258995,2024.07.11
42,Friends Like That,John Morgan Feat. Jason Aldean,894,-42,936,87,0,2197300,-183200,2380500,768380,2024.07.11
43,Wranglers,Miranda Lambert,975,116,859,106,0,2156700,198600,1958100,1823068,2024.07.11
44,Tie Up,Zac Brown Band,1156,39,1117,124,0,2148700,-16200,2164900,677086,2024.07.11
45,I Tried A Ring On,Tigirlily Gold,1152,134,1018,128,0,2050100,171300,1878800,689343,2024.07.11
46,Drinkin' Buddies,"Lee Brice, Hailey Whitters, And Nate Smith",688,48,640,95,0,1905400,14300,1891100,426078,2024.07.11
47,Coming Home,Old Dominion,581,-918,1499,88,0,1631000,-4192200,5823200,1614749,2024.07.11
48,Life With You,Kelsey Hart,875,-67,942,91,0,1592400,-85900,1678300,1793875,2024.07.11
49,Cowboys Cry Too,Kelsea Ballerini,544,143,401,95,0,1432500,38100,1394400,6151899,2024.07.11
50,Fall Of Summer,Scotty McCreery,550,69,481,84,0,1195200,136300,1058900,458554,2024.07.11
51,Hometown Home,Locash,641,97,544,79,0,1153000,170800,982200,82250,2024.07.11
52,Holy Smokes,Bailey Zimmerman,415,60,355,40,0,1075900,86700,989200,4764157,2024.07.11
53,Country Back,Randy Houser,649,-23,672,78,0,1036300,-72800,1109100,37519,2024.07.11
54,Devil You Know,Tyler Braden,462,14,448,48,0,949600,35800,913800,4363096,2024.07.11
55,Single Again,Josh Ross,579,53,526,76,0,820000,71700,748300,2352177,2024.07.11
56,This Heart,Corey Kent,497,8,489,56,0,737300,-11400,748700,1347535,2024.07.11
57,Everything I Need,Chayce Beckham,426,-8,434,58,0,659200,-49200,708400,309733,2024.07.11
58,Strangers,Kameron Marlowe & Ella Langley,447,99,348,46,0,646900,218100,428800,2033340,2024.07.11
59,Neon Baby,Annie Bosko,414,28,386,48,0,596500,50400,546100,15439,2024.07.11
60,Country House,Sam Hunt,337,-17,354,54,0,595400,-7100,602500,411795,2024.07.11
61,Pink Skies,Zach Bryan,151,38,113,7,0,568000,266800,301200,23776938,2024.07.11
62,Just To Say We Did,Kenny Chesney,145,69,76,13,0,547400,274700,272700,256593,2024.07.11
63,Things I Take For Granted,Larry Fleet,332,8,324,48,0,524700,48000,476700,504138,2024.07.11
64,The Devil I Know,Ashley McBryde,359,58,301,51,0,519000,42100,476900,490382,2024.07.11
65,Park,Tyler Hubbard,276,25,251,51,0,515700,-14600,530300,829720,2024.07.11
66,Roulette On The Heart,Conner Smith,385,-11,396,56,0,510600,-24900,535500,574341,2024.07.11
67,Break Mine,Brothers Osborne,295,6,289,46,0,497000,6400,490600,235430,2024.07.11
68,High Road,Koe Wetzel,232,232,0,34,0,434100,434100,0,11376137,2024.07.11
69,King Of Country Music,Ryan Larkins,355,-10,365,56,0,417400,-7700,425100,8405,2024.07.11
70,Over When We'Re Sober,Brantley Gilbert,252,45,207,46,0,409200,-3900,413100,937563,2024.07.11
71,Sad Songs And You,Lauren Watkins,105,105,0,57,0,358400,358400,0,4811,2024.07.11
72,You Look Like You Love Me,Ella Langley & Riley Green,76,74,2,47,0,353500,345200,8300,10669922,2024.07.11
73,Dance Like No One’s Watching,Gabby Barrett,325,11,314,42,0,341000,66900,274100,321391,2024.07.11
74,100%,Styles Haury,74,74,0,39,0,322000,322000,0,2080,2024.07.11
75,Beatles And Eagles,Frontmen,232,10,222,30,0,318200,32600,285600,902,2024.07.11
76,Bury Me In This Bar,Dalton Dover,277,22,255,46,0,313100,40300,272800,30867,2024.07.11
77,Uh-huh (Ajá),Frank Ray,286,17,269,41,0,307300,36900,270400,23117,2024.07.11
78,Young Man,Greylan James,51,0,51,3,0,302100,2900,299200,38015,2024.07.11
79,Good On You,Priscilla Block,236,-10,246,40,0,293900,-55000,348900,632659,2024.07.11
80,Wine Into Whiskey,Tucker Wetmore,48,17,31,3,0,283600,114100,169500,7218708,2024.07.11
81,Baby Daddy's Weekend,Elle King,230,10,220,34,0,271500,27700,243800,41412,2024.07.11
82,Never Been Over,Darius Rucker,220,29,191,45,0,264800,32400,232400,219962,2024.07.11
83,Pray All The Way Home,Austin Snell,143,2,141,24,0,242300,-43800,286100,637518,2024.07.11
84,Acres,Brian Kelley,238,-3,241,39,0,189600,-17800,207400,125974,2024.07.11
85,The Star-Spangled Banner,Chris Stapleton,33,3,30,27,0,166600,30100,136500,174462,2024.07.11
86,I Could Be That Rain,Randall King,129,-8,137,19,0,151400,-19600,171000,301708,2024.07.11
87,Mia Down In Mia,George Strait,22,4,18,5,0,147200,18600,128600,224807,2024.07.11
88,Spin You Around (1/24),Morgan Wallen,31,-16,47,6,0,139700,-7600,147300,5490830,2024.07.11
89,How Is She,Cole Swindell,16,-4,20,1,0,125300,-16200,141500,42279,2024.07.11
90,Love The Leavin',Drew Parker,127,4,123,20,0,121300,-21400,142700,131568,2024.07.11
91,Songs About Whiskey,Anne Wilson,19,-3,22,2,0,109400,-5700,115100,193921,2024.07.11
92,Worst Way,Riley Green,24,-3,27,2,0,109200,-47200,156400,4238700,2024.07.11
93,Should'Ve Been A Cowboy,Jason Aldean,22,22,0,20,0,105300,105300,0,73817,2024.07.11
94,Roots,Austin Burke,27,-4,31,1,0,104600,-26100,130700,7072,2024.07.11
95,Fiddle In The Band,Kane Brown,11,11,0,1,0,92200,92200,0,551067,2024.07.11
96,Wondering Why,Red Clay Strays,27,1,26,5,0,83400,2500,80900,4593438,2024.07.11
97,Moth To A Flame,Morgan Wade,48,47,1,48,0,78300,71000,7300,497725,2024.07.11
98,American Nights,Zach Bryan,28,24,4,1,0,77800,67900,9900,13986989,2024.07.11
99,Running Out Of Time,Wyatt Flores,17,1,16,1,0,71500,1900,69600,392107,2024.07.11
100,Truck On Fire,Carly Pearce,19,18,1,3,0,65600,56700,8900,837407,2024.07.11
101,Shotgun,Thad And Cade,14,14,0,13,0,62000,62000,0,0,2024.07.11
102,Make You Mine,Marynn Taylor,3,-1,4,1,0,59700,1800,57900,10490,2024.07.11
103,Broadway Girls,Lil Durk Feat. Morgan Wallen,16,-2,18,2,0,58700,500,58200,5978854,2024.07.11
104,Hey Driver,Zach Bryan Feat. The War and Treaty,25,-9,34,2,0,57600,-17400,75000,5471345,2024.07.11
105,New To Country,Bailey Zimmerman,14,5,9,2,0,50700,25500,25200,4299547,2024.07.11
106,The Man He Sees In Me,Luke Combs,9,1,8,2,0,47700,4700,43000,3159700,2024.07.11
107,'98 Braves,Morgan Wallen,5,1,4,3,0,46100,9600,36500,1995112,2024.07.11
108,Man Upstairs,Tim Dugger,10,3,7,1,0,44700,4600,40100,11569,2024.07.11
109,Oklahoma Sooner,Jake Banfield,11,1,10,1,0,40600,6700,33900,6306,2024.07.11
110,When My Baby's In Boots,Randall King,2,1,1,1,0,37900,18000,19900,0,2024.07.11
111,Work Boots,Cody Johnson,2,-2,4,1,0,37900,-23600,61500,238539,2024.07.11
112,Tennessee Numbers,Morgan Wallen,4,4,0,1,0,37600,37600,0,627412,2024.07.11
113,Neon Star (Country Boy Lullaby),Morgan Wallen,4,2,2,1,0,37600,17900,19700,1305365,2024.07.11
114,Sunrise,Morgan Wallen,4,3,1,2,0,37300,23000,14300,2817353,2024.07.11
115,Devil Don't Know,Morgan Wallen,3,2,1,1,0,33100,18800,14300,670319,2024.07.11
116,Where That Came From,Randy Travis,8,4,4,2,0,33000,-6200,39200,682244,2024.07.11
117,Ain't That Some,Morgan Wallen,4,1,3,2,0,32100,12100,20000,4732503,2024.07.11
118,You'll Always Be My Baby (Written For Daughters' Weddings),Alan Jackson,8,3,5,1,0,30200,13200,17000,41168,2024.07.11
119,Change The Game,Cody Jinks,13,11,2,4,0,29900,25800,4100,68029,2024.07.11
120,Sweet Dreams,Koe Wetzel,33,-52,85,5,0,29300,-101700,131000,6342814,2024.07.11
121,I Got A Problem,Drake Milligan,14,1,13,2,0,29000,3600,25400,44548,2024.07.11
122,Me To Me,Morgan Wallen,11,11,0,11,0,27900,27900,0,818076,2024.07.11
123,Grandpa (Tell Me 'Bout The Good Old Days),Cody Johnson,3,3,0,1,0,27300,27300,0,103,2024.07.11
124,F150-50,Morgan Wallen,2,2,0,1,0,27200,27200,0,697667,2024.07.11
125,180 (Lifestyle),Morgan Wallen,3,1,2,2,0,25400,-4100,29500,1382292,2024.07.11
126,I Wrote The Book,Morgan Wallen,3,3,0,2,0,22400,22400,0,3028083,2024.07.11
127,Leave You Alone,Kane Brown,6,-8,14,6,0,22100,-9700,31800,153641,2024.07.11
128,A Little Bit Closer,Braxton Keith,2,0,2,1,0,21700,-3800,25500,197071,2024.07.11
129,What Would You Do?,Tucker Wetmore,8,-5,13,1,0,21200,-12800,34000,1451243,2024.07.11
130,Dying Man,Morgan Wallen,3,3,0,1,0,21000,21000,0,1009716,2024.07.11
131,Does Heaven Have A Creek,Elvie Shane,4,3,1,4,0,21000,19200,1800,44073,2024.07.11
132,What's Your Drinking Song?,Kyle Park,1,1,0,1,0,19900,19900,0,0,2024.07.11
133,Relapse,Warren Zeiders,5,5,0,2,0,19400,19400,0,3575127,2024.07.11
134,Am I The Only One,Aaron Lewis,5,0,5,2,0,19400,2500,16900,528727,2024.07.11
135,Not Today,Mitchell Tenpenny,18,10,8,5,0,18700,17300,1400,266346,2024.07.11
136,Two Night Stands,Kylie Morgan,24,-16,40,6,0,17200,-22600,39800,45618,2024.07.11
137,Don't Think Jesus,Morgan Wallen,2,2,0,1,0,16500,16500,0,843437,2024.07.11
138,Sad Girl Summer,Maddie & Tae,2,1,1,2,0,16300,12900,3400,171450,2024.07.11
139,I'Ve Seen Me Do It,Joe Peters,3,2,1,1,0,16100,14700,1400,276,2024.07.11
140,Your Healing Is On The Way,Greater Vision,2,0,2,2,0,16100,4300,11800,3383,2024.07.11
141,Mind Of A Country Boy,Luke Bryan,5,-13,18,1,0,15800,-67200,83000,845431,2024.07.11
142,Hurricane,Parker Mccollum,2,2,0,2,0,15400,15400,0,54703,2024.07.11
143,Any Given Friday Night,Luke Combs,2,0,2,1,0,14600,0,14600,186854,2024.07.11
144,Waiting For Me,Truesong,2,2,0,2,0,13700,13700,0,1226,2024.07.11
144,God's Been Good,LeFevre Quartet,2,2,0,2,0,13700,13700,0,751,2024.07.11
146,My Constant Savior,Donna Ulisse,2,1,1,2,0,13100,7500,5600,7,2024.07.11
146,Revival Broke Out,Gaither Vocal Band,2,1,1,2,0,13100,7500,5600,2546,2024.07.11
148,Here Comes Jesus,Jeff & Sheri Easter,2,1,1,2,0,13100,3200,9900,13428,2024.07.11
148,Forgiven,Joseph Habedank,2,1,1,2,0,13100,3200,9900,4800,2024.07.11
150,It Ain't Austin,George Birge,1,0,1,1,0,12300,8900,3400,39570,2024.07.11
151,Oklahoma Smokeshow,Zach Bryan,3,2,1,2,0,11900,7900,4000,6773382,2024.07.11
152,"I, John",Blackwood Brothers Quartet,2,1,1,2,0,11800,5600,6200,42,2024.07.11
152,There Is A Name,LeFevre Quartet,2,1,1,2,0,11800,5600,6200,4445,2024.07.11
154,Help Is On The Way,Gold City,2,0,2,2,0,11800,0,11800,13806,2024.07.11
155,We Are The Church,Ernie Haase & Signature Sound,2,-1,3,2,0,11800,-7500,19300,21143,2024.07.11
156,It's All Good 'Til It Ain't,Struggle Jennings & Caitlynne Curtis,10,-6,16,1,0,11700,-15900,27600,0,2024.07.11
157,Paying For It,Levi Hummon,16,-4,20,3,0,11600,0,11600,69195,2024.07.11
158,Beautifully Broken,Bailey Marie Griggs,2,2,0,1,0,10600,10600,0,0,2024.07.11
159,Would If I Could (Feat. Lainey Wilson),Ernest,6,0,6,1,0,10100,-2400,12500,845637,2024.07.11
160,Checking In,For King & Country & Lee Brice,1,1,0,1,0,9900,9900,0,82933,2024.07.11
160,Fishin' In The Dark,Niko Moon,1,1,0,1,0,9900,9900,0,633764,2024.07.11
160,"Hallelujah, He Hideth My Soul",Daryl Williams Union,1,1,0,1,0,9900,9900,0,67,2024.07.11
160,Growin' Up And Gettin' Old,Luke Combs,1,1,0,1,0,9900,9900,0,639899,2024.07.11
164,4x4xu,Lainey Wilson,3,3,0,2,0,9300,9300,0,2377985,2024.07.11
165,Mountain With A View,Kelsea Ballerini,6,4,2,1,0,9200,6400,2800,313121,2024.07.11
166,Buckles And Broken Hearts,Joe Peters,1,1,0,1,0,9200,9200,0,523,2024.07.11
167,Damn Right I Do,George Birge,1,0,1,1,0,9000,5600,3400,32294,2024.07.11
167,Hard On The Bottle,George Birge,1,0,1,1,0,9000,5600,3400,8625,2024.07.11
169,Days That End In Why,Morgan Wallen,6,4,2,1,0,8100,6300,1800,693117,2024.07.11
170,Whatever Gets You Through It,Morgan Gruber,8,2,6,1,0,8100,1900,6200,179,2024.07.11
171,Honky Tonk Roll,Wade Bowen,3,0,3,1,0,7700,-4400,12100,1772,2024.07.11
172,Kiss It Goodbye,Morgan Gruber,7,7,0,1,0,7600,7600,0,1711,2024.07.11
173,Means Something To Me,Tate Emmons,1,1,0,1,0,7500,7500,0,409,2024.07.11
173,Scars In Heaven,Nelons,1,1,0,1,0,7500,7500,0,992,2024.07.11
173,Braggin' On Jesus,Steeles,1,1,0,1,0,7500,7500,0,1285,2024.07.11
173,My Jesus,Anne Wilson,1,1,0,1,0,7500,7500,0,1226136,2024.07.11
173,By Your Grace,Cody Johnson,1,1,0,1,0,7500,7500,0,372048,2024.07.11
178,Give Me A Sunrise,Braxton Keith,2,1,1,1,0,7400,1800,5600,100833,2024.07.11
179,Dive,Luke Combs,2,0,2,1,0,7400,-18100,25500,1216837,2024.07.11
180,That's Texas,Cody Johnson,2,-1,3,1,0,7400,-15500,22900,227675,2024.07.11
181,Pour Decisions,Ryan And Rory,1,1,0,1,0,7300,7300,0,271802,2024.07.11
182,Feelin' Country,Thomas Rhett,1,1,0,1,0,7200,7200,0,1314103,2024.07.11
183,Certified,Laura Bryna,14,-1,15,1,0,7200,0,7200,13558,2024.07.11
184,Heart They Didn'T Break,Maddie & Tae,16,1,15,1,0,7100,1400,5700,173997,2024.07.11
185,"Memphis, The Blues",Zach Bryan,4,2,2,1,0,6800,1900,4900,6060562,2024.07.11
186,Wings Of A Dove,Jonathan Wilburn,2,1,1,2,0,6600,1000,5600,0,2024.07.11
187,Leather,Cody Johnson,1,1,0,1,0,6300,6300,0,369755,2024.07.11
188,Turn Your Back,Justified Quartet,1,1,0,1,0,6200,6200,0,69,2024.07.11
188,Prayin' In A Deer Stand,Luke Bryan,1,1,0,1,0,6200,6200,0,36136,2024.07.11
188,That Is That,Adams Voice,1,1,0,1,0,6200,6200,0,3,2024.07.11
188,He's Got A Way,Southbound,1,1,0,1,0,6200,6200,0,1438,2024.07.11
188,Everybody's Song,Poet Voices,1,1,0,1,0,6200,6200,0,59,2024.07.11
188,Bible Verses,Blake Shelton,1,1,0,1,0,6200,6200,0,14146,2024.07.11
188,Come To The Well,Inspirations,1,1,0,1,0,6200,6200,0,14075,2024.07.11
188,Mansions,Sound Street,1,1,0,1,0,6200,6200,0,1456,2024.07.11
188,He Bought Me,Old Paths,1,1,0,1,0,6200,6200,0,1819,2024.07.11
197,The End,Endless Highway,1,0,1,1,0,6200,0,6200,1565,2024.07.11
197,Back To The Garden,Erwins,1,0,1,1,0,6200,0,6200,0,2024.07.11
197,There's Always A Place At The Table,Sunday Drive,1,0,1,1,0,6200,0,6200,383,2024.07.11
197,I Think I'Ll Just Go On,Perrys,1,0,1,1,0,6200,0,6200,5850,2024.07.11
201,In God's Time,Jordan Family Band,1,-1,2,1,0,6200,-7500,13700,1941,2024.07.11
202,He Pilots My Ship,Tribute Quartet,1,-2,3,1,0,6200,-15500,21700,4456,2024.07.11
1,Cowgirls,Morgan Wallen,9064,648,8416,145,0,33677200,2009700,31667500,15825949,2024.07.18
2,I Had Some Help,Post Malone,8540,-77,8617,145,0,33015000,-102200,33117200,33789396,2024.07.18
3,A Bar Song (Tipsy),Shaboozey,7391,1068,6323,144,0,27667000,3831800,23835200,39618104,2024.07.18
4,Bulletproof,Nate Smith,6508,458,6050,145,0,22619100,2028500,20590600,6393060,2024.07.18
5,Where It Ends,Bailey Zimmerman,5657,-202,5859,141,0,21708400,-1398400,23106800,5760916,2024.07.18
6,Dirt Cheap,Cody Johnson,6095,350,5745,145,0,21361900,1706500,19655400,6205757,2024.07.18
7,She's Somebody's Daughter,Drew Baldridge,6214,647,5567,145,0,21329800,2025700,19304100,542926,2024.07.18
8,Young Love & Saturday Nights,Chris Young,5797,118,5679,145,0,19258500,151600,19106900,816737,2024.07.18
9,We Ride,Bryan Martin,4932,-2791,7723,145,0,18723400,-7910600,26634000,4523308,2024.07.18
10,Ain't No Love In Oklahoma (From Twisters: The Album),Luke Combs,5278,288,4990,145,0,18566500,1050400,17516100,9933801,2024.07.18
11,Chevrolet,Dustin Lynch Feat. Jelly Roll,5305,233,5072,144,0,18080900,670700,17410200,3173110,2024.07.18
12,Love You Again,Chase Matthew,4537,176,4361,145,0,14996100,664900,14331200,1908134,2024.07.18
13,Hang Tight Honey,Lainey Wilson,3993,227,3766,145,0,13392100,875000,12517100,3904817,2024.07.18
14,"Love You, Miss You, Mean It",Luke Bryan,3690,484,3206,145,0,12795500,2388900,10406600,2591010,2024.07.18
15,This Is My Dirt,Justin Moore,3848,453,3395,145,0,12238600,1335500,10903100,509864,2024.07.18
16,One Bad Habit,Tim McGraw,3731,382,3349,145,0,11797900,1039500,10758400,550477,2024.07.18
17,Austin,Dasha,3389,387,3002,141,0,10971600,810100,10161500,12010969,2024.07.18
18,I Am Not Okay,Jelly Roll,2609,334,2275,145,0,8872500,1192800,7679700,10272846,2024.07.18
19,Beautiful As You,Thomas Rhett,2617,299,2318,142,0,8463300,1298500,7164800,4850308,2024.07.18
20,Messed Up As Me,Keith Urban,2682,231,2451,141,0,7982000,1036900,6945100,1179183,2024.07.18
21,Gonna Love You,Parmalee,2757,229,2528,144,0,7796200,1051500,6744700,277669,2024.07.18
22,Miles On It,Marshmello & Kane Brown,2368,365,2003,141,0,7365000,1272000,6093000,13122766,2024.07.18
23,Bigger Houses,Dan + Shay,2533,389,2144,143,0,7162400,971600,6190800,1222337,2024.07.18
24,Pour Me A Drink,Post Malone,1524,725,799,121,0,5679300,2642300,3037000,12085477,2024.07.18
25,Dance With You,Brett Young,2121,28,2093,141,0,5454500,140800,5313700,606643,2024.07.18
26,Sounds Like The Radio,Zach Top,2031,183,1848,139,0,5401000,397500,5003500,996839,2024.07.18
27,Lies Lies Lies,Morgan Wallen,1315,394,921,129,0,5095800,626600,4469200,24224920,2024.07.18
28,Damn Good Day To Leave,Riley Green,1826,94,1732,139,0,4889500,445300,4444200,1378836,2024.07.18
29,American Girl,Dierks Bentley,1675,117,1558,141,0,4640400,369800,4270600,210320,2024.07.18
30,Cowboy Songs,George Birge,1757,81,1676,135,0,4626200,517200,4109000,537590,2024.07.18
31,Wind Up Missin' You,Tucker Wetmore,1207,50,1157,93,0,4231800,311200,3920600,6279354,2024.07.18
32,Think I’m In Love With You,Chris Stapleton,1468,158,1310,135,0,4203200,334200,3869000,5938618,2024.07.18
33,Boys Back Home,Dylan Marlowe Feat. Dylan Scott,1414,-87,1501,131,0,3721800,-131900,3853700,2883424,2024.07.18
34,Breakin' In Boots,Matt Stell,1582,174,1408,134,0,3275400,337800,2937600,558420,2024.07.18
35,Called Crazy,Kassi Ashton,802,-8,810,51,0,3075800,67200,3008600,354726,2024.07.18
36,Bones,Russell Dickerson,708,708,0,92,0,2807800,2807800,0,1093917,2024.07.18
37,Find Another Bar,Chris Lane,1274,-46,1320,131,0,2755100,120600,2634500,74769,2024.07.18
38,Whatcha See Is Whatcha Get,Chris Janson,1177,37,1140,135,0,2658200,67500,2590700,138254,2024.07.18
39,This Town's Been Too Good To Us,Dylan Scott,1055,-47,1102,127,0,2552300,85400,2466900,2143550,2024.07.18
40,Forever To Me,Cole Swindell,828,5,823,76,0,2348200,77900,2270300,1272373,2024.07.18
41,Friends Like That,John Morgan Feat. Jason Aldean,960,76,884,85,0,2283200,85900,2197300,729235,2024.07.18
42,SIX FEET UNDER (Caleigh's Song),Hardy,742,10,732,94,0,2262600,2900,2259700,1786865,2024.07.18
43,I Tried A Ring On,Tigirlily Gold,1156,33,1123,129,0,2169100,119000,2050100,896310,2024.07.18
44,Wranglers,Miranda Lambert,1020,49,971,113,0,2166800,8000,2158800,1719077,2024.07.18
45,Tie Up,Zac Brown Band,1117,-41,1158,125,0,2150200,-900,2151100,729664,2024.07.18
46,Drinkin' Buddies,"Lee Brice, Hailey Whitters, And Nate Smith",675,1,674,96,0,1977300,71600,1905700,427354,2024.07.18
47,Coming Home,Old Dominion,689,109,580,83,0,1908500,277500,1631000,3205021,2024.07.18
48,Life With You,Kelsey Hart,975,104,871,95,0,1700900,108500,1592400,1877804,2024.07.18
49,Cowboys Cry Too,Kelsea Ballerini,639,106,533,117,0,1469300,35000,1434300,5621170,2024.07.18
50,Holy Smokes,Bailey Zimmerman,492,79,413,42,0,1400800,324900,1075900,4642158,2024.07.18
51,Fall Of Summer,Scotty McCreery,644,107,537,96,0,1297000,101800,1195200,509480,2024.07.18
52,Hometown Home,Locash,734,98,636,83,0,1281200,128200,1153000,99214,2024.07.18
53,Country Back,Randy Houser,729,86,643,79,0,1163100,126800,1036300,40204,2024.07.18
54,High Road,Koe Wetzel,342,115,227,37,0,1024000,589900,434100,14306532,2024.07.18
55,Just To Say We Did,Kenny Chesney,376,207,169,43,0,1012300,435500,576800,258231,2024.07.18
56,Neon Baby,Annie Bosko,602,188,414,104,0,921800,325300,596500,15994,2024.07.18
57,Devil You Know,Tyler Braden,440,-11,451,47,0,908400,-41200,949600,4645816,2024.07.18
58,Single Again,Josh Ross,583,10,573,74,0,781000,-39000,820000,2395983,2024.07.18
59,Everything I Need,Chayce Beckham,419,6,413,60,0,754900,95700,659200,287216,2024.07.18
60,This Heart,Corey Kent,491,-1,492,51,0,743500,6200,737300,1272310,2024.07.18
61,Strangers,Kameron Marlowe & Ella Langley,490,43,447,47,0,737900,91000,646900,2338162,2024.07.18
62,Country House,Sam Hunt,368,36,332,72,0,668700,73300,595400,407278,2024.07.18
63,Break Mine,Brothers Osborne,304,14,290,44,0,600100,103100,497000,259269,2024.07.18
64,Park,Tyler Hubbard,266,-5,271,42,0,588100,68200,519900,1185399,2024.07.18
65,The Devil I Know,Ashley McBryde,366,12,354,45,0,570500,51500,519000,454015,2024.07.18
66,Pink Skies,Zach Bryan,161,9,152,8,0,560900,-8200,569100,20695820,2024.07.18
67,You Look Like You Love Me,Ella Langley & Riley Green,115,38,77,12,0,519100,163200,355900,10149545,2024.07.18
68,Roulette On The Heart,Conner Smith,373,-7,380,54,0,488600,-22000,510600,577432,2024.07.18
69,Things I Take For Granted,Larry Fleet,313,-14,327,47,0,462700,-62000,524700,578221,2024.07.18
70,Never Been Over,Darius Rucker,262,32,230,57,0,453000,169300,283700,204874,2024.07.18
71,Over When We'Re Sober,Brantley Gilbert,284,36,248,58,0,448600,34300,414300,1239513,2024.07.18
72,100%,Styles Haury,95,20,75,40,0,414700,90300,324400,7638,2024.07.18
73,Young Man,Greylan James,50,-1,51,3,0,338800,36700,302100,37325,2024.07.18
74,Good On You,Priscilla Block,217,-14,231,37,0,310500,16600,293900,713387,2024.07.18
75,Uh-huh (Ajá),Frank Ray,285,5,280,39,0,310000,2700,307300,8670,2024.07.18
76,Bury Me In This Bar,Dalton Dover,245,-27,272,43,0,296800,-16300,313100,36681,2024.07.18
77,King Of Country Music,Ryan Larkins,247,-103,350,43,0,281100,-136300,417400,12513,2024.07.18
78,Beatles And Eagles,Frontmen,223,-4,227,30,0,277300,-40900,318200,1026,2024.07.18
79,Moth To A Flame,Morgan Wade,58,10,48,57,0,271500,193200,78300,421043,2024.07.18
80,Pray All The Way Home,Austin Snell,144,1,143,24,0,256700,14400,242300,661407,2024.07.18
81,Dance Like No One’s Watching,Gabby Barrett,273,-46,319,38,0,250100,-90900,341000,400730,2024.07.18
82,Wine Into Whiskey,Tucker Wetmore,42,-6,48,2,0,246100,-37500,283600,5596458,2024.07.18
83,Man On The Moon,Megan Moroney,56,55,1,54,0,230400,228500,1900,2378625,2024.07.18
84,Baby Daddy's Weekend,Elle King,226,1,225,38,0,220900,-50600,271500,47721,2024.07.18
85,Worst Way,Riley Green,27,3,24,2,0,199200,90000,109200,4646530,2024.07.18
86,I Could Be That Rain,Randall King,155,26,129,19,0,190100,38700,151400,289920,2024.07.18
87,Acres,Brian Kelley,190,-43,233,40,0,184100,-5500,189600,132670,2024.07.18
88,Mia Down In Mia,George Strait,26,4,22,3,0,180800,33600,147200,304857,2024.07.18
89,Shake Shake (All Night Long),Mason Ramsey,52,52,0,26,0,176800,176800,0,79,2024.07.18
90,Songs About Whiskey,Anne Wilson,49,30,19,15,0,155800,46400,109400,206500,2024.07.18
91,Not Today,Mitchell Tenpenny,111,93,18,32,0,148700,130000,18700,293452,2024.07.18
92,How Is She,Cole Swindell,18,2,16,1,0,148100,22800,125300,44395,2024.07.18
93,Truck On Fire,Carly Pearce,34,14,20,3,0,136500,69100,67400,853461,2024.07.18
94,Roots,Austin Burke,31,4,27,1,0,121300,16700,104600,8463,2024.07.18
95,Spin You Around (1/24),Morgan Wallen,33,2,31,4,0,118700,-21000,139700,5672320,2024.07.18
96,Love The Leavin',Drew Parker,135,8,127,20,0,110500,-10800,121300,174628,2024.07.18
97,American Nights,Zach Bryan,37,9,28,2,0,93800,16000,77800,9697287,2024.07.18
98,Whether You Love Me Or Not,Meghan Patrick,48,48,0,48,0,76700,76700,0,60462,2024.07.18
98,Diamond And A Baby,Sarahbeth Taite,48,48,0,48,0,76700,76700,0,5672,2024.07.18
100,Wondering Why,Red Clay Strays,24,-3,27,4,0,74500,-8900,83400,4437222,2024.07.18
101,Broadway Girls,Lil Durk Feat. Morgan Wallen,16,0,16,2,0,60600,1900,58700,5931740,2024.07.18
102,Running Out Of Time,Wyatt Flores,16,-1,17,2,0,59200,-12300,71500,373921,2024.07.18
103,New To Country,Bailey Zimmerman,14,0,14,1,0,52300,1600,50700,4622721,2024.07.18
104,The Star-Spangled Banner,Chris Stapleton,11,-21,32,11,0,51200,-115400,166600,109140,2024.07.18
105,I Got A Problem,Drake Milligan,21,7,14,3,0,47200,18200,29000,50003,2024.07.18
106,Whiskey Drink,Jason Aldean,19,19,0,7,0,43400,43400,0,538039,2024.07.18
107,Goodbye You,Landon Parker,49,49,0,17,0,40700,40700,0,1289,2024.07.18
108,Change The Game,Cody Jinks,10,-3,13,3,0,40500,10600,29900,79315,2024.07.18
109,You In A Honky Tonk,Randall King,2,1,1,1,0,39800,38000,1800,308857,2024.07.18
110,A Little Bit Closer,Braxton Keith,2,0,2,1,0,37900,16200,21700,208697,2024.07.18
111,When My Baby's In Boots,Randall King,2,0,2,1,0,37900,0,37900,0,2024.07.18
112,No Caller ID,Megan Moroney,15,14,1,15,0,36500,32700,3800,3210869,2024.07.18
113,That's Texas,Cody Johnson,2,0,2,1,0,31600,24200,7400,240751,2024.07.18
114,Man Upstairs,Tim Dugger,9,-1,10,1,0,31000,-13700,44700,10709,2024.07.18
115,Oklahoma Sooner,Jake Banfield,11,0,11,1,0,30900,-9700,40600,4090,2024.07.18
116,Hey Driver,Zach Bryan Feat. The War and Treaty,14,-11,25,1,0,28400,-29200,57600,5260750,2024.07.18
117,Lighten That Load,Waylon Hanel,34,34,0,17,0,27600,27600,0,885,2024.07.18
118,Sunrise,Morgan Wallen,12,8,4,12,0,25600,-11700,37300,2966567,2024.07.18
119,Am I The Only One,Aaron Lewis,5,0,5,2,0,25100,5700,19400,628746,2024.07.18
120,Long Live Country Music,Cody Johnson,11,11,0,11,0,24400,24400,0,165223,2024.07.18
121,4x4xu,Lainey Wilson,4,1,3,4,0,22000,12700,9300,2265759,2024.07.18
122,Work Boots,Cody Johnson,2,0,2,1,0,21700,-16200,37900,246101,2024.07.18
123,Lovin' Where It's Goin',Josh Ward,1,1,0,1,0,19900,19900,0,27062,2024.07.18
123,Cause He's A Cowboy,Matt Castillo,1,1,0,1,0,19900,19900,0,1527,2024.07.18
123,Quittin' Time,Zach Bryan,1,1,0,1,0,19900,19900,0,1123169,2024.07.18
126,Loud and Heavy,Cody Jinks,1,0,1,1,0,19900,19000,900,1399793,2024.07.18
127,Wings Of A Dove,Jonathan Wilburn,3,1,2,3,0,19300,12700,6600,0,2024.07.18
128,You'll Always Be My Baby (Written For Daughters' Weddings),Alan Jackson,6,-2,8,1,0,18100,-12100,30200,46153,2024.07.18
129,Kids,New Kids On The Block,1,0,1,1,0,18000,12400,5600,103616,2024.07.18
130,Dive,Luke Combs,1,-1,2,1,0,18000,10600,7400,1219159,2024.07.18
131,Hell Yeah,Little Big Town,2,2,0,1,0,17300,17300,0,177311,2024.07.18
132,Oklahoma Smokeshow,Zach Bryan,5,2,3,3,0,16400,4500,11900,6696772,2024.07.18
133,Would If I Could (Feat. Lainey Wilson),Ernest,7,1,6,1,0,16200,6100,10100,887220,2024.07.18
134,Meet Me At The Cross,Brian Free & Assurance,2,1,1,2,0,15500,9900,5600,6560,2024.07.18
135,Two Night Stands,Kylie Morgan,25,1,24,5,0,14300,-2900,17200,47971,2024.07.18
136,Heaven On A Dirt Road,Jesse Felder,17,17,0,17,0,13800,13800,0,0,2024.07.18
137,Sweet Dreams,Koe Wetzel,23,-10,33,2,0,13300,-16000,29300,6375552,2024.07.18
138,The Building,Emily Ann Roberts,2,2,0,2,0,13100,13100,0,26112,2024.07.18
139,Forgiven,Joseph Habedank,2,0,2,2,0,13100,0,13100,7198,2024.07.18
140,Feel Like This,Ingrid Andress,2,2,0,2,0,12900,12900,0,237227,2024.07.18
141,Where That Came From,Randy Travis,4,-4,8,2,0,12200,-20800,33000,718453,2024.07.18
142,My God,Scotty Inman,2,1,1,2,0,11800,6200,5600,40712,2024.07.18
143,He Pilots My Ship,Tribute Quartet,2,1,1,2,0,11800,5600,6200,5628,2024.07.18
143,In God's Time,Jordan Family Band,2,1,1,2,0,11800,5600,6200,3281,2024.07.18
145,We Are The Church,Ernie Haase & Signature Sound,2,0,2,2,0,11800,0,11800,20618,2024.07.18
145,Help Is On The Way,Gold City,2,0,2,2,0,11800,0,11800,15494,2024.07.18
145,"I, John",Blackwood Brothers Quartet,2,0,2,2,0,11800,0,11800,37,2024.07.18
148,Paying For It,Levi Hummon,12,-4,16,1,0,10800,-800,11600,81500,2024.07.18
149,Ain't That Some,Morgan Wallen,2,-2,4,2,0,10600,-21500,32100,4636362,2024.07.18
150,Honky Tonk Roll,Wade Bowen,4,1,3,2,0,10400,2700,7700,2011,2024.07.18
151,Sunday Sermons,Anne Wilson,1,1,0,1,0,9900,9900,0,468199,2024.07.18
151,Tattoo On A Sunburn,Luke Combs,1,1,0,1,0,9900,9900,0,200355,2024.07.18
151,Drinkin' It Wrong,Adam Doleac,1,1,0,1,0,9900,9900,0,8858,2024.07.18
151,Praying People,Meadows,1,1,0,1,0,9900,9900,0,131,2024.07.18
155,Forward,Niia,1,1,0,1,0,9800,9800,0,184,2024.07.18
156,'98 Braves,Morgan Wallen,2,-3,5,2,0,9700,-36400,46100,1870162,2024.07.18
157,Buckles And Broken Hearts,Joe Peters,1,0,1,1,0,9200,0,9200,556,2024.07.18
158,Beer Chaser,Ashlie Amber,10,10,0,10,0,8900,8900,0,138,2024.07.18
159,Heart They Didn'T Break,Maddie & Tae,16,0,16,1,0,8700,1600,7100,189345,2024.07.18
160,Certified,Laura Bryna,14,0,14,1,0,8600,1400,7200,13362,2024.07.18
161,Oklahoma,Carly Pearce,11,5,6,1,0,7800,2400,5400,27420,2024.07.18
162,Holiday Getaway,Adrianna Sgro,3,3,0,1,0,7800,7800,0,0,2024.07.18
163,My Bar,Priscilla Block,2,1,1,1,0,7700,6100,1600,116147,2024.07.18
164,Thank You Lord For Grace,Authentic Unlimited,1,1,0,1,0,7500,7500,0,5291,2024.07.18
164,I'm So Blessed,CAIN,1,1,0,1,0,7500,7500,0,727715,2024.07.18
164,Red Letter Blueprint,Scotty McCreery,1,1,0,1,0,7500,7500,0,53281,2024.07.18
167,Middle Of Nowhere,Southbound,1,0,1,1,0,7500,1900,5600,5147,2024.07.18
168,Mansions,Sound Street,1,0,1,1,0,7500,1300,6200,1952,2024.07.18
169,Here Comes Jesus,Jeff & Sheri Easter,1,-1,2,1,0,7500,-5600,13100,15870,2024.07.18
170,Hey Mom I Made It,Sacha,1,1,0,1,0,7300,7300,0,40539,2024.07.18
171,Hell Is A Dance Floor,Vincent Mason,1,0,1,1,0,7300,3400,3900,1496053,2024.07.18
172,Any Given Friday Night,Luke Combs,1,-1,2,1,0,7300,-7300,14600,210800,2024.07.18
173,It's All Good 'Til It Ain't,Struggle Jennings & Caitlynne Curtis,7,-3,10,1,0,6900,-4800,11700,0,2024.07.18
174,Am I Okay?,Megan Moroney,2,2,0,2,0,6600,6600,0,5563404,2024.07.18
175,If She Wants A Cowboy,Zach Bryan,2,2,0,1,0,6500,6500,0,615963,2024.07.18
176,Come On In,Kingdom Heirs,1,1,0,1,0,6200,6200,0,8196,2024.07.18
176,Tailgate Church Pew,Granger Smith,1,1,0,1,0,6200,6200,0,4283,2024.07.18
176,"Liar, Liar",Brian Free & Assurance,1,1,0,1,0,6200,6200,0,2196,2024.07.18
176,Warmin' Up,Perrys,1,1,0,1,0,6200,6200,0,6513,2024.07.18
176,Ready To Leave,Down East Boys,1,1,0,1,0,6200,6200,0,811,2024.07.18
176,A Hundred Different Altars,Steeles,1,1,0,1,0,6200,6200,0,947,2024.07.18
176,Think About There,Greater Vision,1,1,0,1,0,6200,6200,0,9287,2024.07.18
176,The Tomb Is Empty Now,Browns,1,1,0,1,0,6200,6200,0,104,2024.07.18
184,Back To The Garden,Erwins,1,0,1,1,0,6200,0,6200,0,2024.07.18
184,That Is That,Adams Voice,1,0,1,1,0,6200,0,6200,5,2024.07.18
184,Turn Your Back,Justified Quartet,1,0,1,1,0,6200,0,6200,77,2024.07.18
184,There's Always A Place At The Table,Sunday Drive,1,0,1,1,0,6200,0,6200,355,2024.07.18
184,He Bought Me,Old Paths,1,0,1,1,0,6200,0,6200,2815,2024.07.18
189,Jesus Loves You,Cody Johnson,1,1,0,1,0,5800,5800,0,167134,2024.07.18
190,Sun To Me,Zach Bryan,6,0,6,2,0,5700,3400,2300,7065095,2024.07.18
191,Heaven Is Happening,Guardians,1,1,0,1,0,5600,5600,0,0,2024.07.18
191,Until Prayer Changes Me,Kingdom Heirs,1,1,0,1,0,5600,5600,0,13070,2024.07.18
191,He's Gettin' Me Ready,Darin & Brooke Aldridge Feat. The Oak Ridge Boys,1,1,0,1,0,5600,5600,0,342,2024.07.18
191,Fall Into Place,Jeff & Sheri Easter,1,1,0,1,0,5600,5600,0,3586,2024.07.18
191,Part Of The Family,Littles,1,1,0,1,0,5600,5600,0,0,2024.07.18
191,Man On The Middle Cross,Scotty Inman,1,1,0,1,0,5600,5600,0,0,2024.07.18
191,Way Up On The Mountain,Becky Isaacs Bowman,1,1,0,1,0,5600,5600,0,737,2024.07.18
191,"Jesus 1, Death 0",Truesong,1,1,0,1,0,5600,5600,0,0,2024.07.18
191,You Have Always Been My Shepherd,Legacy Five,1,1,0,1,0,5600,5600,0,6047,2024.07.18
191,Something To Shout About,Down East Boys,1,1,0,1,0,5600,5600,0,5096,2024.07.18
191,The Original Superman,Tate Emmons,1,1,0,1,0,5600,5600,0,177,2024.07.18
191,Dear Lord,Darin & Brooke Aldridge,1,1,0,1,0,5600,5600,0,5256,2024.07.18
191,Door Wide Open,Gordon Mote,1,1,0,1,0,5600,5600,0,314,2024.07.18
191,Love Me Back To Life,Jordan Family Band,1,1,0,1,0,5600,5600,0,0,2024.07.18
191,Preach The Word,Steve Ladd,1,1,0,1,0,5600,5600,0,52,2024.07.18
206,Jeans & Jesus,Sound,1,0,1,1,0,5600,5200,400,0,2024.07.18
207,Made A Mess,Tim Menzies,1,0,1,1,0,5600,0,5600,2735,2024.07.18
207,After All,Mark Trammell Quartet,1,0,1,1,0,5600,0,5600,1247,2024.07.18
207,Praying For The Prodigal,Kingsmen,1,0,1,1,0,5600,0,5600,582,2024.07.18
207,Blue Collar Gospel,Jerry Salley,1,0,1,1,0,5600,0,5600,0,2024.07.18
207,He Is Good To Me,Taylors,1,0,1,1,0,5600,0,5600,16288,2024.07.18
207,Be Ready,Karen Peck & New River,1,0,1,1,0,5600,0,5600,19688,2024.07.18
207,Cross Over,Allens,1,0,1,1,0,5600,0,5600,653,2024.07.18
207,Hole In The Heart,Nelons,1,0,1,1,0,5600,0,5600,0,2024.07.18
207,Back 40 Back,Luke Combs,2,0,2,1,0,5600,0,5600,177334,2024.07.18
216,Means Something To Me,Tate Emmons,1,0,1,1,0,5600,-1900,7500,506,2024.07.18
217,Revival Broke Out,Gaither Vocal Band,1,-1,2,1,0,5600,-7500,13100,4087,2024.07.18
218,Your Healing Is On The Way,Greater Vision,1,-1,2,1,0,5600,-10500,16100,5655,2024.07.18
1,A Bar Song (Tipsy),Shaboozey,8449,1058,7391,144,0,31403400,3736400,27667000,37974322,2024.07.25
2,Cowgirls,Morgan Wallen,8229,-835,9064,145,0,31357700,-2319500,33677200,15681891,2024.07.25
3,I Had Some Help,Post Malone,7847,-693,8540,145,0,31107800,-1907200,33015000,33125787,2024.07.25
4,Bulletproof,Nate Smith,6752,244,6508,145,0,23189600,570500,22619100,6243444,2024.07.25
5,She's Somebody's Daughter,Drew Baldridge,6549,335,6214,145,0,22546100,1216300,21329800,560169,2024.07.25
6,Dirt Cheap,Cody Johnson,6322,227,6095,145,0,21892300,530400,21361900,6167460,2024.07.25
7,Where It Ends,Bailey Zimmerman,5266,-391,5657,140,0,20182400,-1526000,21708400,5567341,2024.07.25
8,Ain't No Love In Oklahoma (From Twisters: The Album),Luke Combs,5650,372,5278,145,0,19795100,1228600,18566500,16569482,2024.07.25
9,Young Love & Saturday Nights,Chris Young,5825,28,5797,145,0,19133900,-124600,19258500,847852,2024.07.25
10,Chevrolet,Dustin Lynch Feat. Jelly Roll,5522,217,5305,145,0,19014100,933200,18080900,3454074,2024.07.25
11,Love You Again,Chase Matthew,4676,139,4537,145,0,15748700,752600,14996100,2205559,2024.07.25
12,"Love You, Miss You, Mean It",Luke Bryan,4017,327,3690,145,0,14249100,1453600,12795500,2582990,2024.07.25
13,Hang Tight Honey,Lainey Wilson,4111,118,3993,145,0,13657000,264900,13392100,3609079,2024.07.25
14,This Is My Dirt,Justin Moore,4079,231,3848,145,0,13338300,1099700,12238600,542378,2024.07.25
15,One Bad Habit,Tim McGraw,3853,122,3731,145,0,12704300,906400,11797900,526371,2024.07.25
16,Austin,Dasha,3581,192,3389,141,0,11490500,518900,10971600,11442943,2024.07.25
17,I Am Not Okay,Jelly Roll,2892,283,2609,145,0,9987000,1114500,8872500,10059230,2024.07.25
18,Messed Up As Me,Keith Urban,2872,190,2682,141,0,8873800,891800,7982000,1077567,2024.07.25
19,Miles On It,Marshmello & Kane Brown,2676,308,2368,144,0,8804600,1439600,7365000,13253595,2024.07.25
20,Beautiful As You,Thomas Rhett,2670,53,2617,143,0,8613100,149800,8463300,4873610,2024.07.25
21,Pour Me A Drink,Post Malone,2162,638,1524,137,0,7991400,2312100,5679300,9623475,2024.07.25
22,Gonna Love You,Parmalee,2784,27,2757,144,0,7901100,104900,7796200,295678,2024.07.25
23,Bigger Houses,Dan + Shay,2558,25,2533,141,0,7143700,-18700,7162400,1371177,2024.07.25
24,Lies Lies Lies,Morgan Wallen,1605,290,1315,129,0,6517500,1421700,5095800,21912414,2024.07.25
25,Sounds Like The Radio,Zach Top,2156,125,2031,143,0,6135400,734400,5401000,1270384,2024.07.25
26,Guy For That,Post Malone,1345,1345,0,107,0,5605300,5605300,0,8938,2024.07.25
27,Damn Good Day To Leave,Riley Green,2029,203,1826,143,0,5506400,616900,4889500,1378688,2024.07.25
28,Dance With You,Brett Young,2092,-29,2121,142,0,5182600,-271900,5454500,611515,2024.07.25
29,American Girl,Dierks Bentley,1708,33,1675,140,0,5101700,461300,4640400,190057,2024.07.25
30,Cowboy Songs,George Birge,1880,123,1757,135,0,4829600,203400,4626200,567535,2024.07.25
31,Think I’m In Love With You,Chris Stapleton,1589,121,1468,135,0,4776800,573600,4203200,6134138,2024.07.25
32,Wind Up Missin' You,Tucker Wetmore,1362,155,1207,130,0,4349300,117500,4231800,6334771,2024.07.25
33,Boys Back Home,Dylan Marlowe Feat. Dylan Scott,1628,214,1414,133,0,4132100,410300,3721800,2924914,2024.07.25
34,Breakin' In Boots,Matt Stell,1542,-40,1582,136,0,3306500,31100,3275400,534564,2024.07.25
35,Called Crazy,Kassi Ashton,815,13,802,51,0,2995500,-80300,3075800,339041,2024.07.25
36,Find Another Bar,Chris Lane,1397,123,1274,133,0,2938200,183100,2755100,79177,2024.07.25
37,This Town's Been Too Good To Us,Dylan Scott,1101,46,1055,127,0,2575500,23200,2552300,2042859,2024.07.25
38,Whatcha See Is Whatcha Get,Chris Janson,1212,35,1177,134,0,2523700,-134500,2658200,135310,2024.07.25
39,Friends Like That,John Morgan Feat. Jason Aldean,986,26,960,93,0,2508100,224900,2283200,723342,2024.07.25
40,Forever To Me,Cole Swindell,891,63,828,82,0,2418600,70400,2348200,1199804,2024.07.25
41,I Ain'T Sayin',Jordan Davis,812,812,0,101,0,2379200,2379200,0,560,2024.07.25
42,SIX FEET UNDER (Caleigh's Song),Hardy,760,18,742,97,0,2328700,66100,2262600,1391495,2024.07.25
43,Wranglers,Miranda Lambert,1054,34,1020,117,0,2282800,116000,2166800,1576969,2024.07.25
44,I Tried A Ring On,Tigirlily Gold,1222,66,1156,136,0,2162400,-6700,2169100,983732,2024.07.25
45,Tie Up,Zac Brown Band,1187,70,1117,126,0,2069800,-80400,2150200,664217,2024.07.25
46,Drinkin' Buddies,"Lee Brice, Hailey Whitters, And Nate Smith",687,12,675,92,0,1972600,-4700,1977300,405685,2024.07.25
47,Coming Home,Old Dominion,673,-16,689,80,0,1936000,27500,1908500,2917283,2024.07.25
48,Just To Say We Did,Kenny Chesney,637,261,376,76,0,1600000,587700,1012300,446891,2024.07.25
49,Life With You,Kelsey Hart,894,-81,975,96,0,1592100,-108800,1700900,1961693,2024.07.25
50,Fall Of Summer,Scotty McCreery,757,113,644,90,0,1552800,255800,1297000,526062,2024.07.25
51,Cowboys Cry Too,Kelsea Ballerini,703,64,639,116,0,1491400,22100,1469300,5538987,2024.07.25
52,Holy Smokes,Bailey Zimmerman,498,6,492,43,0,1361200,-39600,1400800,4584112,2024.07.25
53,Hometown Home,Locash,737,3,734,85,0,1295400,14200,1281200,103649,2024.07.25
54,Country Back,Randy Houser,755,26,729,78,0,1223600,60500,1163100,42717,2024.07.25
55,High Road,Koe Wetzel,383,41,342,39,0,1119600,95600,1024000,14944099,2024.07.25
56,Devil You Know,Tyler Braden,444,4,440,50,0,983700,75300,908400,4772042,2024.07.25
57,You Look Like You Love Me,Ella Langley & Riley Green,213,98,115,26,0,827100,308000,519100,8884845,2024.07.25
58,Single Again,Josh Ross,595,12,583,76,0,814300,33300,781000,2428982,2024.07.25
59,This Heart,Corey Kent,494,3,491,57,0,809900,66400,743500,1339037,2024.07.25
60,Everything I Need,Chayce Beckham,458,39,419,62,0,777900,23000,754900,291570,2024.07.25
61,Country House,Sam Hunt,416,48,368,62,0,759200,90500,668700,415069,2024.07.25
62,100%,Styles Haury,181,86,95,57,0,723200,308500,414700,11442,2024.07.25
63,The Devil I Know,Ashley McBryde,399,33,366,49,0,687300,116800,570500,529008,2024.07.25
64,Park,Tyler Hubbard,289,23,266,56,0,680800,92700,588100,1219750,2024.07.25
65,Strangers,Kameron Marlowe & Ella Langley,477,-13,490,46,0,654500,-83400,737900,2188814,2024.07.25
66,Bones,Russell Dickerson,363,-345,708,69,0,640500,-2167300,2807800,874745,2024.07.25
67,Neon Baby,Annie Bosko,408,-194,602,112,0,629300,-292500,921800,16683,2024.07.25
68,Break Mine,Brothers Osborne,294,-10,304,45,0,559100,-41000,600100,243055,2024.07.25
69,Pink Skies,Zach Bryan,168,7,161,10,0,543800,-17100,560900,19726256,2024.07.25
70,Roulette On The Heart,Conner Smith,364,-9,373,54,0,496700,8100,488600,581545,2024.07.25
71,Never Been Over,Darius Rucker,311,49,262,52,0,453500,500,453000,203037,2024.07.25
72,Over When We'Re Sober,Brantley Gilbert,289,5,284,53,0,439600,-9000,448600,828695,2024.07.25
73,Things I Take For Granted,Larry Fleet,283,-30,313,43,0,429600,-33100,462700,605608,2024.07.25
74,I Could Be That Rain,Randall King,149,-6,155,19,0,350500,160400,190100,179716,2024.07.25
75,Bury Me In This Bar,Dalton Dover,236,-9,245,43,0,332200,35400,296800,35918,2024.07.25
76,Good On You,Priscilla Block,208,-9,217,32,0,299900,-10600,310500,641735,2024.07.25
77,Feelin' Country,Thomas Rhett,47,47,0,46,0,284300,284300,0,1745417,2024.07.25
78,Wine Into Whiskey,Tucker Wetmore,47,5,42,2,0,279500,33400,246100,5698085,2024.07.25
79,Uh-huh (Ajá),Frank Ray,288,3,285,40,0,279000,-31000,310000,6792,2024.07.25
80,Baby Daddy's Weekend,Elle King,222,-4,226,37,0,268200,47300,220900,43058,2024.07.25
81,Out Of Oklahoma,Lainey Wilson,42,41,1,42,0,259500,256800,2700,3373938,2024.07.25
82,Pray All The Way Home,Austin Snell,143,-1,144,21,0,257700,1000,256700,624196,2024.07.25
83,Country Classic,Kane Brown,45,45,0,45,0,256400,256400,0,2243389,2024.07.25
84,Beatles And Eagles,Frontmen,218,-5,223,30,0,249100,-28200,277300,1134,2024.07.25
85,Three Drinks Behind,George Strait,38,38,0,5,0,247800,247800,0,1088389,2024.07.25
86,Truck On Fire,Carly Pearce,85,51,34,10,0,224300,87800,136500,824328,2024.07.25
87,Not Today,Mitchell Tenpenny,168,57,111,37,0,213700,65000,148700,257758,2024.07.25
88,Young Man,Greylan James,35,-15,50,3,0,212500,-126300,338800,44557,2024.07.25
89,Dance Like No One’s Watching,Gabby Barrett,229,-44,273,33,0,208900,-41200,250100,361489,2024.07.25
90,Leave The Light On,Jelly Roll,38,38,0,37,0,208600,208600,0,0,2024.07.25
91,Whiskey Drink,Jason Aldean,113,94,19,19,0,195700,152300,43400,718897,2024.07.25
92,Acres,Brian Kelley,258,68,190,46,0,194700,10600,184100,142492,2024.07.25
93,Worst Way,Riley Green,23,-4,27,2,0,165600,-33600,199200,4663122,2024.07.25
94,Songs About Whiskey,Anne Wilson,80,31,49,15,0,152100,-3700,155800,198993,2024.07.25
95,Roots,Austin Burke,38,7,31,1,0,145300,24000,121300,7628,2024.07.25
96,Ain't In Kansas Anymore,Miranda Lambert,19,19,0,19,0,139500,139500,0,2404977,2024.07.25
97,King Of Country Music,Ryan Larkins,114,-133,247,25,0,124000,-157100,281100,13591,2024.07.25
98,How Is She,Cole Swindell,15,-3,18,1,0,119300,-28800,148100,43684,2024.07.25
99,Dead End Road,Jelly Roll,16,16,0,14,0,104600,104600,0,4629149,2024.07.25
100,Love The Leavin',Drew Parker,138,3,135,21,0,98700,-11800,110500,145630,2024.07.25
101,Wondering Why,Red Clay Strays,28,4,24,4,0,90100,15600,74500,4490892,2024.07.25
102,American Nights,Zach Bryan,36,-1,37,1,0,89800,-4000,93800,7997226,2024.07.25
103,Mia Down In Mia,George Strait,11,-15,26,3,0,85300,-95500,180800,309569,2024.07.25
104,Hell Or High Water,Bailey Zimmerman,13,13,0,11,0,83800,83800,0,3114431,2024.07.25
105,Spin You Around (1/24),Morgan Wallen,27,-6,33,5,0,76400,-42300,118700,5698713,2024.07.25
106,What She's Like,Emma Klein,47,47,0,47,0,76200,76200,0,793,2024.07.25
106,Mother Of Three,Caitlyn Smith,47,47,0,47,0,76200,76200,0,11067,2024.07.25
108,Running Out Of Time,Wyatt Flores,16,0,16,1,0,73800,14600,59200,512406,2024.07.25
109,John Deere Green,"HIXTAPE Feat. HARDY, Morgan Wallen, Joe Diffie",10,10,0,7,0,73200,73200,0,0,2024.07.25
110,Keith Whitley,Morgan Wallen,16,15,1,15,0,54700,49400,5300,551910,2024.07.25
111,The Star-Spangled Banner,Chris Stapleton,14,3,11,13,0,52500,1300,51200,97435,2024.07.25
112,New To Country,Bailey Zimmerman,13,-1,14,1,0,50100,-2200,52300,4666318,2024.07.25
113,Oklahoma Sooner,Jake Banfield,12,1,11,1,0,45600,14700,30900,5711,2024.07.25
114,Man Upstairs,Tim Dugger,10,1,9,1,0,43800,12800,31000,8133,2024.07.25
115,'98 Braves,Morgan Wallen,4,2,2,2,0,43400,33700,9700,1734306,2024.07.25
116,Broadway Girls,Lil Durk Feat. Morgan Wallen,11,-5,16,2,0,41800,-18800,60600,5839469,2024.07.25
117,Mind Of A Country Boy,Luke Bryan,17,17,0,17,0,40300,40300,0,265962,2024.07.25
118,Dive,Luke Combs,2,1,1,1,0,39800,21800,18000,1246434,2024.07.25
119,Am I Okay?,Megan Moroney,6,4,2,1,0,37800,31200,6600,4532420,2024.07.25
120,Days That End In Why,Morgan Wallen,10,5,5,3,0,36100,31300,4800,706661,2024.07.25
121,Relapse,Warren Zeiders,37,31,6,15,0,35400,32300,3100,3505649,2024.07.25
122,Neon Star (Country Boy Lullaby),Morgan Wallen,3,3,0,1,0,34000,34000,0,1330863,2024.07.25
123,Fiddle In The Band,Kane Brown,2,1,1,1,0,33500,31700,1800,673576,2024.07.25
124,Work Boots,Cody Johnson,2,0,2,1,0,31600,9900,21700,244261,2024.07.25
125,Church Bells And Train Whistles,Brad Tursi,12,12,0,1,0,30500,30500,0,105544,2024.07.25
126,Oklahoma Smokeshow,Zach Bryan,4,-1,5,3,0,29400,13000,16400,7129757,2024.07.25
127,You In A Honky Tonk,Randall King,4,2,2,3,0,29000,-10800,39800,323771,2024.07.25
128,I Got A Problem,Drake Milligan,19,-2,21,3,0,28600,-18600,47200,50651,2024.07.25
129,Ain't That Some,Morgan Wallen,3,1,2,2,0,28200,17600,10600,4457692,2024.07.25
130,Beer Chaser,Ashlie Amber,34,24,10,17,0,27600,18700,8900,9059,2024.07.25
131,A Little Bit Closer,Braxton Keith,2,0,2,1,0,25500,-12400,37900,205935,2024.07.25
132,I Wrote The Book,Morgan Wallen,3,2,1,2,0,25000,25000,0,3245794,2024.07.25
133,Grandpa (Tell Me 'Bout The Good Old Days),Cody Johnson,2,1,1,1,0,23600,21800,1800,0,2024.07.25
134,Baby Do,Randall King,2,2,0,1,0,21700,21700,0,15208,2024.07.25
135,Longneck Way To Go,Midland Feat. Jon Pardi,3,3,0,2,0,21400,21400,0,146241,2024.07.25
136,That's Texas,Cody Johnson,3,1,2,2,0,21200,-10400,31600,226923,2024.07.25
137,Star Spangled Banner,Mickey Guyton,3,2,1,3,0,20800,17700,3100,0,2024.07.25
138,Loud and Heavy,Cody Jinks,2,1,1,2,0,20300,400,19900,1462519,2024.07.25
139,Over Drinkin' Under Thinkin',Drake Milligan,1,1,0,1,0,19900,19900,0,82221,2024.07.25
139,Open The Gate,Zach Bryan,1,1,0,1,0,19900,19900,0,1620478,2024.07.25
141,Everything Has Your Memory,Wade Bowen,1,0,1,1,0,19900,19900,0,6627,2024.07.25
142,Quittin' Time,Zach Bryan,1,0,1,1,0,19900,0,19900,1194264,2024.07.25
143,Change The Game,Cody Jinks,6,-4,10,2,0,19800,-20700,40500,86318,2024.07.25
144,Devil Don't Know,Morgan Wallen,2,2,0,1,0,19700,19700,0,649726,2024.07.25
144,Don't Think Jesus,Morgan Wallen,2,2,0,1,0,19700,19700,0,822512,2024.07.25
144,Me + All Your Reasons,Morgan Wallen,2,2,0,1,0,19700,19700,0,1054246,2024.07.25
144,Tennessee Fan,Morgan Wallen,2,2,0,1,0,19700,19700,0,1041860,2024.07.25
144,F150-50,Morgan Wallen,2,2,0,1,0,19700,19700,0,659648,2024.07.25
149,Whiskey Friends,Morgan Wallen,2,1,1,1,0,19700,17000,2700,1233522,2024.07.25
150,180 (Lifestyle),Morgan Wallen,2,1,1,1,0,19700,16200,3500,1432836,2024.07.25
151,Sunrise,Morgan Wallen,2,-10,12,1,0,19700,-5900,25600,2941369,2024.07.25
152,Two Night Stands,Kylie Morgan,24,-1,25,5,0,18000,3700,14300,48835,2024.07.25
153,Heart Of A Small Town,Tim Dugger,2,0,2,1,0,17400,12600,4800,18223,2024.07.25
154,Am I The Only One,Aaron Lewis,4,-1,5,1,0,17000,-8100,25100,606361,2024.07.25
155,Where That Came From,Randy Travis,2,-2,4,1,0,16600,4400,12200,636880,2024.07.25
156,Ain'T About You,Huntergirl,1,1,0,1,0,16100,16100,0,13188,2024.07.25
157,Hey Driver,Zach Bryan Feat. The War and Treaty,7,-7,14,2,0,15600,-12800,28400,5243424,2024.07.25
158,Dying Man,Morgan Wallen,1,1,0,1,0,15200,15200,0,1161141,2024.07.25
159,Any Given Friday Night,Luke Combs,2,1,1,1,0,14600,7300,7300,209702,2024.07.25
160,Heaven By Noon,Megan Moroney,2,2,0,1,0,14200,14200,0,990105,2024.07.25
161,Just A Bottle,Orlando Mendez,17,17,0,17,0,13800,13800,0,1171,2024.07.25
162,Heaven On A Dirt Road,Jesse Felder,17,0,17,17,0,13800,0,13800,0,2024.07.25
163,Goodbye You,Landon Parker,17,-32,49,17,0,13800,-26900,40700,1205,2024.07.25
164,When My Baby's In Boots,Randall King,1,-1,2,1,0,13600,-24300,37900,0,2024.07.25
165,Over Being Under You,Laura Bryna,14,14,0,5,0,13200,13200,0,6011,2024.07.25
166,You'll Always Be My Baby (Written For Daughters' Weddings),Alan Jackson,5,-1,6,1,0,12700,-5400,18100,44730,2024.07.25
167,Your Healing Is On The Way,Greater Vision,2,1,1,2,0,11800,6200,5600,5133,2024.07.25
168,Help Is On The Way,Gold City,2,0,2,2,0,11800,0,11800,17384,2024.07.25
169,Wings Of A Dove,Jonathan Wilburn,2,-1,3,2,0,11800,-7500,19300,0,2024.07.25
170,35s,Tyler Hubbard,1,1,0,1,0,11400,11400,0,88503,2024.07.25
171,Back 40 Back,Luke Combs,4,2,2,1,0,11200,5600,5600,190983,2024.07.25
172,Sundays In The South,Elvie Shane,1,1,0,1,0,9900,9900,0,3921,2024.07.25
172,The Blessing,Triumphant Quartet,1,1,0,1,0,9900,9900,0,985,2024.07.25
172,Love Carried The Cross,Endless Highway,1,1,0,1,0,9900,9900,0,5413,2024.07.25
172,Because He Lives,Carrie Underwood,1,1,0,1,0,9900,9900,0,51005,2024.07.25
176,Sweet Dreams,Koe Wetzel,17,-6,23,2,0,9700,-3600,13300,7233352,2024.07.25
177,Mint Tea,Johnny Blue Skies,7,7,0,1,0,9300,9300,0,0,2024.07.25
178,Whatever Gets You Through It,Morgan Gruber,9,4,5,1,0,9300,5600,3700,294,2024.07.25
179,Would If I Could (Feat. Lainey Wilson),Ernest,1,-6,7,1,0,9100,-7100,16200,854909,2024.07.25
180,Born With A Beer In My Hand,Morgan Wallen,2,2,0,1,0,9000,9000,0,703156,2024.07.25
181,Decoration,Jillian Riscoe,3,0,3,1,0,9000,7000,2000,5,2024.07.25
182,Paying For It,Levi Hummon,10,-2,12,1,0,9000,-1800,10800,80273,2024.07.25
183,Kiss It Goodbye,Morgan Gruber,6,2,4,1,0,8800,3900,4900,2906,2024.07.25
184,Certified,Laura Bryna,15,1,14,1,0,8700,100,8600,12823,2024.07.25
185,Hate My Heart,Carrie Underwood,1,1,0,1,0,8500,8500,0,78124,2024.07.25
186,Lucky,Megan Moroney,3,3,0,2,0,8400,8400,0,337804,2024.07.25
187,Mountain With A View,Kelsea Ballerini,7,2,5,1,0,8400,7200,1200,321959,2024.07.25
188,Last Rodeo,Restless Road,2,2,0,1,0,8100,8100,0,262502,2024.07.25
189,Never Left Me,Megan Moroney,2,2,0,2,0,8000,8000,0,1278658,2024.07.25
190,Sun To Me,Zach Bryan,8,2,6,2,0,8000,2300,5700,7022486,2024.07.25
191,"Salt, Lime & Tequila",Ryan Griffin,2,-1,3,1,0,8000,5600,2400,75371,2024.07.25
192,Workin' On It,Michael Ray,1,1,0,1,0,7600,7600,0,8333,2024.07.25
193,Whiskey Bent,Cody Johnson,1,1,0,1,0,7300,7300,0,754528,2024.07.25
193,Boots Don'T,Shania Twain & Breland,1,1,0,1,0,7300,7300,0,888599,2024.07.25
195,Oklahoma,Carly Pearce,9,-2,11,1,0,6700,-1100,7800,23404,2024.07.25
196,Fake Id,Sydney Mack,5,2,3,1,0,6300,3200,3100,664,2024.07.25
197,Make Me A Mop,Cody Johnson,1,1,0,1,0,6300,6300,0,82474,2024.07.25
198,I Think I'Ll Just Go On,Perrys,1,1,0,1,0,6200,6200,0,8268,2024.07.25
198,All Things,Sound,1,1,0,1,0,6200,6200,0,2177,2024.07.25
198,The End,Endless Highway,1,1,0,1,0,6200,6200,0,1123,2024.07.25
198,Come To The Well,Inspirations,1,1,0,1,0,6200,6200,0,9557,2024.07.25
198,A Good Day Coming On,Kingdom Heirs,1,1,0,1,0,6200,6200,0,0,2024.07.25
198,We Shall Rise,Inspirations,1,1,0,1,0,6200,6200,0,3680,2024.07.25
198,Tell The Grave,Perrys,1,1,0,1,0,6200,6200,0,2013,2024.07.25
205,A Hundred Different Altars,Steeles,1,0,1,1,0,6200,0,6200,1276,2024.07.25
205,Back To The Garden,Erwins,1,0,1,1,0,6200,0,6200,0,2024.07.25
205,He Bought Me,Old Paths,1,0,1,1,0,6200,0,6200,2654,2024.07.25
205,Ready To Leave,Down East Boys,1,0,1,1,0,6200,0,6200,861,2024.07.25
209,"I, John",Blackwood Brothers Quartet,1,-1,2,1,0,6200,-5600,11800,93,2024.07.25
209,My God,Scotty Inman,1,-1,2,1,0,6200,-5600,11800,48615,2024.07.25
209,In God's Time,Jordan Family Band,1,-1,2,1,0,6200,-5600,11800,3474,2024.07.25
209,We Are The Church,Ernie Haase & Signature Sound,1,-1,2,1,0,6200,-5600,11800,21408,2024.07.25
209,He Pilots My Ship,Tribute Quartet,1,-1,2,1,0,6200,-5600,11800,6917,2024.07.25
1,A Bar Song (Tipsy),Shaboozey,8777,328,8449,144,0,32598900,1195500,31403400,36447441,2024.08.01
2,I Had Some Help,Post Malone,7559,-288,7847,145,0,30835600,-272200,31107800,32203110,2024.08.01
3,Cowgirls,Morgan Wallen,7343,-886,8229,145,0,28876200,-2481500,31357700,15143224,2024.08.01
4,Bulletproof,Nate Smith,6872,120,6752,145,0,23974400,784800,23189600,6040583,2024.08.01
5,She's Somebody's Daughter,Drew Baldridge,6796,247,6549,145,0,23199200,653100,22546100,593095,2024.08.01
6,Dirt Cheap,Cody Johnson,6404,82,6322,145,0,22154300,262000,21892300,6122376,2024.08.01
7,Chevrolet,Dustin Lynch Feat. Jelly Roll,6031,509,5522,145,0,21695200,2681100,19014100,3329919,2024.08.01
8,Ain't No Love In Oklahoma (From Twisters: The Album),Luke Combs,6099,449,5650,145,0,21051600,1256500,19795100,15994835,2024.08.01
9,Young Love & Saturday Nights,Chris Young,6087,262,5825,145,0,20330300,1196400,19133900,839460,2024.08.01
10,Love You Again,Chase Matthew,4866,190,4676,145,0,16266300,517600,15748700,2074961,2024.08.01
11,"Love You, Miss You, Mean It",Luke Bryan,4498,481,4017,145,0,15632200,1383100,14249100,2516524,2024.08.01
12,This Is My Dirt,Justin Moore,4543,464,4079,145,0,14604900,1266600,13338300,744979,2024.08.01
13,Hang Tight Honey,Lainey Wilson,4242,131,4111,145,0,13886400,229400,13657000,4671727,2024.08.01
14,One Bad Habit,Tim McGraw,3915,62,3853,145,0,12741100,36800,12704300,537891,2024.08.01
15,Austin,Dasha,3754,173,3581,141,0,12246500,756000,11490500,11347654,2024.08.01
16,I Am Not Okay,Jelly Roll,3198,306,2892,145,0,10715100,728100,9987000,9833183,2024.08.01
17,Pour Me A Drink,Post Malone,2845,683,2162,144,0,10429600,2438200,7991400,10091037,2024.08.01
18,Messed Up As Me,Keith Urban,2952,80,2872,141,0,9371400,497600,8873800,1174103,2024.08.01
19,Miles On It,Marshmello & Kane Brown,2952,276,2676,144,0,9352800,548200,8804600,12547842,2024.08.01
20,Beautiful As You,Thomas Rhett,2805,135,2670,144,0,8922000,308900,8613100,4572893,2024.08.01
21,Gonna Love You,Parmalee,2954,170,2784,145,0,8685400,784300,7901100,304423,2024.08.01
22,Lies Lies Lies,Morgan Wallen,1967,362,1605,138,0,7411100,893600,6517500,19470739,2024.08.01
23,Bigger Houses,Dan + Shay,2526,-32,2558,141,0,7283400,139700,7143700,1264664,2024.08.01
24,Sounds Like The Radio,Zach Top,2164,8,2156,142,0,6659100,523700,6135400,1308749,2024.08.01
25,Damn Good Day To Leave,Riley Green,2135,106,2029,144,0,5848300,341900,5506400,1392574,2024.08.01
26,American Girl,Dierks Bentley,1719,11,1708,141,0,5060300,-41400,5101700,196248,2024.08.01
27,Think I’m In Love With You,Chris Stapleton,1663,74,1589,136,0,5003900,227100,4776800,5963760,2024.08.01
28,Cowboy Songs,George Birge,1909,29,1880,137,0,4870500,40900,4829600,567154,2024.08.01
29,Wind Up Missin' You,Tucker Wetmore,1345,-17,1362,131,0,4444100,94800,4349300,6231224,2024.08.01
30,Boys Back Home,Dylan Marlowe Feat. Dylan Scott,1470,-158,1628,137,0,3642700,-489400,4132100,2508764,2024.08.01
31,Breakin' In Boots,Matt Stell,1596,54,1542,137,0,3387500,81000,3306500,506078,2024.08.01
32,Called Crazy,Kassi Ashton,804,-11,815,48,0,2974400,-21100,2995500,439818,2024.08.01
33,This Town's Been Too Good To Us,Dylan Scott,1173,72,1101,126,0,2694100,118600,2575500,2206538,2024.08.01
34,Whatcha See Is Whatcha Get,Chris Janson,1250,38,1212,135,0,2687600,163900,2523700,139835,2024.08.01
35,Guy For That,Post Malone,744,-601,1345,102,0,2665000,-2940300,5605300,15242566,2024.08.01
36,Find Another Bar,Chris Lane,1259,-138,1397,134,0,2608900,-329300,2938200,74197,2024.08.01
37,Wranglers,Miranda Lambert,1146,92,1054,134,0,2361800,79000,2282800,1648615,2024.08.01
38,Friends Like That,John Morgan Feat. Jason Aldean,992,6,986,90,0,2349000,-159100,2508100,702557,2024.08.01
39,I Tried A Ring On,Tigirlily Gold,1208,-14,1222,137,0,2199000,36600,2162400,1985491,2024.08.01
40,Forever To Me,Cole Swindell,876,-15,891,83,0,2190300,-228300,2418600,1157184,2024.08.01
41,Tie Up,Zac Brown Band,1134,-53,1187,124,0,2132700,62900,2069800,606438,2024.08.01
42,Life With You,Kelsey Hart,1125,231,894,97,0,2094600,502500,1592100,1790810,2024.08.01
43,Drinkin' Buddies,"Lee Brice, Hailey Whitters, And Nate Smith",695,8,687,92,0,2026400,53800,1972600,372333,2024.08.01
44,Coming Home,Old Dominion,719,46,673,82,0,1960500,24500,1936000,2347186,2024.08.01
45,SIX FEET UNDER (Caleigh's Song),Hardy,733,-27,760,93,0,1940400,-388300,2328700,1336727,2024.08.01
46,I Ain'T Sayin',Jordan Davis,460,-352,812,79,0,1863600,-515600,2379200,2624902,2024.08.01
47,Just To Say We Did,Kenny Chesney,724,87,637,73,0,1854500,254500,1600000,480306,2024.08.01
48,High Road,Koe Wetzel,557,174,383,47,0,1789200,669600,1119600,13224948,2024.08.01
49,Fall Of Summer,Scotty McCreery,766,9,757,93,0,1640800,88000,1552800,483560,2024.08.01
50,Holy Smokes,Bailey Zimmerman,516,18,498,44,0,1529900,168700,1361200,4430533,2024.08.01
51,Cowboys Cry Too,Kelsea Ballerini,713,10,703,103,0,1510800,19400,1491400,4251606,2024.08.01
52,Hometown Home,Locash,782,45,737,86,0,1336500,41100,1295400,109167,2024.08.01
53,Whiskey Drink,Jason Aldean,528,415,113,60,0,1268200,1072500,195700,724158,2024.08.01
54,Country Back,Randy Houser,702,-53,755,79,0,1128500,-95100,1223600,44621,2024.08.01
55,Truck On Fire,Carly Pearce,379,294,85,64,0,1054000,829700,224300,865417,2024.08.01
56,You Look Like You Love Me,Ella Langley & Riley Green,278,65,213,22,0,974500,147400,827100,8912316,2024.08.01
57,Single Again,Josh Ross,676,81,595,85,0,909300,95000,814300,2324140,2024.08.01
58,Devil You Know,Tyler Braden,442,-2,444,47,0,869600,-114100,983700,4648079,2024.08.01
59,Everything I Need,Chayce Beckham,452,-6,458,62,0,800200,22300,777900,263821,2024.08.01
60,Bones,Russell Dickerson,449,86,363,77,0,737400,96900,640500,983468,2024.08.01
61,This Heart,Corey Kent,497,3,494,59,0,719200,-90700,809900,1290044,2024.08.01
62,Park,Tyler Hubbard,310,21,289,55,0,657900,-22900,680800,1317457,2024.08.01
63,Country House,Sam Hunt,388,-28,416,61,0,644300,-114900,759200,399552,2024.08.01
64,The Devil I Know,Ashley McBryde,383,-16,399,46,0,627400,-59900,687300,511411,2024.08.01
65,Strangers,Kameron Marlowe & Ella Langley,412,-65,477,46,0,543000,-111500,654500,2134139,2024.08.01
66,Over When We'Re Sober,Brantley Gilbert,377,88,289,67,0,510300,70700,439600,608139,2024.08.01
67,Break Mine,Brothers Osborne,282,-12,294,43,0,485000,-74100,559100,228623,2024.08.01
68,Love The Leavin',Drew Parker,224,86,138,22,0,440500,341800,98700,141166,2024.08.01
69,Never Been Over,Darius Rucker,307,-4,311,50,0,435900,-17600,453500,201053,2024.08.01
70,Pink Skies,Zach Bryan,151,-17,168,7,0,400300,-143500,543800,18765903,2024.08.01
71,Things I Take For Granted,Larry Fleet,267,-16,283,41,0,380400,-49200,429600,599640,2024.08.01
72,Bury Me In This Bar,Dalton Dover,291,55,236,42,0,361600,29400,332200,20673,2024.08.01
73,Espresso,Sabrina Carpenter,80,80,0,40,0,344800,344800,0,21957286,2024.08.01
74,Worst Way,Riley Green,31,8,23,1,0,311300,145700,165600,4631728,2024.08.01
75,Beatles And Eagles,Frontmen,213,-5,218,31,0,286600,37500,249100,978,2024.08.01
76,I Could Be That Rain,Randall King,148,-1,149,20,0,283200,-67300,350500,165150,2024.08.01
77,What She's Like,Emma Klein,57,10,47,56,0,278100,201900,76200,1530,2024.08.01
78,Good On You,Priscilla Block,203,-5,208,33,0,276300,-23600,299900,715805,2024.08.01
79,Pray All The Way Home,Austin Snell,154,11,143,24,0,275500,17800,257700,642363,2024.08.01
80,Uh-huh (Ajá),Frank Ray,274,-14,288,38,0,272300,-6700,279000,7719,2024.08.01
81,Acres,Brian Kelley,241,-17,258,62,0,260000,65300,194700,134320,2024.08.01
82,Songs About Whiskey,Anne Wilson,110,30,80,18,0,245300,93200,152100,186860,2024.08.01
83,Roulette On The Heart,Conner Smith,201,-163,364,44,0,236900,-259800,496700,500653,2024.08.01
84,Wine Into Whiskey,Tucker Wetmore,41,-6,47,2,0,228100,-51400,279500,5747565,2024.08.01
85,Baby Daddy's Weekend,Elle King,207,-15,222,36,0,226200,-42000,268200,46974,2024.08.01
86,Relapse,Warren Zeiders,126,89,37,28,0,181200,145800,35400,3562061,2024.08.01
87,Not Today,Mitchell Tenpenny,193,25,168,37,0,171300,-42400,213700,241017,2024.08.01
88,Dance Like No One’s Watching,Gabby Barrett,166,-63,229,26,0,154800,-54100,208900,470391,2024.08.01
89,Am I Okay?,Megan Moroney,24,18,6,1,0,150600,112800,37800,4870267,2024.08.01
90,How Is She,Cole Swindell,17,2,15,1,0,119600,300,119300,42093,2024.08.01
91,Wondering Why,Red Clay Strays,38,10,28,5,0,117300,27200,90100,4665745,2024.08.01
92,Little Miss Runner Up,Gretchen Wilson,17,17,0,17,0,111700,111700,0,8847,2024.08.01
93,Neon Baby,Annie Bosko,82,-326,408,24,0,100700,-528600,629300,16309,2024.08.01
94,American Nights,Zach Bryan,39,3,36,1,0,87800,-2000,89800,7330113,2024.08.01
95,Running Out Of Time,Wyatt Flores,15,-1,16,2,0,85300,11500,73800,580016,2024.08.01
96,King Of Country Music,Ryan Larkins,66,-48,114,12,0,81800,-42200,124000,10922,2024.08.01
97,First Rodeo,Sarahbeth Taite,47,47,0,47,0,76200,76200,0,4187,2024.08.01
97,Blue Bird,Carter Faith,47,47,0,47,0,76200,76200,0,0,2024.08.01
99,Milwaukee,Wyatt Flores,16,16,0,15,0,72100,72100,0,838344,2024.08.01
100,Man On The Moon,Megan Moroney,15,14,1,1,0,71900,70000,1900,1474152,2024.08.01
101,Three Drinks Behind,George Strait,9,-29,38,3,0,64900,-182900,247800,758446,2024.08.01
102,100%,Styles Haury,14,-167,181,11,0,63500,-659700,723200,9205,2024.08.01
103,I Got A Problem,Drake Milligan,23,4,19,3,0,63100,34500,28600,50262,2024.08.01
104,Spin You Around (1/24),Morgan Wallen,23,-4,27,4,0,59400,-17000,76400,5741149,2024.08.01
105,Lonely Road,mgk & Jelly Roll,10,10,0,5,0,58200,58200,0,10541647,2024.08.01
106,The Star-Spangled Banner,Chris Stapleton,12,-2,14,10,0,58100,5600,52500,87362,2024.08.01
107,Roots,Austin Burke,14,-24,38,1,0,50900,-94400,145300,8684,2024.08.01
108,Church Bells And Train Whistles,Brad Tursi,20,8,12,1,0,50200,19700,30500,38108,2024.08.01
109,Start Nowhere,Sam Hunt,9,9,0,9,0,49800,49800,0,118664,2024.08.01
110,Death Row,Thomas Rhett Feat. Tyler Hubbard & Russell Dickerson,9,9,0,9,0,48200,48200,0,40249,2024.08.01
110,Locked Up,Sam Hunt,9,9,0,9,0,48200,48200,0,559939,2024.08.01
112,Oklahoma Sooner,Jake Banfield,12,0,12,1,0,47000,1400,45600,3280,2024.08.01
113,Ain't That Some,Morgan Wallen,6,3,3,3,0,43500,15300,28200,4688154,2024.08.01
114,New To Country,Bailey Zimmerman,12,-1,13,1,0,40900,-9200,50100,3243738,2024.08.01
115,'98 Braves,Morgan Wallen,5,1,4,4,0,40300,-3100,43400,1758078,2024.08.01
116,Open The Gate,Zach Bryan,2,1,1,1,0,39800,19900,19900,1647020,2024.08.01
117,Quittin' Time,Zach Bryan,3,2,1,1,0,39700,19800,19900,1155251,2024.08.01
118,Heavens To Betsy,Jackson Dean,5,5,0,2,0,38700,38700,0,81268,2024.08.01
119,Dive,Luke Combs,3,1,2,1,0,37800,-2000,39800,1238934,2024.08.01
120,Man Upstairs,Tim Dugger,9,-1,10,1,0,36300,-7500,43800,6304,2024.08.01
121,Broadway Girls,Lil Durk Feat. Morgan Wallen,12,1,11,2,0,35900,-5900,41800,5886239,2024.08.01
122,John Deere Green,"HIXTAPE Feat. HARDY, Morgan Wallen, Joe Diffie",3,-7,10,2,0,29600,-43600,73200,0,2024.08.01
123,Use Me,Zach Top,3,3,0,3,0,26600,26600,0,601172,2024.08.01
124,When My Baby's In Boots,Randall King,2,1,1,1,0,25500,11900,13600,0,2024.08.01
125,Heartfirst,Kelsea Ballerini,6,6,0,5,0,24900,24900,0,293426,2024.08.01
126,You In A Honky Tonk,Randall King,3,-1,4,3,0,24700,-4300,29000,317490,2024.08.01
127,F150-50,Morgan Wallen,3,1,2,1,0,24200,4500,19700,696645,2024.08.01
128,Seven In Tennessee,12/Oc,12,12,0,1,0,24000,24000,0,4361,2024.08.01
129,Devil Don't Know,Morgan Wallen,3,1,2,2,0,23900,4200,19700,662529,2024.08.01
130,Sunrise Tells The Story,Midland,2,2,0,1,0,23600,23600,0,140952,2024.08.01
131,A Little Bit Closer,Braxton Keith,2,0,2,1,0,21700,-3800,25500,211229,2024.08.01
132,Country Music Made Me Do It,Carly Pearce,4,4,0,4,0,21000,21000,0,25455,2024.08.01
133,You'll Always Be My Baby (Written For Daughters' Weddings),Alan Jackson,7,2,5,1,0,20800,8100,12700,45314,2024.08.01
134,Record High,Randall King,2,2,0,2,0,19900,19900,0,21626,2024.08.01
135,Work Boots,Cody Johnson,1,-1,2,1,0,19900,-11700,31600,229578,2024.08.01
136,That's Texas,Cody Johnson,2,-1,3,1,0,19800,-1400,21200,221374,2024.08.01
137,Good Girl Gone Missin',Morgan Wallen,2,1,1,1,0,19700,15200,4500,1155718,2024.08.01
138,Me + All Your Reasons,Morgan Wallen,2,0,2,1,0,19700,0,19700,1051249,2024.08.01
138,Whiskey Friends,Morgan Wallen,2,0,2,1,0,19700,0,19700,1265109,2024.08.01
138,Tennessee Fan,Morgan Wallen,2,0,2,1,0,19700,0,19700,1047064,2024.08.01
138,Sunrise,Morgan Wallen,2,0,2,1,0,19700,0,19700,2987834,2024.08.01
142,I Wrote The Book,Morgan Wallen,2,-1,3,1,0,19700,-5300,25000,3194338,2024.08.01
143,Keith Whitley,Morgan Wallen,2,-14,16,1,0,19700,-35000,54700,564569,2024.08.01
144,Here And Her,Travis Denning,4,4,0,4,0,19400,19400,0,5273,2024.08.01
145,He Pilots My Ship,Tribute Quartet,3,2,1,3,0,19300,13100,6200,5565,2024.08.01
146,Help Is On The Way,Gold City,3,1,2,3,0,19300,7500,11800,17396,2024.08.01
147,Over Being Under You,Laura Bryna,22,8,14,5,0,19200,6000,13200,1284,2024.08.01
148,Hey Driver,Zach Bryan Feat. The War and Treaty,8,1,7,2,0,18400,2800,15600,5374615,2024.08.01
149,Out Of Oklahoma,Lainey Wilson,4,-38,42,3,0,16800,-242700,259500,3585762,2024.08.01
150,Don't Think Jesus,Morgan Wallen,3,1,2,3,0,16500,-3200,19700,815988,2024.08.01
151,Heart Of A Small Town,Tim Dugger,3,1,2,1,0,15900,-1500,17400,19099,2024.08.01
152,Hole In The Heart,Nelons,2,1,1,2,0,15500,9900,5600,0,2024.08.01
153,Dying Man,Morgan Wallen,1,0,1,1,0,15200,0,15200,1117051,2024.08.01
154,Born With A Beer In My Hand,Morgan Wallen,1,-1,2,1,0,15200,6200,9000,714028,2024.08.01
155,Sweet Dreams,Koe Wetzel,10,-7,17,2,0,15200,5500,9700,6300143,2024.08.01
156,Change The Game,Cody Jinks,8,2,6,4,0,14600,-5200,19800,84325,2024.08.01
157,Any Given Friday Night,Luke Combs,2,0,2,1,0,14600,0,14600,179027,2024.08.01
158,Come On In,Kingdom Heirs,2,2,0,2,0,13700,13700,0,7976,2024.08.01
159,Fall Into Place,Jeff & Sheri Easter,2,2,0,2,0,13100,13100,0,2961,2024.08.01
160,Middle Of Nowhere,Southbound,2,1,1,2,0,13100,7500,5600,5279,2024.08.01
161,Whatever Gets You Through It,Morgan Gruber,10,1,9,1,0,12400,3100,9300,206,2024.08.01
162,Wings Of A Dove,Jonathan Wilburn,2,0,2,1,0,12400,600,11800,0,2024.08.01
163,From Austin,Zach Bryan,5,4,1,2,0,11900,11900,0,2671283,2024.08.01
164,"I, John",Blackwood Brothers Quartet,2,1,1,2,0,11800,5600,6200,47,2024.08.01
165,Your Healing Is On The Way,Greater Vision,2,0,2,2,0,11800,0,11800,4670,2024.08.01
166,Am I The Only One,Aaron Lewis,3,-1,4,1,0,11600,-5400,17000,601181,2024.08.01
167,Star Spangled Banner,Mickey Guyton,2,-1,3,2,0,11000,-9800,20800,0,2024.08.01
168,Mint Tea,Johnny Blue Skies,11,4,7,1,0,10900,1600,9300,0,2024.08.01
169,Two Night Stands,Kylie Morgan,20,-4,24,3,0,10900,-7100,18000,43805,2024.08.01
170,Alimony,Miranda Lambert,2,2,0,2,0,10600,10600,0,652763,2024.08.01
171,Oklahoma Smokeshow,Zach Bryan,4,0,4,2,0,10500,-18900,29400,7320069,2024.08.01
172,"Salt, Lime & Tequila",Ryan Griffin,3,1,2,1,0,10300,2300,8000,73281,2024.08.01
173,Song While You'Re Away,Tyler Childers,8,4,4,1,0,10200,5000,5200,1404191,2024.08.01
174,Good Morning Mercy,Jason Crabb,1,1,0,1,0,9900,9900,0,108801,2024.08.01
174,He's Got A Way,Southbound,1,1,0,1,0,9900,9900,0,1499,2024.08.01
176,Paying For It,Levi Hummon,11,1,10,1,0,9900,900,9000,76961,2024.08.01
177,Heaven By Noon,Megan Moroney,1,-1,2,1,0,9700,-4500,14200,808901,2024.08.01
178,Days That End In Why,Morgan Wallen,6,-4,10,2,0,9700,-26400,36100,701942,2024.08.01
179,Decoration,Jillian Riscoe,5,2,3,1,0,9300,300,9000,11,2024.08.01
180,Certified,Laura Bryna,16,1,15,1,0,8700,0,8700,7900,2024.08.01
181,Back 40 Back,Luke Combs,3,-1,4,1,0,8400,-2800,11200,191527,2024.08.01
182,"Burn, Burn, Burn",Zach Bryan,2,2,0,1,0,8300,8300,0,5186536,2024.08.01
183,Where That Came From,Randy Travis,2,0,2,2,0,8000,-8600,16600,593688,2024.08.01
184,My Bar,Priscilla Block,2,1,1,1,0,7700,3200,4500,116827,2024.08.01
185,Checking In,For King & Country & Lee Brice,1,1,0,1,0,7500,7500,0,84331,2024.08.01
185,Sunday Sermons,Anne Wilson,1,1,0,1,0,7500,7500,0,471299,2024.08.01
185,Wasted Words,Craguns,1,1,0,1,0,7500,7500,0,536,2024.08.01
185,Scars In Heaven,Casting Crowns,1,1,0,1,0,7500,7500,0,386160,2024.08.01
189,Forgiven,Joseph Habedank,1,0,1,1,0,7500,1900,5600,7368,2024.08.01
190,Give Me A Sunrise,Braxton Keith,2,1,1,1,0,7400,1800,5600,112777,2024.08.01
191,Free Like,Maddie & Tae,1,1,0,1,0,7300,7300,0,323789,2024.08.01
191,Hit The Hay Runnin',Aaron Watson,1,1,0,1,0,7300,7300,0,0,2024.08.01
193,Hungover Again,Casey Donahew,2,1,1,2,0,7300,5500,1800,0,2024.08.01
193,My Kind Of Weathered,Kin Faux,2,1,1,2,0,7300,5500,1800,1143,2024.08.01
193,Drunk Since Dallas,Grant Gilbert,2,1,1,2,0,7300,5500,1800,8305,2024.08.01
196,Rain In The Rearview,Anne Wilson,1,0,1,1,0,7300,3500,3800,378751,2024.08.01
197,Steal My Thunder,Conner Smith,1,0,1,1,0,7300,2500,4800,2065564,2024.08.01
198,Streetlights,Frank Ray,1,1,0,1,0,6300,6300,0,1513,2024.08.01
199,Build A Bridge,Ashley Cooke,5,1,4,1,0,6300,3400,2900,5805,2024.08.01
200,Hell Or High Water,Bailey Zimmerman,1,-12,13,1,0,6300,-77500,83800,2940091,2024.08.01
1,A Bar Song (Tipsy),Shaboozey,8027,-750,8777,144,0,31154200,-1444700,32598900,34459050,2024.08.08
2,I Had Some Help,Post Malone,7409,-150,7559,145,0,30809700,-25900,30835600,29277877,2024.08.08
3,Bulletproof,Nate Smith,7802,930,6872,145,0,27312200,3337800,23974400,5961865,2024.08.08
4,Cowgirls,Morgan Wallen,6697,-646,7343,145,0,26899900,-1976300,28876200,15026909,2024.08.08
5,She's Somebody's Daughter,Drew Baldridge,6956,160,6796,145,0,24052800,853600,23199200,585978,2024.08.08
6,Dirt Cheap,Cody Johnson,6588,184,6404,145,0,22599400,445100,22154300,6002601,2024.08.08
7,Chevrolet,Dustin Lynch Feat. Jelly Roll,6386,355,6031,145,0,22117700,422500,21695200,3263096,2024.08.08
8,Ain't No Love In Oklahoma (From Twisters: The Album),Luke Combs,6322,223,6099,145,0,21756400,704800,21051600,15083698,2024.08.08
9,Young Love & Saturday Nights,Chris Young,6137,50,6087,145,0,20971200,640900,20330300,685584,2024.08.08
10,"Love You, Miss You, Mean It",Luke Bryan,4742,244,4498,145,0,16504000,871800,15632200,2380101,2024.08.08
11,Love You Again,Chase Matthew,4943,77,4866,144,0,16248600,-17700,16266300,2088567,2024.08.08
12,This Is My Dirt,Justin Moore,4698,155,4543,145,0,15419100,814200,14604900,713302,2024.08.08
13,Hang Tight Honey,Lainey Wilson,4286,44,4242,145,0,13623800,-262600,13886400,4947938,2024.08.08
14,Pour Me A Drink,Post Malone,3515,670,2845,145,0,13086400,2656800,10429600,10196501,2024.08.08
15,Austin,Dasha,3945,191,3754,141,0,12894100,647600,12246500,10875509,2024.08.08
16,One Bad Habit,Tim McGraw,3849,-66,3915,145,0,12658200,-82900,12741100,493981,2024.08.08
17,I Am Not Okay,Jelly Roll,3388,190,3198,145,0,11710500,995400,10715100,9078165,2024.08.08
18,Messed Up As Me,Keith Urban,3119,167,2952,143,0,9526300,154900,9371400,1102767,2024.08.08
19,Miles On It,Marshmello & Kane Brown,2970,18,2952,144,0,9186400,-166400,9352800,11787352,2024.08.08
20,Beautiful As You,Thomas Rhett,2932,127,2805,145,0,9124600,202600,8922000,4912107,2024.08.08
21,Gonna Love You,Parmalee,3002,48,2954,145,0,9016800,331400,8685400,302365,2024.08.08
22,Lies Lies Lies,Morgan Wallen,2371,404,1967,144,0,8763400,1352300,7411100,17835478,2024.08.08
23,Bigger Houses,Dan + Shay,2557,31,2526,143,0,7417900,134500,7283400,1303943,2024.08.08
24,Sounds Like The Radio,Zach Top,2232,68,2164,140,0,6975200,316100,6659100,1308961,2024.08.08
25,Damn Good Day To Leave,Riley Green,2140,5,2135,144,0,5819800,-28500,5848300,1452016,2024.08.08
26,American Girl,Dierks Bentley,1855,136,1719,142,0,5782800,722500,5060300,195489,2024.08.08
27,Think I’m In Love With You,Chris Stapleton,1823,160,1663,137,0,5705300,701400,5003900,5782777,2024.08.08
28,Cowboy Songs,George Birge,1843,-66,1909,138,0,4727300,-143200,4870500,628640,2024.08.08
29,Wind Up Missin' You,Tucker Wetmore,1319,-26,1345,131,0,4362200,-81900,4444100,5927208,2024.08.08
30,Breakin' In Boots,Matt Stell,1745,149,1596,138,0,3573500,186000,3387500,469347,2024.08.08
31,Boys Back Home,Dylan Marlowe Feat. Dylan Scott,1321,-149,1470,133,0,3180000,-462700,3642700,2659213,2024.08.08
32,Called Crazy,Kassi Ashton,829,25,804,50,0,2970800,-3600,2974400,487344,2024.08.08
33,Find Another Bar,Chris Lane,1261,2,1259,133,0,2672200,63300,2608900,76673,2024.08.08
34,Whatcha See Is Whatcha Get,Chris Janson,1245,-5,1250,135,0,2622400,-65200,2687600,135122,2024.08.08
35,This Town's Been Too Good To Us,Dylan Scott,1181,8,1173,128,0,2498600,-195500,2694100,2145321,2024.08.08
36,Guy For That,Post Malone,800,56,744,98,0,2489800,-175200,2665000,11103754,2024.08.08
37,Friends Like That,John Morgan Feat. Jason Aldean,1043,51,992,95,0,2442600,93600,2349000,878067,2024.08.08
38,Life With You,Kelsey Hart,1179,54,1125,100,0,2439700,345100,2094600,1841426,2024.08.08
39,High Road,Koe Wetzel,708,151,557,52,0,2340400,551200,1789200,12439322,2024.08.08
40,Wranglers,Miranda Lambert,1092,-54,1146,132,0,2310200,-51600,2361800,1517604,2024.08.08
41,You Look Like You Love Me,Ella Langley & Riley Green,527,249,278,43,0,2099400,1124900,974500,9170176,2024.08.08
42,Tie Up,Zac Brown Band,1143,9,1134,124,0,2082800,-49900,2132700,638175,2024.08.08
43,Forever To Me,Cole Swindell,837,-39,876,85,0,2056700,-133600,2190300,1171375,2024.08.08
44,Just To Say We Did,Kenny Chesney,831,107,724,77,0,2049300,194800,1854500,461338,2024.08.08
45,Whiskey Drink,Jason Aldean,828,300,528,63,0,2038600,770400,1268200,1009960,2024.08.08
46,Drinkin' Buddies,"Lee Brice, Hailey Whitters, And Nate Smith",702,7,695,91,0,1929500,-96900,2026400,415949,2024.08.08
47,I Tried A Ring On,Tigirlily Gold,1192,-16,1208,136,0,1906900,-292100,2199000,1624596,2024.08.08
48,Coming Home,Old Dominion,744,25,719,85,0,1893600,-66900,1960500,2541210,2024.08.08
49,Cowboys Cry Too,Kelsea Ballerini,823,110,713,115,0,1806300,295500,1510800,3743107,2024.08.08
50,Fall Of Summer,Scotty McCreery,793,27,766,95,0,1777700,136900,1640800,429310,2024.08.08
51,Holy Smokes,Bailey Zimmerman,550,34,516,45,0,1720600,190700,1529900,4588939,2024.08.08
52,I Ain'T Sayin',Jordan Davis,654,194,460,91,0,1603900,-259700,1863600,2376232,2024.08.08
53,SIX FEET UNDER (Caleigh's Song),Hardy,657,-76,733,89,0,1483700,-456700,1940400,1178304,2024.08.08
54,Hometown Home,Locash,758,-24,782,86,0,1327200,-9300,1336500,110946,2024.08.08
55,Country Back,Randy Houser,726,24,702,80,0,1192600,64100,1128500,40043,2024.08.08
56,Truck On Fire,Carly Pearce,556,177,379,82,0,1186200,132200,1054000,879815,2024.08.08
57,Everything I Need,Chayce Beckham,483,31,452,60,0,895300,95100,800200,269258,2024.08.08
58,Single Again,Josh Ross,687,11,676,95,0,894000,-15300,909300,2412071,2024.08.08
59,This Heart,Corey Kent,528,31,497,57,0,794300,75100,719200,1317007,2024.08.08
60,Park,Tyler Hubbard,384,74,310,64,0,747500,89600,657900,1344849,2024.08.08
61,Devil You Know,Tyler Braden,390,-52,442,47,0,737400,-132200,869600,4874406,2024.08.08
62,Country House,Sam Hunt,395,7,388,65,0,716200,71900,644300,352408,2024.08.08
63,Bones,Russell Dickerson,431,-18,449,71,0,661500,-75900,737400,793989,2024.08.08
64,The Devil I Know,Ashley McBryde,386,3,383,45,0,637700,10300,627400,222258,2024.08.08
65,Over When We'Re Sober,Brantley Gilbert,402,25,377,66,0,603000,92700,510300,572060,2024.08.08
66,Love The Leavin',Drew Parker,243,19,224,21,0,596800,156300,440500,120482,2024.08.08
67,Strangers,Kameron Marlowe & Ella Langley,384,-28,412,45,0,476800,-66200,543000,2181689,2024.08.08
68,Never Been Over,Darius Rucker,333,26,307,51,0,474600,38700,435900,179874,2024.08.08
69,Wine Into Whiskey,Tucker Wetmore,73,32,41,2,0,473400,245300,228100,5508751,2024.08.08
70,Pink Skies,Zach Bryan,149,-2,151,9,0,412700,12400,400300,18783299,2024.08.08
71,Am I Okay?,Megan Moroney,58,34,24,7,0,397500,246900,150600,5813123,2024.08.08
72,Things I Take For Granted,Larry Fleet,244,-23,267,38,0,387200,6800,380400,651097,2024.08.08
73,I Could Be That Rain,Randall King,198,50,148,40,0,365600,82400,283200,157751,2024.08.08
74,Out Of Oklahoma,Lainey Wilson,67,63,4,12,0,306700,289900,16800,3542454,2024.08.08
75,Worst Way,Riley Green,31,0,31,2,0,294000,-17300,311300,4552112,2024.08.08
76,Good On You,Priscilla Block,190,-13,203,32,0,284700,8400,276300,367475,2024.08.08
77,Break Mine,Brothers Osborne,154,-128,282,32,0,274000,-211000,485000,407253,2024.08.08
78,Parallel Love,Brad Tursi,58,58,0,57,0,272300,272300,0,6494,2024.08.08
79,Pray All The Way Home,Austin Snell,142,-12,154,22,0,260500,-15000,275500,786869,2024.08.08
80,Bury Me In This Bar,Dalton Dover,222,-69,291,41,0,259800,-101800,361600,17492,2024.08.08
81,Beatles And Eagles,Frontmen,212,-1,213,30,0,253300,-33300,286600,1032,2024.08.08
82,Acres,Brian Kelley,267,26,241,51,0,249400,-10600,260000,139052,2024.08.08
83,Relapse,Warren Zeiders,202,76,126,29,0,233000,51800,181200,4183518,2024.08.08
84,Baby Daddy's Weekend,Elle King,212,5,207,35,0,199900,-26300,226200,42341,2024.08.08
85,Songs About Whiskey,Anne Wilson,118,8,110,19,0,179300,-66000,245300,188128,2024.08.08
86,Heavens To Betsy,Jackson Dean,34,29,5,12,0,149500,110800,38700,301459,2024.08.08
87,Not Today,Mitchell Tenpenny,178,-15,193,39,0,141900,-29400,171300,232485,2024.08.08
88,Wondering Why,Red Clay Strays,35,-3,38,3,0,121200,3900,117300,4329867,2024.08.08
89,Neon Baby,Annie Bosko,46,-36,82,6,0,114700,14000,100700,14182,2024.08.08
90,Dance Like No One’s Watching,Gabby Barrett,127,-39,166,25,0,109700,-45100,154800,567110,2024.08.08
91,How Is She,Cole Swindell,17,0,17,1,0,109500,-10100,119600,40514,2024.08.08
92,Spin You Around (1/24),Morgan Wallen,32,9,23,3,0,96500,37100,59400,5367584,2024.08.08
93,Broadway Girls,Lil Durk Feat. Morgan Wallen,23,11,12,2,0,94700,58800,35900,5944863,2024.08.08
94,I Got A Problem,Drake Milligan,44,21,23,4,0,91800,28700,63100,48345,2024.08.08
95,American Nights,Zach Bryan,37,-2,39,1,0,90100,2300,87800,6163314,2024.08.08
96,Uh-huh (Ajá),Frank Ray,101,-173,274,26,0,86200,-186100,272300,10294,2024.08.08
97,Sweet Dreams,Koe Wetzel,17,7,10,1,0,79900,64700,15200,5816303,2024.08.08
98,Bad Boy,Huntergirl,48,48,0,48,0,76700,76700,0,26036,2024.08.08
99,Free Like,Maddie & Tae,47,46,1,47,0,73800,66500,7300,217708,2024.08.08
100,King Of Country Music,Ryan Larkins,35,-31,66,7,0,67000,-14800,81800,9769,2024.08.08
101,The Star-Spangled Banner,Chris Stapleton,15,3,12,12,0,64500,6400,58100,92062,2024.08.08
102,Man Upstairs,Tim Dugger,11,2,9,1,0,63600,27300,36300,5261,2024.08.08
103,Don't Think Jesus,Morgan Wallen,19,16,3,13,0,60600,44100,16500,822296,2024.08.08
104,New To Country,Bailey Zimmerman,13,1,12,1,0,53900,13000,40900,3032384,2024.08.08
105,'98 Braves,Morgan Wallen,10,5,5,1,0,49600,9300,40300,1788120,2024.08.08
106,Roulette On The Heart,Conner Smith,59,-142,201,16,0,48900,-188000,236900,509728,2024.08.08
107,Born Lonely,Matt Stell,9,9,0,9,0,48200,48200,0,22052,2024.08.08
108,Running Out Of Time,Wyatt Flores,16,1,15,1,0,47200,-38100,85300,607482,2024.08.08
109,Ain't That Some,Morgan Wallen,11,5,6,2,0,45500,2000,43500,4703257,2024.08.08
110,Man On The Moon,Megan Moroney,9,-6,15,1,0,43700,-28200,71900,1470632,2024.08.08
111,Oklahoma Sooner,Jake Banfield,11,-1,12,1,0,42600,-4400,47000,2470,2024.08.08
112,Church Bells And Train Whistles,Brad Tursi,17,-3,20,1,0,42600,-7600,50200,23826,2024.08.08
113,Fiddle In The Band,Kane Brown,3,3,0,1,0,37200,37200,0,400254,2024.08.08
114,Young Man,Greylan James,17,7,10,3,0,36400,32700,3700,35191,2024.08.08
115,That's Texas,Cody Johnson,2,0,2,1,0,33500,13700,19800,224790,2024.08.08
116,Where That Came From,Randy Travis,8,6,2,2,0,33200,25200,8000,550092,2024.08.08
117,Hey Driver,Zach Bryan Feat. The War and Treaty,9,1,8,2,0,30300,11900,18400,5144581,2024.08.08
118,Days That End In Why,Morgan Wallen,9,3,6,2,0,30100,20400,9700,685950,2024.08.08
119,Good Horses,Lainey Wilson,10,10,0,3,0,29800,29800,0,2211902,2024.08.08
120,Seven In Tennessee,12/Oc,17,5,12,1,0,29500,5500,24000,3274,2024.08.08
121,Cozy,Braxton Keith,2,2,0,1,0,26200,26200,0,1106785,2024.08.08
122,Indifferent,Megan Moroney,7,7,0,1,0,25900,25900,0,3136706,2024.08.08
123,Grandpa (Tell Me 'Bout The Good Old Days),Cody Johnson,2,2,0,1,0,25500,25500,0,216,2024.08.08
124,Country Girls (Just Wanna Have Fun),Mackenzie Carpenter,10,10,0,10,0,23000,23000,0,27579,2024.08.08
125,Three Drinks Behind,George Strait,2,-7,9,1,0,22800,-42100,64900,455922,2024.08.08
126,Quittin' Time,Zach Bryan,2,-1,3,1,0,21700,-18000,39700,1239949,2024.08.08
127,Tennessee Fan,Morgan Wallen,6,4,2,1,0,21000,1300,19700,1119368,2024.08.08
128,Boots Need A Hat,Teddy Robb,24,24,0,12,0,20200,20200,0,39289,2024.08.08
129,Can Down,Mike Ryan,1,1,0,1,0,19900,19900,0,29687,2024.08.08
130,Work Boots,Cody Johnson,1,0,1,1,0,19900,0,19900,230198,2024.08.08
131,Dive,Luke Combs,1,-2,3,1,0,19900,-17900,37800,1196460,2024.08.08
132,Open The Gate,Zach Bryan,2,0,2,1,0,19800,-20000,39800,1777213,2024.08.08
133,You In A Honky Tonk,Randall King,2,-1,3,2,0,19800,-4900,24700,313941,2024.08.08
134,Golden Child,Meghan Patrick,3,3,0,3,0,19600,19600,0,0,2024.08.08
135,One Beer Away,Reklaws,4,4,0,4,0,19400,19400,0,24262,2024.08.08
136,Hole In The Heart,Nelons,3,1,2,2,0,18700,3200,15500,0,2024.08.08
137,Heart Of A Small Town,Tim Dugger,2,-1,3,1,0,17400,1500,15900,16594,2024.08.08
138,"Salt, Lime & Tequila",Ryan Griffin,4,1,3,1,0,17200,6900,10300,71361,2024.08.08
139,I Wrote The Book,Morgan Wallen,3,1,2,1,0,17200,-2500,19700,3116481,2024.08.08
140,Keith Whitley,Morgan Wallen,2,0,2,1,0,16400,-3300,19700,526725,2024.08.08
141,Over Being Under You,Laura Bryna,17,-5,22,5,0,16200,-3000,19200,266,2024.08.08
142,Forgiven,Joseph Habedank,2,1,1,2,0,15500,8000,7500,5823,2024.08.08
143,Any Given Friday Night,Luke Combs,2,0,2,1,0,14600,0,14600,176663,2024.08.08
144,Help Is On The Way,Gold City,2,-1,3,2,0,13700,-5600,19300,20303,2024.08.08
145,Here Comes Jesus,Jeff & Sheri Easter,2,2,0,2,0,13100,13100,0,18708,2024.08.08
146,Middle Of Nowhere,Southbound,2,0,2,2,0,13100,0,13100,4563,2024.08.08
147,Oklahoma Smokeshow,Zach Bryan,3,-1,4,2,0,12200,1700,10500,7335251,2024.08.08
148,Your Healing Is On The Way,Greater Vision,2,0,2,2,0,11800,0,11800,3910,2024.08.08
149,Wings Of A Dove,Jonathan Wilburn,2,0,2,2,0,11800,-600,12400,0,2024.08.08
150,Leave You Alone,Kane Brown,2,2,0,2,0,10300,10300,0,196293,2024.08.08
151,Come And See,Mylon Hayes Family,1,1,0,1,0,9900,9900,0,3874,2024.08.08
151,Red Letter Blueprint,Scotty McCreery,1,1,0,1,0,9900,9900,0,43064,2024.08.08
151,Adios Cowboy,Midland,1,1,0,1,0,9900,9900,0,71907,2024.08.08
154,Think About There,Greater Vision,1,0,1,1,0,9900,3700,6200,10027,2024.08.08
155,Wasted Words,Craguns,1,0,1,1,0,9900,2400,7500,561,2024.08.08
156,Whiskey Friends,Morgan Wallen,1,-1,2,1,0,9900,-9800,19700,1211525,2024.08.08
157,Song While You'Re Away,Tyler Childers,9,1,8,2,0,9700,-500,10200,994458,2024.08.08
158,Oklahoma Sun,Koe Wetzel,3,2,1,1,0,9100,7300,1800,122037,2024.08.08
159,Tattoo On A Sunburn,Luke Combs,1,1,0,1,0,9100,9100,0,200823,2024.08.08
160,Whatever Gets You Through It,Morgan Gruber,7,-3,10,1,0,8300,-4100,12400,184,2024.08.08
161,Paying For It,Levi Hummon,9,-2,11,1,0,8100,-1800,9900,75565,2024.08.08
162,Mint Tea,Johnny Blue Skies,12,1,11,1,0,7800,-3100,10900,0,2024.08.08
163,Means Something To Me,Tate Emmons,1,1,0,1,0,7500,7500,0,413,2024.08.08
163,Mansions,Sound Street,1,1,0,1,0,7500,7500,0,2021,2024.08.08
163,Make The Morning Worth The Midnight,Gaither Vocal Band,1,1,0,1,0,7500,7500,0,8403,2024.08.08
166,Red Words,Erwins,1,0,1,1,0,7500,1900,5600,7487,2024.08.08
167,Sunday Sermons,Anne Wilson,1,0,1,1,0,7500,0,7500,464121,2024.08.08
168,He's Got A Way,Southbound,1,0,1,1,0,7500,-2400,9900,1581,2024.08.08
169,Fall Into Place,Jeff & Sheri Easter,1,-1,2,1,0,7500,-5600,13100,3361,2024.08.08
170,You'll Always Be My Baby (Written For Daughters' Weddings),Alan Jackson,5,-2,7,1,0,7500,-13300,20800,50851,2024.08.08
171,Leave A Light On,Papa Roach,1,1,0,1,0,7300,7300,0,814475,2024.08.08
171,Total Control,Morgan Wade,1,1,0,1,0,7300,7300,0,343967,2024.08.08
171,What I Shoulda Done,Mae Estes,1,1,0,1,0,7300,7300,0,7792,2024.08.08
174,Change The Game,Cody Jinks,6,-2,8,2,0,7300,-7300,14600,86972,2024.08.08
175,5 Leaf Clover,Luke Combs,1,1,0,1,0,7100,7100,0,1333264,2024.08.08
176,Certified,Laura Bryna,14,-2,16,1,0,7100,-1600,8700,7303,2024.08.08
177,Star Spangled Banner,Mickey Guyton,2,0,2,2,0,7000,-4000,11000,0,2024.08.08
178,He Pilots My Ship,Tribute Quartet,2,-1,3,2,0,6600,-12700,19300,5157,2024.08.08
179,Cancel,Randy Houser,1,1,0,1,0,6300,6300,0,20545,2024.08.08
180,Still Telling My Story,Erwins,1,1,0,1,0,6200,6200,0,0,2024.08.08
180,Leavin' On My Mind,Kim Hopper,1,1,0,1,0,6200,6200,0,121,2024.08.08
180,Pray On,Kenna Turner West,1,1,0,1,0,6200,6200,0,37,2024.08.08
180,A Good Day Coming On,Kingdom Heirs,1,1,0,1,0,6200,6200,0,0,2024.08.08
180,There's Always A Place At The Table,Sunday Drive,1,1,0,1,0,6200,6200,0,395,2024.08.08
180,In God's Time,Jordan Family Band,1,1,0,1,0,6200,6200,0,3852,2024.08.08
180,Waiting For Me,Truesong,1,1,0,1,0,6200,6200,0,867,2024.08.08
180,The Tomb Is Empty Now,Browns,1,1,0,1,0,6200,6200,0,84,2024.08.08
180,All Things,Sound,1,1,0,1,0,6200,6200,0,1861,2024.08.08
180,A Hundred Different Altars,Steeles,1,1,0,1,0,6200,6200,0,1129,2024.08.08
190,We Are The Church,Ernie Haase & Signature Sound,1,0,1,1,0,6200,600,5600,24484,2024.08.08
191,I Think I'Ll Just Go On,Perrys,1,0,1,1,0,6200,0,6200,8187,2024.08.08
191,He Bought Me,Old Paths,1,0,1,1,0,6200,0,6200,2709,2024.08.08
191,"Liar, Liar",Brian Free & Assurance,1,0,1,1,0,6200,0,6200,1951,2024.08.08
191,My God,Scotty Inman,1,0,1,1,0,6200,0,6200,43520,2024.08.08
195,Lonely Road,mgk & Jelly Roll,3,-7,10,2,0,6200,-52000,58200,8138376,2024.08.08
196,Sun To Me,Zach Bryan,6,2,4,1,0,6000,2100,3900,7112933,2024.08.08
197,Fake Id,Sydney Mack,4,-1,5,1,0,5800,2300,3500,627,2024.08.08
198,Praying For The Prodigal,Kingsmen,1,1,0,1,0,5600,5600,0,2863,2024.08.08
198,Beautiful,Nelons,1,1,0,1,0,5600,5600,0,10395,2024.08.08
198,Blue Collar Gospel,Jerry Salley,1,1,0,1,0,5600,5600,0,0,2024.08.08
198,Brighten the Corner Where You Are,Browns,1,1,0,1,0,5600,5600,0,648,2024.08.08
198,Meet Me At The Cross,Brian Free & Assurance,1,1,0,1,0,5600,5600,0,5021,2024.08.08
198,Address Change Notification,Southbound,1,1,0,1,0,5600,5600,0,4355,2024.08.08
198,One Wide River To Cross,Mark Bishop,1,1,0,1,0,5600,5600,0,308,2024.08.08
198,Alone Like That,Parmalee,1,1,0,1,0,5600,5600,0,4634,2024.08.08
198,I'M Forgiven,Kingdom Heirs,1,1,0,1,0,5600,5600,0,3954,2024.08.08
207,The Original Superman,Tate Emmons,1,0,1,1,0,5600,5200,400,160,2024.08.08
207,Cross Over,Allens,1,0,1,1,0,5600,5200,400,531,2024.08.08
209,Made A Mess,Tim Menzies,1,0,1,1,0,5600,0,5600,2104,2024.08.08
209,Take Me To The Water,"Lauren, Amber & Kenna",1,0,1,1,0,5600,0,5600,2223,2024.08.08
209,"Jesus 1, Death 0",Truesong,1,0,1,1,0,5600,0,5600,0,2024.08.08
209,He Forgives And Forgets,Gordon Mote,1,0,1,1,0,5600,0,5600,2024,2024.08.08
209,Revival Broke Out,Gaither Vocal Band,1,0,1,1,0,5600,0,5600,3432,2024.08.08
209,Praise The Lord,Collingsworth Family,1,0,1,1,0,5600,0,5600,42723,2024.08.08
209,Be Ready,Karen Peck & New River,1,0,1,1,0,5600,0,5600,7946,2024.08.08
209,Man On The Middle Cross,Scotty Inman,1,0,1,1,0,5600,0,5600,0,2024.08.08
217,Build A Bridge,Ashley Cooke,5,0,5,1,0,5600,-700,6300,6256,2024.08.08
218,A Little Bit Closer,Braxton Keith,1,-1,2,1,0,5600,-16100,21700,217029,2024.08.08
1,A Bar Song (Tipsy),Shaboozey,7495,-532,8027,144,0,30477300,-676900,31154200,33748871,2024.08.15
2,I Had Some Help,Post Malone,7096,-313,7409,145,0,30087200,-722500,30809700,28065958,2024.08.15
3,Bulletproof,Nate Smith,7792,-10,7802,145,0,27723300,411100,27312200,5927605,2024.08.15
4,Cowgirls,Morgan Wallen,6557,-140,6697,145,0,26428500,-471400,26899900,14733021,2024.08.15
5,She's Somebody's Daughter,Drew Baldridge,7099,143,6956,145,0,24588300,535500,24052800,592248,2024.08.15
6,Chevrolet,Dustin Lynch Feat. Jelly Roll,6517,131,6386,145,0,22463200,345500,22117700,3405599,2024.08.15
7,Ain't No Love In Oklahoma (From Twisters: The Album),Luke Combs,6347,25,6322,145,0,22330700,574300,21756400,14678921,2024.08.15
8,Young Love & Saturday Nights,Chris Young,6347,210,6137,145,0,21682900,711700,20971200,677213,2024.08.15
9,Dirt Cheap,Cody Johnson,6293,-295,6588,145,0,21555400,-1044000,22599400,6097841,2024.08.15
10,"Love You, Miss You, Mean It",Luke Bryan,4825,83,4742,145,0,16921100,417100,16504000,2254199,2024.08.15
11,Love You Again,Chase Matthew,5063,120,4943,145,0,16695300,446700,16248600,2037319,2024.08.15
12,This Is My Dirt,Justin Moore,4719,21,4698,145,0,15899400,480300,15419100,674563,2024.08.15
13,Pour Me A Drink,Post Malone,3900,385,3515,145,0,14376500,1290100,13086400,9716343,2024.08.15
14,Hang Tight Honey,Lainey Wilson,4366,80,4286,145,0,13417800,-206000,13623800,4736693,2024.08.15
15,Austin,Dasha,4024,79,3945,142,0,13201600,307500,12894100,11066508,2024.08.15
16,One Bad Habit,Tim McGraw,3948,99,3849,145,0,12817100,158900,12658200,497209,2024.08.15
17,I Am Not Okay,Jelly Roll,3632,244,3388,145,0,11579500,-131000,11710500,10181916,2024.08.15
18,Miles On It,Marshmello & Kane Brown,3212,242,2970,144,0,10516100,1329700,9186400,11700831,2024.08.15
19,Gonna Love You,Parmalee,3112,110,3002,145,0,9357600,340800,9016800,312301,2024.08.15
20,Beautiful As You,Thomas Rhett,2954,22,2932,145,0,9341200,216600,9124600,4882543,2024.08.15
21,Lies Lies Lies,Morgan Wallen,2622,251,2371,144,0,9182000,418600,8763400,17353699,2024.08.15
22,Messed Up As Me,Keith Urban,3170,51,3119,142,0,9076500,-449800,9526300,1102339,2024.08.15
23,Sounds Like The Radio,Zach Top,2400,168,2232,142,0,7423100,447900,6975200,1440634,2024.08.15
24,Bigger Houses,Dan + Shay,2574,17,2557,142,0,7252300,-165600,7417900,1454643,2024.08.15
25,American Girl,Dierks Bentley,1870,15,1855,142,0,6038900,256100,5782800,211495,2024.08.15
26,Think I’m In Love With You,Chris Stapleton,1841,18,1823,140,0,5806100,100800,5705300,6185086,2024.08.15
27,Damn Good Day To Leave,Riley Green,2157,17,2140,144,0,5772900,-46900,5819800,1381061,2024.08.15
28,Cowboy Songs,George Birge,1910,67,1843,138,0,4861000,133700,4727300,643527,2024.08.15
29,Wind Up Missin' You,Tucker Wetmore,1459,140,1319,136,0,4551700,189500,4362200,5985853,2024.08.15
30,Boys Back Home,Dylan Marlowe Feat. Dylan Scott,1453,132,1321,136,0,3728200,548200,3180000,2461659,2024.08.15
31,Breakin' In Boots,Matt Stell,1553,-192,1745,136,0,3311700,-261800,3573500,410084,2024.08.15
32,High Road,Koe Wetzel,929,221,708,61,0,3096400,756000,2340400,10597258,2024.08.15
33,Called Crazy,Kassi Ashton,829,0,829,53,0,3014000,43200,2970800,448115,2024.08.15
34,Friends Like That,John Morgan Feat. Jason Aldean,1178,135,1043,103,0,2739800,297200,2442600,873418,2024.08.15
35,You Look Like You Love Me,Ella Langley & Riley Green,703,176,527,55,0,2723100,623700,2099400,8798651,2024.08.15
36,Find Another Bar,Chris Lane,1282,21,1261,134,0,2711700,39500,2672200,79706,2024.08.15
37,Whatcha See Is Whatcha Get,Chris Janson,1278,33,1245,136,0,2668700,46300,2622400,136661,2024.08.15
38,Life With You,Kelsey Hart,1180,1,1179,103,0,2501700,62000,2439700,1866511,2024.08.15
39,This Town's Been Too Good To Us,Dylan Scott,1141,-40,1181,130,0,2497900,-700,2498600,2332492,2024.08.15
40,Guy For That,Post Malone,788,-12,800,77,0,2372900,-116900,2489800,11293590,2024.08.15
41,Wranglers,Miranda Lambert,1136,44,1092,124,0,2339700,29500,2310200,1587227,2024.08.15
42,Forever To Me,Cole Swindell,920,83,837,100,0,2189300,132600,2056700,1135453,2024.08.15
43,Drinkin' Buddies,"Lee Brice, Hailey Whitters, And Nate Smith",735,33,702,94,0,2177400,247900,1929500,341049,2024.08.15
44,Whiskey Drink,Jason Aldean,815,-13,828,74,0,2018600,-20000,2038600,1061026,2024.08.15
45,Tie Up,Zac Brown Band,1094,-49,1143,124,0,1890100,-192700,2082800,775314,2024.08.15
46,Fall Of Summer,Scotty McCreery,857,64,793,99,0,1823200,45500,1777700,394417,2024.08.15
47,I Tried A Ring On,Tigirlily Gold,1098,-94,1192,136,0,1811500,-95400,1906900,1728440,2024.08.15
48,I Ain'T Sayin',Jordan Davis,764,110,654,92,0,1801200,197300,1603900,2446258,2024.08.15
49,Cowboys Cry Too,Kelsea Ballerini,838,15,823,117,0,1731500,-74800,1806300,3776688,2024.08.15
50,Coming Home,Old Dominion,708,-36,744,84,0,1726200,-167400,1893600,2371519,2024.08.15
51,Just To Say We Did,Kenny Chesney,776,-55,831,79,0,1699200,-350100,2049300,474933,2024.08.15
52,Holy Smokes,Bailey Zimmerman,612,62,550,55,0,1666400,-54200,1720600,5077800,2024.08.15
53,Hometown Home,Locash,772,14,758,89,0,1338400,11200,1327200,124226,2024.08.15
54,Country Back,Randy Houser,771,45,726,80,0,1259500,66900,1192600,40771,2024.08.15
55,SIX FEET UNDER (Caleigh's Song),Hardy,654,-3,657,93,0,1254200,-229500,1483700,1182373,2024.08.15
56,Truck On Fire,Carly Pearce,528,-28,556,76,0,1232300,46100,1186200,914964,2024.08.15
57,Everything I Need,Chayce Beckham,483,0,483,62,0,982000,86700,895300,242072,2024.08.15
58,Over When We'Re Sober,Brantley Gilbert,458,56,402,78,0,928200,325200,603000,784337,2024.08.15
59,Single Again,Josh Ross,712,25,687,97,0,910700,16700,894000,2482137,2024.08.15
60,Love The Leavin',Drew Parker,325,82,243,20,0,904300,307500,596800,124429,2024.08.15
61,Am I Okay?,Megan Moroney,151,93,58,25,0,867900,470400,397500,5192748,2024.08.15
62,Country House,Sam Hunt,508,113,395,74,0,844100,127900,716200,296837,2024.08.15
63,Bones,Russell Dickerson,504,73,431,75,0,774300,112800,661500,640242,2024.08.15
64,This Heart,Corey Kent,492,-36,528,56,0,744000,-50300,794300,912773,2024.08.15
65,Devil You Know,Tyler Braden,384,-6,390,50,0,736000,-1400,737400,4628295,2024.08.15
66,Park,Tyler Hubbard,367,-17,384,65,0,709200,-38300,747500,1314247,2024.08.15
67,The Devil I Know,Ashley McBryde,388,2,386,43,0,662800,25100,637700,201659,2024.08.15
68,Pink Skies,Zach Bryan,196,47,149,11,0,524600,111900,412700,18894038,2024.08.15
69,Strangers,Kameron Marlowe & Ella Langley,386,2,384,45,0,490400,13600,476800,1745401,2024.08.15
70,Never Been Over,Darius Rucker,321,-12,333,51,0,462400,-12200,474600,186846,2024.08.15
71,I Could Be That Rain,Randall King,202,4,198,31,0,442800,77200,365600,111945,2024.08.15
72,Out Of Oklahoma,Lainey Wilson,112,45,67,14,0,436700,130000,306700,3856176,2024.08.15
73,Wine Into Whiskey,Tucker Wetmore,66,-7,73,3,0,414500,-58900,473400,5324326,2024.08.15
74,Chasing Cars,Nate Smith,94,94,0,56,0,362300,362300,0,32330,2024.08.15
75,Glitter,Lexie Hayden,106,106,0,58,0,358900,358900,0,545,2024.08.15
76,Espresso,Sabrina Carpenter,80,80,0,40,0,344800,344800,0,20324925,2024.08.15
77,Things I Take For Granted,Larry Fleet,219,-25,244,33,0,344200,-43000,387200,614519,2024.08.15
78,Worst Way,Riley Green,31,0,31,2,0,321900,27900,294000,4587258,2024.08.15
79,Heavens To Betsy,Jackson Dean,172,138,34,35,0,317900,168400,149500,263603,2024.08.15
80,Pray All The Way Home,Austin Snell,149,7,142,22,0,307100,46600,260500,788658,2024.08.15
81,Bury Me In This Bar,Dalton Dover,245,23,222,42,0,276000,16200,259800,17998,2024.08.15
82,Relapse,Warren Zeiders,207,5,202,30,0,263200,30200,233000,4417066,2024.08.15
83,Acres,Brian Kelley,284,17,267,50,0,251900,2500,249400,141207,2024.08.15
84,Good On You,Priscilla Block,185,-5,190,33,0,246500,-38200,284700,353633,2024.08.15
85,Beatles And Eagles,Frontmen,204,-8,212,30,0,243800,-9500,253300,1014,2024.08.15
86,Not Today,Mitchell Tenpenny,211,33,178,54,0,236700,94800,141900,281232,2024.08.15
87,Baby Daddy's Weekend,Elle King,227,15,212,35,0,214800,14900,199900,68334,2024.08.15
88,Songs About Whiskey,Anne Wilson,119,1,118,18,0,190300,11000,179300,187367,2024.08.15
89,Wondering Why,Red Clay Strays,41,6,35,4,0,134300,13100,121200,4402008,2024.08.15
90,Dance Like No One’s Watching,Gabby Barrett,130,3,127,23,0,119800,10100,109700,333277,2024.08.15
91,How Is She,Cole Swindell,17,0,17,1,0,118100,8600,109500,40933,2024.08.15
92,Break Mine,Brothers Osborne,57,-97,154,12,0,117300,-156700,274000,397766,2024.08.15
93,I Got A Problem,Drake Milligan,50,6,44,4,0,106900,15100,91800,47707,2024.08.15
94,King Of Country Music,Ryan Larkins,28,-7,35,6,0,90900,23900,67000,8599,2024.08.15
95,Neon Baby,Annie Bosko,30,-16,46,5,0,90400,-24300,114700,12686,2024.08.15
96,American Nights,Zach Bryan,37,0,37,1,0,84800,-5300,90100,5900727,2024.08.15
97,My Own Lane,Sunny Sweeney,48,48,0,48,0,78300,78300,0,10939,2024.08.15
98,Cozy,Braxton Keith,16,14,2,1,0,73800,47600,26200,1100370,2024.08.15
99,Spin You Around (1/24),Morgan Wallen,26,-6,32,3,0,73300,-23200,96500,5417704,2024.08.15
100,Who Hurt You,Kashus Culpepper,16,16,0,15,0,72100,72100,0,62718,2024.08.15
101,Good Horses,Lainey Wilson,16,6,10,5,0,59700,29900,29800,1968326,2024.08.15
102,New To Country,Bailey Zimmerman,14,1,13,1,0,58400,4500,53900,2998537,2024.08.15
103,Broadway Girls,Lil Durk Feat. Morgan Wallen,14,-9,23,2,0,57500,-37200,94700,5920946,2024.08.15
104,Running Out Of Time,Wyatt Flores,16,0,16,2,0,55000,7800,47200,635892,2024.08.15
105,Don't Think Jesus,Morgan Wallen,10,-9,19,10,0,53600,-7000,60600,834761,2024.08.15
106,Church Bells And Train Whistles,Brad Tursi,19,2,17,1,0,48300,5700,42600,27935,2024.08.15
107,Work Boots,Cody Johnson,4,3,1,1,0,45300,25400,19900,239569,2024.08.15
108,Man Upstairs,Tim Dugger,10,-1,11,1,0,43400,-20200,63600,6228,2024.08.15
109,Change The Game,Cody Jinks,11,5,6,3,0,41300,34000,7300,84329,2024.08.15
110,The Star-Spangled Banner,Chris Stapleton,13,-2,15,12,0,41100,-23400,64500,95448,2024.08.15
111,That's Texas,Cody Johnson,3,1,2,1,0,35300,1800,33500,235568,2024.08.15
112,Jesus Loves You,Cody Johnson,16,16,0,16,0,34700,34700,0,158034,2024.08.15
113,Oklahoma Sooner,Jake Banfield,8,-3,11,1,0,32600,-10000,42600,2409,2024.08.15
114,Loud and Heavy,Cody Jinks,5,5,0,3,0,31300,31300,0,1450743,2024.08.15
115,Where That Came From,Randy Travis,5,-3,8,2,0,29000,-4200,33200,422048,2024.08.15
116,This Side Of The Dirt,Neon Union,15,15,0,12,0,27400,27400,0,6829,2024.08.15
117,Sweet Dreams,Koe Wetzel,7,-10,17,1,0,25900,-54000,79900,5708871,2024.08.15
118,Seven In Tennessee,12/Oc,17,0,17,1,0,25500,-4000,29500,2875,2024.08.15
119,When My Baby's In Boots,Randall King,2,1,1,1,0,23600,21800,1800,0,2024.08.15
120,Roulette On The Heart,Conner Smith,28,-31,59,8,0,22800,-26100,48900,459364,2024.08.15
121,Leave You Alone,Kane Brown,6,4,2,6,0,22100,11800,10300,244573,2024.08.15
122,"Poor, Poor Pitiful Me","Lainey Wilson, Terri Clark",4,4,0,4,0,22000,22000,0,36474,2024.08.15
123,One Beer Away,Reklaws,4,0,4,4,0,22000,2600,19400,29220,2024.08.15
124,Give Me A Sunrise,Braxton Keith,2,2,0,1,0,21700,21700,0,120964,2024.08.15
125,Dive,Luke Combs,2,1,1,1,0,21700,1800,19900,1291090,2024.08.15
126,You In A Honky Tonk,Randall King,2,0,2,2,0,21700,1900,19800,315068,2024.08.15
127,Three Drinks Behind,George Strait,2,0,2,1,0,21700,-1100,22800,469049,2024.08.15
128,Hit The Hay Runnin',Aaron Watson,5,3,2,5,0,21200,17600,3600,0,2024.08.15
129,Trouble,Josh Ross,4,3,1,4,0,21000,18600,2400,682927,2024.08.15
130,Oklahoma Smokeshow,Zach Bryan,6,3,3,2,0,20700,8500,12200,7629570,2024.08.15
131,Phones Don't Work,Wade Bowen,1,1,0,1,0,19900,19900,0,7700,2024.08.15
131,Like A Hurricane,Cody Jinks,1,1,0,1,0,19900,19900,0,97741,2024.08.15
131,My Baby Does,Drew Parker,1,1,0,1,0,19900,19900,0,1987,2024.08.15
131,I’ll Love You Longer,Drew Parker,1,1,0,1,0,19900,19900,0,13410,2024.08.15
131,Lovin' Where It's Goin',Josh Ward,1,1,0,1,0,19900,19900,0,36045,2024.08.15
131,Gettin' By,Flatland Cavalry,1,1,0,1,0,19900,19900,0,133790,2024.08.15
137,Up In Texas,Midland,1,0,1,1,0,19900,18100,1800,58991,2024.08.15
138,Grandpa (Tell Me 'Bout The Good Old Days),Cody Johnson,1,-1,2,1,0,19900,-5600,25500,0,2024.08.15
139,Fiddle In The Band,Kane Brown,2,-1,3,2,0,19900,-17300,37200,390830,2024.08.15
140,Beach Chair,Uncle Kracker,2,2,0,1,0,19800,19800,0,19617,2024.08.15
141,Sunrise Tells The Story,Midland,2,1,1,1,0,19800,18000,1800,139057,2024.08.15
142,Ain't That Some,Morgan Wallen,2,-9,11,2,0,18400,-27100,45500,4887378,2024.08.15
143,You'll Always Be My Baby (Written For Daughters' Weddings),Alan Jackson,6,1,5,1,0,17800,10300,7500,48067,2024.08.15
144,My Bar,Priscilla Block,3,2,1,2,0,17600,17600,0,111572,2024.08.15
145,Rain In The Rearview,Anne Wilson,3,3,0,1,0,16600,16600,0,368325,2024.08.15
146,Over Being Under You,Laura Bryna,17,0,17,5,0,16200,0,16200,495,2024.08.15
147,"Salt, Lime & Tequila",Ryan Griffin,4,0,4,1,0,16000,-1200,17200,68417,2024.08.15
148,Heart Of A Small Town,Tim Dugger,3,1,2,1,0,15900,-1500,17400,15742,2024.08.15
149,Any Given Friday Night,Luke Combs,2,0,2,1,0,14600,0,14600,176138,2024.08.15
150,Whatever Gets You Through It,Morgan Gruber,10,3,7,1,0,13400,5100,8300,255,2024.08.15
151,Scars In Heaven,Nelons,2,2,0,2,0,13100,13100,0,26329,2024.08.15
152,Hey Driver,Zach Bryan Feat. The War and Treaty,5,-4,9,1,0,12600,-17700,30300,5378088,2024.08.15
153,The Things We Cannot Change,LeFevre Quartet,2,2,0,2,0,11800,11800,0,3271,2024.08.15
154,Be Ready,Karen Peck & New River,2,1,1,2,0,11800,6200,5600,8524,2024.08.15
155,Think About There,Greater Vision,2,1,1,2,0,11800,1900,9900,11203,2024.08.15
156,He Pilots My Ship,Tribute Quartet,2,0,2,2,0,11800,5200,6600,5699,2024.08.15
157,Help Is On The Way,Gold City,2,0,2,2,0,11800,-1900,13700,20155,2024.08.15
158,Little Miss Runner Up,Gretchen Wilson,7,7,0,7,0,10900,10900,0,6787,2024.08.15
159,'98 Braves,Morgan Wallen,3,-7,10,2,0,10800,-38800,49600,1759889,2024.08.15
160,Just Like Johnny,Redferrin,2,2,0,1,0,10000,10000,0,3133146,2024.08.15
161,Sunrise,Morgan Wallen,1,1,0,1,0,9900,9900,0,2916901,2024.08.15
162,Golden Child,Meghan Patrick,3,0,3,3,0,9800,-9800,19600,0,2024.08.15
163,Never Love You Again,Post Malone,2,2,0,2,0,9500,9500,0,0,2024.08.15
163,Wrong Ones,Post Malone,2,2,0,2,0,9500,9500,0,0,2024.08.15
163,Right About You,Post Malone,2,2,0,2,0,9500,9500,0,1636,2024.08.15
163,M-E-X-I-C-O,Post Malone,2,2,0,2,0,9500,9500,0,0,2024.08.15
163,Goes Without Saying,Post Malone,2,2,0,2,0,9500,9500,0,0,2024.08.15
163,What Don't Belong To Me,Post Malone,2,2,0,2,0,9500,9500,0,8576,2024.08.15
163,Losers,Post Malone,2,2,0,2,0,9500,9500,0,0,2024.08.15
163,Missin' You Like This,Post Malone,2,2,0,2,0,9500,9500,0,0,2024.08.15
163,Hide My Gun,Post Malone,2,2,0,2,0,9500,9500,0,0,2024.08.15
163,Have The Heart,Post Malone,2,2,0,2,0,9500,9500,0,0,2024.08.15
163,Devil I've Been,Post Malone,2,2,0,2,0,9500,9500,0,1953,2024.08.15
163,Finer Things,Post Malone,2,2,0,2,0,9500,9500,0,0,2024.08.15
175,Lonely Road,mgk & Jelly Roll,4,1,3,3,0,9000,2800,6200,7644763,2024.08.15
176,Back 40 Back,Luke Combs,3,2,1,1,0,8400,5600,2800,178509,2024.08.15
177,Long Live Cowgirls,Ian Munsick & Cody Johnson,12,3,9,4,0,8300,6200,2100,742968,2024.08.15
178,Kiss It Goodbye,Morgan Gruber,6,5,1,1,0,8000,6800,1200,1175,2024.08.15
179,Hell Yeah,Little Big Town,1,1,0,1,0,7600,7600,0,219266,2024.08.15
180,Religion Isn'T Working,Joseph Habedank,1,1,0,1,0,7500,7500,0,931,2024.08.15
180,Four Days Late (Acoustic),Karen Peck & New River,1,1,0,1,0,7500,7500,0,0,2024.08.15
182,Darlin',Chase Matthew,1,0,1,1,0,7500,3300,4200,2642162,2024.08.15
183,Gone Country,Thomas Rhett,2,2,0,1,0,7400,7400,0,1864271,2024.08.15
184,Whiskey Bent,Cody Johnson,2,1,1,1,0,7400,5600,1800,722466,2024.08.15
185,A Little Bit Closer,Braxton Keith,2,1,1,1,0,7400,1800,5600,223223,2024.08.15
186,Quittin' Time,Zach Bryan,2,0,2,1,0,7400,-14300,21700,1298964,2024.08.15
187,Miss America,Castellows,1,1,0,1,0,7300,7300,0,45718,2024.08.15
187,lose you again,Avery Anna,1,1,0,1,0,7300,7300,0,0,2024.08.15
187,Take Me Home,Little Big Town,1,1,0,1,0,7300,7300,0,58828,2024.08.15
187,Train (Station Edition),Hunter Brothers,1,1,0,1,0,7300,7300,0,3857,2024.08.15
191,Hungover Again,Casey Donahew,2,1,1,2,0,7300,5500,1800,0,2024.08.15
191,My Kind Of Weathered,Kin Faux,2,1,1,2,0,7300,5500,1800,706,2024.08.15
193,I Just Killed A Man,Catie Offerman,3,3,0,2,0,6400,6400,0,6700,2024.08.15
194,Summertime Blues,Zach Bryan,7,1,6,1,0,6300,1600,4700,607062,2024.08.15
195,He Grew The Tree,Guardians Quartet,1,1,0,1,0,6200,6200,0,507,2024.08.15
195,Turn Your Back,Justified Quartet,1,1,0,1,0,6200,6200,0,63,2024.08.15
195,Like Jesus Can,Taranda Greene,1,1,0,1,0,6200,6200,0,833,2024.08.15
195,No Better Than That,Southbound,1,1,0,1,0,6200,6200,0,407,2024.08.15
195,God's Gonna Cut You Down,Bailey Zimmerman,1,1,0,1,0,6200,6200,0,369615,2024.08.15
195,Be The Reason,Steeles,1,1,0,1,0,6200,6200,0,1134,2024.08.15
195,God's Been Good,LeFevre Quartet,1,1,0,1,0,6200,6200,0,733,2024.08.15
195,Jesus Does,Lore Family,1,1,0,1,0,6200,6200,0,1014,2024.08.15
195,Back To The Garden,Erwins,1,1,0,1,0,6200,6200,0,0,2024.08.15
195,The End,Endless Highway,1,1,0,1,0,6200,6200,0,236,2024.08.15
195,Come To The Well,Inspirations,1,1,0,1,0,6200,6200,0,10749,2024.08.15
195,Tell The Grave,Perrys,1,1,0,1,0,6200,6200,0,2320,2024.08.15
195,I'M Going Where,Crystle Elam,1,1,0,1,0,6200,6200,0,4,2024.08.15
208,He Bought Me,Old Paths,1,0,1,1,0,6200,0,6200,2272,2024.08.15
208,There's Always A Place At The Table,Sunday Drive,1,0,1,1,0,6200,0,6200,490,2024.08.15
208,I Think I'Ll Just Go On,Perrys,1,0,1,1,0,6200,0,6200,8598,2024.08.15
208,Waiting For Me,Truesong,1,0,1,1,0,6200,0,6200,868,2024.08.15
208,We Are The Church,Ernie Haase & Signature Sound,1,0,1,1,0,6200,0,6200,22052,2024.08.15
208,In God's Time,Jordan Family Band,1,0,1,1,0,6200,0,6200,5146,2024.08.15
208,My God,Scotty Inman,1,0,1,1,0,6200,0,6200,42227,2024.08.15
208,All Things,Sound,1,0,1,1,0,6200,0,6200,1830,2024.08.15
216,Mansions,Sound Street,1,0,1,1,0,6200,-1300,7500,1859,2024.08.15
217,Wings Of A Dove,Jonathan Wilburn,1,-1,2,1,0,6200,-5600,11800,0,2024.08.15
1,A Bar Song (Tipsy),Shaboozey,7341,-154,7495,144,0,29779300,-698000,30477300,32964711,2024.08.22
2,I Had Some Help,Post Malone,6562,-534,7096,145,0,28010700,-2076500,30087200,35094068,2024.08.22
3,She's Somebody's Daughter,Drew Baldridge,8234,1135,7099,145,0,27866200,3277900,24588300,598498,2024.08.22
4,Cowgirls,Morgan Wallen,6332,-225,6557,144,0,25732100,-696400,26428500,14927609,2024.08.22
5,Chevrolet,Dustin Lynch Feat. Jelly Roll,6648,131,6517,145,0,23082100,618900,22463200,3412149,2024.08.22
6,Ain't No Love In Oklahoma (From Twisters: The Album),Luke Combs,6476,129,6347,145,0,23079200,748500,22330700,14402140,2024.08.22
7,Young Love & Saturday Nights,Chris Young,6348,1,6347,145,0,22198300,515400,21682900,643949,2024.08.22
8,Dirt Cheap,Cody Johnson,6414,121,6293,145,0,21806000,250600,21555400,5927568,2024.08.22
9,Bulletproof,Nate Smith,4670,-3122,7792,144,0,18221400,-9501900,27723300,6147693,2024.08.22
10,"Love You, Miss You, Mean It",Luke Bryan,5394,569,4825,145,0,18059500,1138400,16921100,3180364,2024.08.22
11,Love You Again,Chase Matthew,5325,262,5063,145,0,16687000,-8300,16695300,1959931,2024.08.22
12,This Is My Dirt,Justin Moore,4870,151,4719,145,0,16633800,734400,15899400,688007,2024.08.22
13,Pour Me A Drink,Post Malone,4319,419,3900,145,0,15738100,1361600,14376500,16952956,2024.08.22
14,Austin,Dasha,4350,326,4024,142,0,14735600,1534000,13201600,10970812,2024.08.22
15,Hang Tight Honey,Lainey Wilson,4180,-186,4366,145,0,13531600,113800,13417800,4765292,2024.08.22
16,One Bad Habit,Tim McGraw,3966,18,3948,145,0,12796300,-20800,12817100,358427,2024.08.22
17,Miles On It,Marshmello & Kane Brown,3665,453,3212,144,0,12574400,2058300,10516100,12495176,2024.08.22
18,I Am Not Okay,Jelly Roll,3767,135,3632,145,0,11946100,366600,11579500,10531890,2024.08.22
19,Gonna Love You,Parmalee,3413,301,3112,145,0,11188700,1831100,9357600,328874,2024.08.22
20,Lies Lies Lies,Morgan Wallen,2984,362,2622,145,0,10257300,1075300,9182000,16950886,2024.08.22
21,Beautiful As You,Thomas Rhett,3035,81,2954,145,0,9766500,425300,9341200,5001480,2024.08.22
22,Messed Up As Me,Keith Urban,3214,44,3170,144,0,9095900,19400,9076500,1158615,2024.08.22
23,Bigger Houses,Dan + Shay,2596,22,2574,142,0,7825400,573100,7252300,1346337,2024.08.22
24,Sounds Like The Radio,Zach Top,2532,132,2400,140,0,7393100,-30000,7423100,1635215,2024.08.22
25,American Girl,Dierks Bentley,1939,69,1870,143,0,6101900,63000,6038900,198278,2024.08.22
26,Think I’m In Love With You,Chris Stapleton,1903,62,1841,140,0,5928400,122300,5806100,5739615,2024.08.22
27,Damn Good Day To Leave,Riley Green,2276,119,2157,144,0,5904500,131600,5772900,1339688,2024.08.22
28,Cowboy Songs,George Birge,1960,50,1910,138,0,5246500,385500,4861000,639883,2024.08.22
29,Wind Up Missin' You,Tucker Wetmore,1512,53,1459,140,0,4683900,132200,4551700,5983167,2024.08.22
30,Boys Back Home,Dylan Marlowe Feat. Dylan Scott,1674,221,1453,133,0,4307000,578800,3728200,2420772,2024.08.22
31,High Road,Koe Wetzel,1062,133,929,61,0,3628400,532000,3096400,9631791,2024.08.22
32,Breakin' In Boots,Matt Stell,1642,89,1553,140,0,3435200,123500,3311700,412182,2024.08.22
33,You Look Like You Love Me,Ella Langley & Riley Green,857,154,703,75,0,3100300,377200,2723100,8095337,2024.08.22
34,Friends Like That,John Morgan Feat. Jason Aldean,1258,80,1178,103,0,3052700,312900,2739800,841690,2024.08.22
35,Called Crazy,Kassi Ashton,882,53,829,82,0,3032200,18200,3014000,488006,2024.08.22
36,Find Another Bar,Chris Lane,1310,28,1282,134,0,2899100,187400,2711700,79849,2024.08.22
37,Whatcha See Is Whatcha Get,Chris Janson,1322,44,1278,136,0,2748400,79700,2668700,134707,2024.08.22
38,Just To Say We Did,Kenny Chesney,891,115,776,85,0,2732800,1033600,1699200,453242,2024.08.22
39,This Town's Been Too Good To Us,Dylan Scott,1259,118,1141,129,0,2674300,176400,2497900,2163245,2024.08.22
40,Guy For That,Post Malone,836,48,788,102,0,2643600,270700,2372900,17117463,2024.08.22
41,Life With You,Kelsey Hart,1204,24,1180,107,0,2402300,-99400,2501700,1843644,2024.08.22
42,Wranglers,Miranda Lambert,1108,-28,1136,124,0,2365300,25600,2339700,1352953,2024.08.22
43,Forever To Me,Cole Swindell,960,40,920,85,0,2337400,148100,2189300,719469,2024.08.22
44,Drinkin' Buddies,"Lee Brice, Hailey Whitters, And Nate Smith",708,-27,735,91,0,2028100,-149300,2177400,322737,2024.08.22
45,Tie Up,Zac Brown Band,1141,47,1094,126,0,1985800,95700,1890100,747305,2024.08.22
46,I Tried A Ring On,Tigirlily Gold,1145,47,1098,138,0,1920100,108600,1811500,1516727,2024.08.22
47,I Ain'T Sayin',Jordan Davis,810,46,764,94,0,1894300,93100,1801200,2751532,2024.08.22
48,Fall Of Summer,Scotty McCreery,855,-2,857,101,0,1863200,40000,1823200,382759,2024.08.22
49,Coming Home,Old Dominion,751,43,708,88,0,1852000,125800,1726200,2429844,2024.08.22
50,Whiskey Drink,Jason Aldean,770,-45,815,83,0,1814700,-203900,2018600,1005935,2024.08.22
51,Cowboys Cry Too,Kelsea Ballerini,915,77,838,130,0,1716000,-15500,1731500,3687910,2024.08.22
52,Holy Smokes,Bailey Zimmerman,637,25,612,68,0,1493100,-173300,1666400,4983094,2024.08.22
53,Truck On Fire,Carly Pearce,618,90,528,98,0,1456400,224100,1232300,916702,2024.08.22
54,Love The Leavin',Drew Parker,478,153,325,56,0,1394000,489700,904300,111247,2024.08.22
55,Hometown Home,Locash,795,23,772,89,0,1378100,39700,1338400,108607,2024.08.22
56,Country Back,Randy Houser,761,-10,771,83,0,1351200,91700,1259500,36599,2024.08.22
57,SIX FEET UNDER (Caleigh's Song),Hardy,662,8,654,98,0,1229100,-25100,1254200,863019,2024.08.22
58,Am I Okay?,Megan Moroney,256,105,151,26,0,1069900,202000,867900,5313668,2024.08.22
59,Everything I Need,Chayce Beckham,475,-8,483,62,0,936600,-45400,982000,240287,2024.08.22
60,Single Again,Josh Ross,719,7,712,97,0,914900,4200,910700,2539606,2024.08.22
61,Over When We'Re Sober,Brantley Gilbert,454,-4,458,70,0,908300,-19900,928200,787539,2024.08.22
62,This Heart,Corey Kent,510,18,492,59,0,858600,114600,744000,872431,2024.08.22
63,Park,Tyler Hubbard,415,48,367,78,0,814600,105400,709200,1012885,2024.08.22
64,Country House,Sam Hunt,524,16,508,76,0,811700,-32400,844100,278225,2024.08.22
65,Devil You Know,Tyler Braden,397,13,384,47,0,810900,74900,736000,4756368,2024.08.22
66,Bones,Russell Dickerson,468,-36,504,72,0,651100,-123200,774300,520100,2024.08.22
67,I Could Be That Rain,Randall King,238,36,202,34,0,597000,154200,442800,103737,2024.08.22
68,Never Been Over,Darius Rucker,366,45,321,53,0,520000,57600,462400,175985,2024.08.22
69,Out Of Oklahoma,Lainey Wilson,112,0,112,13,0,480100,43400,436700,3567712,2024.08.22
70,Strangers,Kameron Marlowe & Ella Langley,378,-8,386,48,0,477000,-13400,490400,1167412,2024.08.22
71,Losers,Post Malone,88,86,2,71,0,464500,455000,9500,13015434,2024.08.22
72,The Devil I Know,Ashley McBryde,248,-140,388,41,0,448500,-214300,662800,185801,2024.08.22
73,Pink Skies,Zach Bryan,177,-19,196,6,0,436200,-88400,524600,18610087,2024.08.22
74,Nosedive,Post Malone,81,80,1,68,0,425000,421600,3400,9150745,2024.08.22
75,Heavens To Betsy,Jackson Dean,226,54,172,53,0,367200,49300,317900,235199,2024.08.22
76,Worst Way,Riley Green,37,6,31,2,0,363300,41400,321900,4231837,2024.08.22
77,Wrong Ones,Post Malone,72,70,2,38,0,338000,328500,9500,12568479,2024.08.22
78,Bury Me In This Bar,Dalton Dover,237,-8,245,41,0,308500,32500,276000,16369,2024.08.22
79,Pray All The Way Home,Austin Snell,148,-1,149,24,0,305200,-1900,307100,748405,2024.08.22
80,Good On You,Priscilla Block,176,-9,185,29,0,291800,45300,246500,309260,2024.08.22
81,Beatles And Eagles,Frontmen,206,2,204,30,0,279300,35500,243800,1382,2024.08.22
82,Things I Take For Granted,Larry Fleet,209,-10,219,31,0,278800,-65400,344200,632943,2024.08.22
83,Acres,Brian Kelley,252,-32,284,51,0,235500,-16400,251900,134267,2024.08.22
84,Relapse,Warren Zeiders,203,-4,207,27,0,234200,-29000,263200,4420495,2024.08.22
85,Songs About Whiskey,Anne Wilson,122,3,119,18,0,232500,42200,190300,184868,2024.08.22
86,Yours,Post Malone,48,47,1,31,0,231300,227900,3400,8264690,2024.08.22
87,Wine Into Whiskey,Tucker Wetmore,38,-28,66,2,0,219200,-195300,414500,5485099,2024.08.22
88,California Sober,Post Malone,44,43,1,28,0,219100,215700,3400,11505242,2024.08.22
89,Goes Without Saying,Post Malone,44,42,2,35,0,210600,201100,9500,8074300,2024.08.22
90,Baby Daddy's Weekend,Elle King,213,-14,227,34,0,192700,-22100,214800,45204,2024.08.22
91,Not Today,Mitchell Tenpenny,202,-9,211,42,0,175800,-60900,236700,207964,2024.08.22
92,Missin' You Like This,Post Malone,33,31,2,26,0,151800,142300,9500,7822166,2024.08.22
93,I Got A Problem,Drake Milligan,57,7,50,12,0,128100,21200,106900,48671,2024.08.22
94,Wondering Why,Red Clay Strays,34,-7,41,5,0,121000,-13300,134300,4060486,2024.08.22
95,How Is She,Cole Swindell,16,-1,17,1,0,117300,-800,118100,40383,2024.08.22
96,Finer Things,Post Malone,31,29,2,24,0,111600,102100,9500,9828498,2024.08.22
97,Hide My Gun,Post Malone,27,25,2,23,0,102100,92600,9500,7650901,2024.08.22
98,Break Mine,Brothers Osborne,40,-17,57,5,0,96700,-20600,117300,383963,2024.08.22
99,Hey Mercedes,Post Malone,5,5,0,2,0,89600,89600,0,2337943,2024.08.22
100,Cozy,Braxton Keith,17,1,16,1,0,79900,6100,73800,1090608,2024.08.22
101,Dollar Bill Bar,Sierra Ferrell,47,46,1,46,0,78500,73100,5400,233143,2024.08.22
102,M-E-X-I-C-O,Post Malone,23,21,2,23,0,78300,68800,9500,5968009,2024.08.22
103,Cry,Tiera Kennedy,48,48,0,48,0,76700,76700,0,38064,2024.08.22
104,American Nights,Zach Bryan,34,-3,37,1,0,73000,-11800,84800,5437423,2024.08.22
105,New To Country,Bailey Zimmerman,18,4,14,2,0,71400,13000,58400,2478694,2024.08.22
106,Right About You,Post Malone,20,18,2,19,0,71000,61500,9500,5779402,2024.08.22
107,The Star-Spangled Banner,Chris Stapleton,14,1,13,13,0,68600,27500,41100,84255,2024.08.22
108,Dance Like No One’s Watching,Gabby Barrett,75,-55,130,20,0,63800,-56000,119800,320542,2024.08.22
109,Have The Heart,Post Malone,20,18,2,18,0,62500,53000,9500,8268234,2024.08.22
110,What Don't Belong To Me,Post Malone,26,24,2,20,0,61200,51700,9500,10551944,2024.08.22
111,Man Upstairs,Tim Dugger,12,2,10,1,0,59300,15900,43400,5600,2024.08.22
112,Spin You Around (1/24),Morgan Wallen,25,-1,26,3,0,53000,-20300,73300,5307259,2024.08.22
113,Good Horses,Lainey Wilson,13,-3,16,2,0,50800,-8900,59700,1741033,2024.08.22
114,Back To Texas,Post Malone,3,3,0,2,0,49800,49800,0,1807368,2024.08.22
115,King Of Country Music,Ryan Larkins,25,-3,28,5,0,46800,-44100,90900,6917,2024.08.22
116,Church Bells And Train Whistles,Brad Tursi,18,-1,19,1,0,41700,-6600,48300,26489,2024.08.22
117,Running Out Of Time,Wyatt Flores,13,-3,16,1,0,41500,-13500,55000,613967,2024.08.22
118,Two Steppin' On The Moon,Josh Turner,8,8,0,8,0,40200,40200,0,397575,2024.08.22
119,Devil I've Been,Post Malone,16,14,2,16,0,39800,30300,9500,7309958,2024.08.22
120,Oklahoma Sooner,Jake Banfield,8,0,8,1,0,36600,4000,32600,2067,2024.08.22
121,Broadway Girls,Lil Durk Feat. Morgan Wallen,13,-1,14,2,0,35300,-22200,57500,5799867,2024.08.22
122,Work Boots,Cody Johnson,2,-2,4,1,0,33500,-11800,45300,231175,2024.08.22
123,Darlin',Chase Matthew,4,3,1,1,0,29900,22400,7500,2476720,2024.08.22
124,Who Needs You,Post Malone,2,2,0,2,0,29900,29900,0,1835617,2024.08.22
125,Seven In Tennessee,12/Oc,16,-1,17,1,0,29800,4300,25500,3128,2024.08.22
126,Never Love You Again,Post Malone,11,9,2,11,0,23400,13900,9500,6489023,2024.08.22
127,Mia Down In Mia,George Strait,2,2,0,1,0,21700,21700,0,167468,2024.08.22
128,Young Man,Greylan James,17,2,15,3,0,21700,15700,6000,33791,2024.08.22
129,Grandpa (Tell Me 'Bout The Good Old Days),Cody Johnson,2,1,1,1,0,21700,1800,19900,0,2024.08.22
130,Dive,Luke Combs,2,0,2,1,0,21700,0,21700,1246260,2024.08.22
131,When My Baby's In Boots,Randall King,2,0,2,1,0,21700,-1900,23600,0,2024.08.22
132,Change The Game,Cody Jinks,8,-3,11,2,0,20600,-20700,41300,82726,2024.08.22
133,Neon Baby,Annie Bosko,15,-15,30,3,0,20500,-69900,90400,11939,2024.08.22
134,Liar,Jelly Roll,7,6,1,2,0,20200,17400,2800,4448496,2024.08.22
135,Sun To Me,Zach Bryan,10,5,5,2,0,20200,16600,3600,7599210,2024.08.22
136,Dancin' With The Devil,Josh Ward,1,1,0,1,0,19900,19900,0,9606,2024.08.22
137,A Little Bit Closer,Braxton Keith,1,-1,2,1,0,19900,12500,7400,235193,2024.08.22
138,Down In Georgia,Josh Turner,4,4,0,4,0,19400,19400,0,178504,2024.08.22
139,Where That Came From,Randy Travis,5,0,5,1,0,19300,-9700,29000,397951,2024.08.22
140,Roulette On The Heart,Conner Smith,15,-13,28,6,0,18700,-4100,22800,424156,2024.08.22
141,Give Me A Sunrise,Braxton Keith,1,-1,2,1,0,18000,-3700,21700,125907,2024.08.22
142,Heart Of A Small Town,Tim Dugger,2,-1,3,1,0,17400,1500,15900,14404,2024.08.22
143,Fear And Friday's,Zach Bryan,4,4,0,1,0,16800,16800,0,1535194,2024.08.22
144,He Pilots My Ship,Tribute Quartet,2,0,2,2,0,16100,4300,11800,6347,2024.08.22
145,Over Being Under You,Laura Bryna,16,-1,17,5,0,16000,-200,16200,610,2024.08.22
146,Blackout Betty,Ashley McBryde,6,6,0,6,0,15700,15700,0,45404,2024.08.22
147,The Building,Emily Ann Roberts,2,2,0,2,0,15500,15500,0,29279,2024.08.22
148,Any Given Friday Night,Luke Combs,2,0,2,1,0,14600,0,14600,170191,2024.08.22
149,Fiddle In The Band,Kane Brown,1,-1,2,1,0,13600,-6300,19900,428304,2024.08.22
150,Hit The Hay Runnin',Aaron Watson,3,-2,5,3,0,13400,-7800,21200,0,2024.08.22
151,Hey Driver,Zach Bryan Feat. The War and Treaty,5,0,5,3,0,13000,400,12600,5410149,2024.08.22
152,Hawaii,Old Dominion,2,2,0,2,0,12700,12700,0,83448,2024.08.22
153,My Bar,Priscilla Block,2,-1,3,2,0,12400,-5200,17600,103656,2024.08.22
154,Star Spangled Banner,Mickey Guyton,2,0,2,2,0,12300,7900,4400,0,2024.08.22
155,Am I The Only One,Aaron Lewis,2,0,2,2,0,12300,6800,5500,563156,2024.08.22
156,You'll Always Be My Baby (Written For Daughters' Weddings),Alan Jackson,5,-1,6,1,0,12200,-5600,17800,47218,2024.08.22
157,Strawberry Wine And A Cheap Six Pack,Travis Denning,3,3,0,1,0,12100,12100,0,27741,2024.08.22
158,Oklahoma Smokeshow,Zach Bryan,4,-2,6,2,0,12000,-8700,20700,7549704,2024.08.22
159,Certified,Laura Bryna,17,-1,18,1,0,11900,6300,5600,6700,2024.08.22
160,Would If I Could (Feat. Lainey Wilson),Ernest,3,3,0,2,0,11800,11800,0,525093,2024.08.22
161,Wings Of A Dove,Jonathan Wilburn,2,1,1,2,0,11800,5600,6200,0,2024.08.22
162,The Things We Cannot Change,LeFevre Quartet,2,0,2,2,0,11800,0,11800,4375,2024.08.22
162,Help Is On The Way,Gold City,2,0,2,2,0,11800,0,11800,17353,2024.08.22
164,Now Or Never,Corey Kent,2,2,0,2,0,11200,11200,0,970416,2024.08.22
165,Back 40 Back,Luke Combs,4,1,3,1,0,11200,2800,8400,165981,2024.08.22
166,Ain't How It Ends,Post Malone,1,1,0,1,0,10000,10000,0,2403557,2024.08.22
166,Dead At The Honky Tonk,Post Malone,1,1,0,1,0,10000,10000,0,2611988,2024.08.22
166,Two Hearts,Post Malone,1,1,0,1,0,10000,10000,0,1945338,2024.08.22
166,Fallin' In Love,Post Malone,1,1,0,1,0,10000,10000,0,2718491,2024.08.22
166,Go To Hell,Post Malone,1,1,0,1,0,10000,10000,0,1975455,2024.08.22
171,Never Not God,Sound,1,1,0,1,0,9900,9900,0,16513,2024.08.22
171,Whiskey Friends,Morgan Wallen,1,1,0,1,0,9900,9900,0,1144211,2024.08.22
171,On And On,Wes Hampton,1,1,0,1,0,9900,9900,0,98,2024.08.22
171,Tattoo On A Sunburn,Luke Combs,1,1,0,1,0,9900,9900,0,187917,2024.08.22
171,Little Miss Saturday Night,Drew Parker,1,1,0,1,0,9900,9900,0,29301,2024.08.22
176,God's Been Good,LeFevre Quartet,1,0,1,1,0,9900,3700,6200,787,2024.08.22
177,Buy A Girl A Drink,Travis Denning,2,2,0,1,0,9300,9300,0,37394,2024.08.22
178,I Wrote The Book,Morgan Wallen,1,1,0,1,0,8500,8500,0,2892503,2024.08.22
179,Ain't That Some,Morgan Wallen,1,-1,2,1,0,7900,-10500,18400,4413561,2024.08.22
180,Back Pew,Lily Rose,1,1,0,1,0,7600,7600,0,371518,2024.08.22
181,Gettin' Ready To Breathe,Wes Hampton,1,1,0,1,0,7500,7500,0,16972,2024.08.22
181,Looks Like Jesus,Brian Free & Assurance,1,1,0,1,0,7500,7500,0,738,2024.08.22
181,Braggin' On Jesus,Steeles,1,1,0,1,0,7500,7500,0,1035,2024.08.22
184,We Were Never Gonna,Josh Kerr,1,1,0,1,0,7300,7300,0,0,2024.08.22
185,Kiss It Goodbye,Morgan Gruber,6,0,6,1,0,7300,-700,8000,724,2024.08.22
186,Build A Bridge,Ashley Cooke,5,1,4,1,0,6900,2600,4300,6059,2024.08.22
187,Oklahoma,Carly Pearce,8,4,4,1,0,6500,2900,3600,21313,2024.08.22
188,Just Like Johnny,Redferrin,9,7,2,1,0,6300,-3700,10000,2963848,2024.08.22
189,Summertime Blues,Zach Bryan,7,0,7,1,0,6300,0,6300,585701,2024.08.22
190,Whatever Gets You Through It,Morgan Gruber,7,-3,10,1,0,6300,-7100,13400,158,2024.08.22
191,Come On In,Kingdom Heirs,1,1,0,1,0,6200,6200,0,8656,2024.08.22
191,Nobody Knows Better Than Me,Tiffany Coburn,1,1,0,1,0,6200,6200,0,0,2024.08.22
191,"Liar, Liar",Brian Free & Assurance,1,1,0,1,0,6200,6200,0,1949,2024.08.22
191,He's Got A Way,Southbound,1,1,0,1,0,6200,6200,0,1626,2024.08.22
191,That Is That,Adams Voice,1,1,0,1,0,6200,6200,0,3,2024.08.22
196,"I, John",Blackwood Brothers Quartet,1,0,1,1,0,6200,600,5600,70,2024.08.22
197,In God's Time,Jordan Family Band,1,0,1,1,0,6200,0,6200,4040,2024.08.22
197,I Think I'Ll Just Go On,Perrys,1,0,1,1,0,6200,0,6200,7804,2024.08.22
197,The End,Endless Highway,1,0,1,1,0,6200,0,6200,289,2024.08.22
197,There's Always A Place At The Table,Sunday Drive,1,0,1,1,0,6200,0,6200,441,2024.08.22
197,Mansions,Sound Street,1,0,1,1,0,6200,0,6200,2044,2024.08.22
197,Jesus Does,Lore Family,1,0,1,1,0,6200,0,6200,993,2024.08.22
197,Come To The Well,Inspirations,1,0,1,1,0,6200,0,6200,9437,2024.08.22
197,Back To The Garden,Erwins,1,0,1,1,0,6200,0,6200,0,2024.08.22
197,All Things,Sound,1,0,1,1,0,6200,0,6200,1600,2024.08.22
197,He Grew The Tree,Guardians Quartet,1,0,1,1,0,6200,0,6200,588,2024.08.22
197,He Bought Me,Old Paths,1,0,1,1,0,6200,0,6200,2412,2024.08.22
197,Like Jesus Can,Taranda Greene,1,0,1,1,0,6200,0,6200,745,2024.08.22
209,Think About There,Greater Vision,1,-1,2,1,0,6200,-5600,11800,12111,2024.08.22
209,Be Ready,Karen Peck & New River,1,-1,2,1,0,6200,-5600,11800,7756,2024.08.22
1,A Bar Song (Tipsy),Shaboozey,6874,63,6811,143,0,28174200,-588600,28762800,30248638,2024.09.05
2,I Had Some Help,Post Malone,6415,-216,6631,145,0,27477200,-660100,28137300,26285891,2024.09.05
3,Chevrolet,Dustin Lynch Feat. Jelly Roll,7404,339,7065,145,0,27279200,2202800,25076400,3374986,2024.09.05
4,Ain't No Love In Oklahoma (From Twisters: The Album),Luke Combs,7078,351,6727,145,0,25596600,1847100,23749500,15118670,2024.09.05
5,Young Love & Saturday Nights,Chris Young,7486,919,6567,145,0,24998000,2351900,22646100,596482,2024.09.05
6,Cowgirls,Morgan Wallen,5861,43,5818,145,0,24251300,-359700,24611000,13798972,2024.09.05
7,Pour Me A Drink,Post Malone,5543,472,5071,145,0,20025000,1445000,18580000,8759251,2024.09.05
8,"Love You, Miss You, Mean It",Luke Bryan,5897,182,5715,145,0,19981800,901400,19080400,2848009,2024.09.05
9,Love You Again,Chase Matthew,5988,699,5289,145,0,18949600,2056500,16893100,2074671,2024.09.05
10,This Is My Dirt,Justin Moore,5454,418,5036,145,0,18058500,883900,17174600,569921,2024.09.05
11,Miles On It,Marshmello & Kane Brown,4788,742,4046,144,0,17453200,2961400,14491800,11826265,2024.09.05
12,Dirt Cheap,Cody Johnson,4381,-2926,7307,144,0,16447700,-7740900,24188600,5750512,2024.09.05
13,Austin,Dasha,4410,-6,4416,142,0,15091900,167100,14924800,10377032,2024.09.05
14,I Am Not Okay,Jelly Roll,4378,436,3942,145,0,14766400,2062000,12704400,10650707,2024.09.05
15,Gonna Love You,Parmalee,4064,433,3631,145,0,13296000,1281800,12014200,358976,2024.09.05
16,One Bad Habit,Tim McGraw,4085,148,3937,145,0,12948200,178800,12769400,600580,2024.09.05
17,Lies Lies Lies,Morgan Wallen,3364,210,3154,145,0,12189900,1215200,10974700,15427277,2024.09.05
18,Beautiful As You,Thomas Rhett,3436,378,3058,145,0,11589800,1320300,10269500,6184444,2024.09.05
19,Messed Up As Me,Keith Urban,3223,84,3139,144,0,8989500,121500,8868000,1142882,2024.09.05
20,Bigger Houses,Dan + Shay,2677,100,2577,142,0,7913800,-7000,7920800,1068040,2024.09.05
21,Sounds Like The Radio,Zach Top,2619,121,2498,142,0,7679600,63000,7616600,1735797,2024.09.05
22,Think I’m In Love With You,Chris Stapleton,2349,463,1886,142,0,7322100,1106900,6215200,5875869,2024.09.05
23,Damn Good Day To Leave,Riley Green,2634,211,2423,144,0,7091700,840100,6251600,1272397,2024.09.05
24,Cowboy Songs,George Birge,2427,418,2009,138,0,6957900,1662200,5295700,682204,2024.09.05
25,American Girl,Dierks Bentley,2072,82,1990,142,0,6328000,49600,6278400,178302,2024.09.05
26,Hang Tight Honey,Lainey Wilson,1928,-2218,4146,139,0,6258100,-6681000,12939100,3138772,2024.09.05
27,Wind Up Missin' You,Tucker Wetmore,1931,149,1782,142,0,6113100,758400,5354700,5713318,2024.09.05
28,You Look Like You Love Me,Ella Langley & Riley Green,1488,410,1078,128,0,5166500,1291900,3874600,9545503,2024.09.05
29,High Road,Koe Wetzel,1493,164,1329,81,0,5140900,347500,4793400,8985160,2024.09.05
30,Boys Back Home,Dylan Marlowe Feat. Dylan Scott,1860,117,1743,139,0,5007700,259000,4748700,2225702,2024.09.05
31,Just To Say We Did,Kenny Chesney,1172,140,1032,104,0,3873100,382000,3491100,465217,2024.09.05
32,Friends Like That,John Morgan Feat. Jason Aldean,1420,86,1334,109,0,3661100,325600,3335500,732154,2024.09.05
33,Find Another Bar,Chris Lane,1611,278,1333,135,0,3544000,479200,3064800,75220,2024.09.05
34,Breakin' In Boots,Matt Stell,1623,-20,1643,139,0,3452400,19900,3432500,222113,2024.09.05
35,Called Crazy,Kassi Ashton,923,58,865,87,0,3042300,166200,2876100,585148,2024.09.05
36,Whatcha See Is Whatcha Get,Chris Janson,1341,-48,1389,141,0,3038900,-49700,3088600,133428,2024.09.05
37,This Town's Been Too Good To Us,Dylan Scott,1346,8,1338,131,0,2996200,251100,2745100,1965489,2024.09.05
38,Wranglers,Miranda Lambert,1372,125,1247,130,0,2846400,242700,2603700,1294695,2024.09.05
39,Guy For That,Post Malone,920,35,885,105,0,2812500,219300,2593200,10286799,2024.09.05
40,Forever To Me,Cole Swindell,1119,64,1055,114,0,2742200,37000,2705200,784520,2024.09.05
41,I Ain'T Sayin',Jordan Davis,1059,162,897,106,0,2698500,462900,2235600,2713510,2024.09.05
42,Life With You,Kelsey Hart,1276,89,1187,112,0,2599100,140800,2458300,1188418,2024.09.05
43,Coming Home,Old Dominion,837,25,812,113,0,2162600,185100,1977500,2355972,2024.09.05
44,Drinkin' Buddies,"Lee Brice, Hailey Whitters, And Nate Smith",728,9,719,92,0,2054200,142100,1912100,271202,2024.09.05
45,I Tried A Ring On,Tigirlily Gold,1267,96,1171,140,0,2045700,95100,1950600,1194525,2024.09.05
46,Holy Smokes,Bailey Zimmerman,723,72,651,68,0,2000600,346900,1653700,4325133,2024.09.05
47,Am I Okay?,Megan Moroney,615,187,428,63,0,1865100,365500,1499600,5722153,2024.09.05
48,Fall Of Summer,Scotty McCreery,898,44,854,98,0,1838600,90400,1748200,341515,2024.09.05
49,Cowboys Cry Too,Kelsea Ballerini,988,56,932,132,0,1792200,207600,1584600,3468397,2024.09.05
50,Tie Up,Zac Brown Band,1116,-1,1117,125,0,1789500,-192400,1981900,716354,2024.09.05
51,Whiskey Drink,Jason Aldean,825,25,800,95,0,1760000,-85600,1845600,1059553,2024.09.05
52,Truck On Fire,Carly Pearce,723,107,616,95,0,1671800,283100,1388700,1239966,2024.09.05
53,Love The Leavin',Drew Parker,488,85,403,72,0,1539700,361500,1178200,90932,2024.09.05
54,Hometown Home,Locash,832,8,824,90,0,1515200,5000,1510200,83308,2024.09.05
55,4x4xu,Lainey Wilson,495,348,147,71,0,1440500,1030400,410100,3051553,2024.09.05
56,Country Back,Randy Houser,739,-53,792,81,0,1289400,-123200,1412600,25660,2024.09.05
57,Single Again,Josh Ross,811,73,738,102,0,1194000,157500,1036500,2425764,2024.09.05
58,Over When We'Re Sober,Brantley Gilbert,519,23,496,73,0,1172200,18500,1153700,676997,2024.09.05
59,Everything I Need,Chayce Beckham,562,45,517,65,0,1018700,117300,901400,257853,2024.09.05
60,SIX FEET UNDER (Caleigh's Song),Hardy,544,-111,655,89,0,1007100,-159700,1166800,731985,2024.09.05
61,This Heart,Corey Kent,544,11,533,60,0,962000,107000,855000,842132,2024.09.05
62,Bones,Russell Dickerson,551,65,486,86,0,863400,138700,724700,1528912,2024.09.05
63,Country House,Sam Hunt,514,-8,522,82,0,848000,-47400,895400,265427,2024.09.05
64,Devil You Know,Tyler Braden,409,45,364,46,0,804000,-19900,823900,4846630,2024.09.05
65,Park,Tyler Hubbard,407,-3,410,70,0,715800,-40600,756400,970291,2024.09.05
66,Heavens To Betsy,Jackson Dean,413,30,383,81,0,647100,106600,540500,214451,2024.09.05
67,I Could Be That Rain,Randall King,294,13,281,40,0,619800,-37500,657300,103980,2024.09.05
68,Strangers,Kameron Marlowe & Ella Langley,377,4,373,47,0,476900,-24600,501500,1061758,2024.09.05
69,Never Been Over,Darius Rucker,347,19,328,51,0,443600,-89000,532600,177214,2024.09.05
70,Pink Skies,Zach Bryan,159,-24,183,8,0,387800,-66200,454000,16650939,2024.09.05
71,Relapse,Warren Zeiders,262,27,235,37,0,326500,73500,253000,4069366,2024.09.05
72,Wine Into Whiskey,Tucker Wetmore,47,23,24,3,0,305300,184400,120900,5374372,2024.09.05
73,Worst Way,Riley Green,30,0,30,2,0,293600,-14300,307900,4464657,2024.09.05
74,Beatles And Eagles,Frontmen,215,2,213,28,0,284300,-32000,316300,1213,2024.09.05
75,Pray All The Way Home,Austin Snell,136,-10,146,21,0,270200,-43700,313900,766350,2024.09.05
76,Out Of Oklahoma,Lainey Wilson,50,-69,119,10,0,267300,-223100,490400,3496350,2024.09.05
77,Baby Daddy's Weekend,Elle King,245,18,227,36,0,263300,29700,233600,29266,2024.09.05
78,Acres,Brian Kelley,270,7,263,50,0,251200,-9400,260600,138923,2024.09.05
79,Not Today,Mitchell Tenpenny,275,26,249,51,0,240200,25200,215000,205941,2024.09.05
80,Bury Me In This Bar,Dalton Dover,173,-84,257,43,0,239500,-103800,343300,15811,2024.09.05
81,Things I Take For Granted,Larry Fleet,164,-14,178,27,0,233500,-7300,240800,590975,2024.09.05
82,The Devil I Know,Ashley McBryde,88,-74,162,14,0,211800,-127700,339500,167604,2024.09.05
83,Girl In The Mirror,Megan Moroney,40,-40,80,40,0,172400,-109900,282300,502682,2024.09.05
84,I Never Lie,Zach Top,16,14,2,3,0,172000,132200,39800,4077001,2024.09.05
85,How Is She,Cole Swindell,22,0,22,1,0,165600,18200,147400,44083,2024.09.05
86,Songs About Whiskey,Anne Wilson,116,-4,120,19,0,163200,-37600,200800,160439,2024.09.05
87,I Got A Problem,Drake Milligan,57,6,51,5,0,155600,49200,106400,57524,2024.09.05
88,Cozy,Braxton Keith,22,1,21,2,0,131800,10200,121600,1187416,2024.09.05
89,Good On You,Priscilla Block,108,-14,122,19,0,124100,-37300,161400,382101,2024.09.05
90,Wrong Ones,Post Malone,41,-6,47,4,0,115100,14700,100400,4952829,2024.09.05
91,Spin You Around (1/24),Morgan Wallen,34,2,32,4,0,97500,-8400,105900,5172062,2024.09.05
92,New To Country,Bailey Zimmerman,23,1,22,2,0,93900,4700,89200,2036111,2024.09.05
93,Steal My Thunder,Conner Smith,16,10,6,1,0,92700,52900,39800,1079667,2024.09.05
94,What Could Go Right,Thomas Rhett,37,37,0,23,0,88900,88900,0,400212,2024.09.05
95,Break Mine,Brothers Osborne,41,1,40,5,0,86300,-10000,96300,343844,2024.09.05
96,Losers,Post Malone,21,4,17,5,0,85000,1900,83100,8354565,2024.09.05
97,Georgia Is Yours,Sugarland,48,48,0,48,0,83000,83000,0,31407,2024.09.05
98,The Straw,Kassi Ashton,48,0,48,48,0,83000,6300,76700,27740,2024.09.05
99,Broadway Girls,Lil Durk Feat. Morgan Wallen,17,2,15,3,0,73200,14200,59000,5583958,2024.09.05
100,American Nights,Zach Bryan,31,-6,37,1,0,71000,-9100,80100,4836386,2024.09.05
101,Finer Things,Post Malone,10,-6,16,2,0,61200,-18400,79600,3179148,2024.09.05
102,'98 Braves,Morgan Wallen,8,4,4,4,0,60100,31800,28300,1522109,2024.09.05
103,Grandpa (Tell Me 'Bout The Good Old Days),Cody Johnson,3,2,1,1,0,55900,36000,19900,0,2024.09.05
104,Fool,Thomas Rhett,18,17,1,18,0,54400,51600,2800,534353,2024.09.05
105,The Star-Spangled Banner,Chris Stapleton,12,-4,16,11,0,50400,-12700,63100,85139,2024.09.05
106,After All The Bars Are Closed,Thomas Rhett,20,-1,21,18,0,49800,-72700,122500,2077797,2024.09.05
107,Church,Thomas Rhett,20,-19,39,18,0,49600,-168700,218300,441418,2024.09.05
108,King Of Country Music,Ryan Larkins,17,-10,27,5,0,49000,-12100,61100,7649,2024.09.05
109,Would If I Could (Feat. Lainey Wilson),Ernest,22,5,17,18,0,48700,22100,26600,530034,2024.09.05
110,Good News Sold,Jordan Davis,9,9,0,9,0,48200,48200,0,235300,2024.09.05
111,Back To Blue,Thomas Rhett,19,19,0,17,0,46300,46300,0,369377,2024.09.05
111,Country For California,Thomas Rhett,19,19,0,17,0,46300,46300,0,341885,2024.09.05
111,Can't Love You Anymore,Thomas Rhett,19,19,0,17,0,46300,46300,0,584848,2024.09.05
114,Somethin' 'Bout A Woman,Thomas Rhett,19,-78,97,17,0,46300,-218400,264700,1162396,2024.09.05
115,Oklahoma Sooner,Jake Banfield,11,0,11,1,0,45700,9100,36600,2029,2024.09.05
116,Nosedive,Post Malone,8,-1,9,2,0,43500,-17100,60600,4561595,2024.09.05
117,Good Horses,Lainey Wilson,14,-46,60,3,0,41900,-136900,178800,1824905,2024.09.05
118,Golden Child,Meghan Patrick,33,29,4,7,0,41600,32100,9500,90,2024.09.05
119,Overdrive,Thomas Rhett,17,17,0,17,0,40300,40300,0,985580,2024.09.05
120,Gone Country,Thomas Rhett,17,-29,46,17,0,40300,-221300,261600,1452958,2024.09.05
121,Devil Don't Know,Morgan Wallen,4,4,0,2,0,40200,40200,0,570068,2024.09.05
122,Mint Tea,Johnny Blue Skies,16,7,9,1,0,40100,25800,14300,0,2024.09.05
123,Man Upstairs,Tim Dugger,9,-2,11,1,0,38600,-9700,48300,4112,2024.09.05
124,Ain't That Some,Morgan Wallen,3,2,1,2,0,38300,29800,8500,4001956,2024.09.05
125,Nine Ball,Zach Bryan,2,0,2,1,0,37900,12400,25500,4180674,2024.09.05
126,Boots,Thomas Rhett,16,-42,58,16,0,37800,-66600,104400,286108,2024.09.05
127,Days That End In Why,Morgan Wallen,7,0,7,2,0,37600,29900,7700,610284,2024.09.05
128,Wondering Why,Red Clay Strays,12,-21,33,3,0,37400,-31200,68600,4418325,2024.09.05
129,Hell Is A Dance Floor,Vincent Mason,16,16,0,16,0,37200,37200,0,1819554,2024.09.05
130,Feelin' Country,Thomas Rhett,6,6,0,2,0,36900,36900,0,693400,2024.09.05
131,John Deere Green,"HIXTAPE Feat. HARDY, Morgan Wallen, Joe Diffie",6,6,0,3,0,34700,34700,0,0,2024.09.05
132,Where That Came From,Randy Travis,7,2,5,2,0,34700,10700,24000,361121,2024.09.05
133,I Could Spend Forever Loving You,Thomas Rhett,15,15,0,15,0,34300,34300,0,320438,2024.09.05
134,Don't Wanna Dance,Thomas Rhett,15,12,3,15,0,34300,4700,29600,296366,2024.09.05
135,180 (Lifestyle),Morgan Wallen,3,3,0,1,0,34000,34000,0,1308845,2024.09.05
136,California Sober,Post Malone,17,-9,26,1,0,33900,-44600,78500,4796292,2024.09.05
137,Liar,Jelly Roll,11,0,11,3,0,33800,5500,28300,3582201,2024.09.05
138,Work Boots,Cody Johnson,2,0,2,1,0,33500,-4400,37900,211541,2024.09.05
139,Don't Think Jesus,Morgan Wallen,3,3,0,1,0,31700,31700,0,755702,2024.09.05
140,Keith Whitley,Morgan Wallen,3,3,0,2,0,31400,31400,0,465947,2024.09.05
141,Leave A Light On (Talk Away The Dark),Papa Roach & Carrie Underwood,5,2,3,1,0,28500,13000,15500,558206,2024.09.05
142,Honky Tonk Hall Of Fame,George Strait & Chris Stapleton,2,2,0,1,0,27200,27200,0,0,2024.09.05
143,28,Zach Bryan,9,7,2,1,0,26700,21700,5000,11248223,2024.09.05
144,Cowboys And Dreamers,George Strait,2,2,0,1,0,26300,26300,0,280,2024.09.05
145,Running Out Of Time,Wyatt Flores,7,-2,9,1,0,25900,-26200,52100,584786,2024.09.05
146,Quittin' Time,Zach Bryan,2,1,1,1,0,25500,23700,1800,1092524,2024.09.05
147,When My Baby's In Boots,Randall King,2,0,2,1,0,25500,2000,23500,0,2024.09.05
148,"Salt, Lime & Tequila",Ryan Griffin,4,1,3,1,0,25400,15100,10300,63042,2024.09.05
149,Yours,Post Malone,13,-4,17,2,0,25300,-15300,40600,3183961,2024.09.05
150,Song While You'Re Away,Tyler Childers,11,4,7,2,0,24100,15300,8800,626397,2024.09.05
151,That's Texas,Cody Johnson,3,1,2,2,0,23500,-10000,33500,196687,2024.09.05
152,Baby Do,Randall King,1,1,0,1,0,19900,19900,0,15390,2024.09.05
153,A Little Bit Closer,Braxton Keith,1,0,1,1,0,19900,18100,1800,243913,2024.09.05
154,Dive,Luke Combs,1,0,1,1,0,19900,6300,13600,1148584,2024.09.05
155,Neon Cowgirl,Dan + Shay,1,0,1,1,0,19900,0,19900,85715,2024.09.05
156,Open The Gate,Zach Bryan,1,-1,2,1,0,19900,-1800,21700,1814258,2024.09.05
157,Sunrise,Morgan Wallen,2,2,0,1,0,19700,19700,0,2557416,2024.09.05
158,Parallel Love,Brad Tursi,4,4,0,4,0,19400,19400,0,1509,2024.09.05
159,Two Steppin' On The Moon,Josh Turner,4,2,2,4,0,19400,10100,9300,276676,2024.09.05
160,Better Than You,Joe Nichols & Annie Bosko,10,10,0,1,0,19300,19300,0,0,2024.09.05
161,Be Ready,Karen Peck & New River,3,2,1,3,0,19300,13100,6200,5577,2024.09.05
162,Change The Game,Cody Jinks,6,-3,9,2,0,19000,-16700,35700,72175,2024.09.05
163,Tennessee Numbers,Morgan Wallen,2,2,0,1,0,18800,18800,0,531934,2024.09.05
163,Neon Star (Country Boy Lullaby),Morgan Wallen,2,2,0,1,0,18800,18800,0,1251936,2024.09.05
163,Whiskey Friends,Morgan Wallen,2,2,0,1,0,18800,18800,0,1126731,2024.09.05
163,F150-50,Morgan Wallen,2,2,0,1,0,18800,18800,0,575402,2024.09.05
163,Outlook,Morgan Wallen,2,2,0,1,0,18800,18800,0,531705,2024.09.05
168,I Wrote The Book,Morgan Wallen,2,1,1,1,0,18800,14600,4200,2713044,2024.09.05
169,Whiskey Bent,Cody Johnson,1,1,0,1,0,18000,18000,0,716369,2024.09.05
170,Lonely Road,mgk & Jelly Roll,4,1,3,3,0,16800,11000,5800,7345253,2024.09.05
171,Dance Like No One’s Watching,Gabby Barrett,26,-17,43,4,0,16600,-9000,25600,180105,2024.09.05
172,The Things We Cannot Change,LeFevre Quartet,2,0,2,2,0,16100,4300,11800,4192,2024.09.05
173,Me + All Your Reasons,Morgan Wallen,1,1,0,1,0,15200,15200,0,931750,2024.09.05
173,You Wreck Me,George Strait,1,1,0,1,0,15200,15200,0,8511,2024.09.05
175,You'll Always Be My Baby (Written For Daughters' Weddings),Alan Jackson,8,2,6,1,0,14700,-2900,17600,47657,2024.09.05
176,Any Given Friday Night,Luke Combs,2,0,2,1,0,14600,0,14600,183245,2024.09.05
177,Fourteen Gears,Sydney Irving,16,16,0,16,0,13600,13600,0,0,2024.09.05
178,Fiddle In The Band,Kane Brown,1,-2,3,1,0,13600,-25500,39100,270070,2024.09.05
179,You'D Think I Was A Cowboy,Dylan Scott,3,3,0,2,0,13300,13300,0,2146950,2024.09.05
180,Middle Of Nowhere,Southbound,2,1,1,2,0,13100,5600,7500,4322,2024.09.05
181,Fall Into Place,Jeff & Sheri Easter,2,0,2,2,0,13100,-2400,15500,3193,2024.09.05
182,Neon Baby,Annie Bosko,8,3,5,1,0,12800,4800,8000,13233,2024.09.05
183,Hole In The Heart,Nelons,2,0,2,2,0,12300,-800,13100,0,2024.09.05
184,Goes Without Saying,Post Malone,2,-2,4,2,0,12200,2400,9800,2602826,2024.09.05
185,Third Rock From The Sun,"HIXTAPE & Joe Diffie Feat. Brooks & Dunn, Blake Shelton & HARDY",1,1,0,1,0,12000,12000,0,0,2024.09.05
185,Tennessee Fan,Morgan Wallen,1,1,0,1,0,12000,12000,0,945440,2024.09.05
185,Good Girl Gone Missin',Morgan Wallen,1,1,0,1,0,12000,12000,0,976384,2024.09.05
185,Now Or Never,Corey Kent,1,1,0,1,0,12000,12000,0,1088029,2024.09.05
189,Help Is On The Way,Gold City,2,0,2,2,0,11800,0,11800,15006,2024.09.05
190,Young Man,Greylan James,17,4,13,3,0,11700,2000,9700,32084,2024.09.05
191,Roulette On The Heart,Conner Smith,12,0,12,4,0,11700,-4400,16100,398912,2024.09.05
192,Three Drinks Behind,George Strait,1,0,1,1,0,11400,0,11400,265448,2024.09.05
192,Mia Down In Mia,George Strait,1,0,1,1,0,11400,0,11400,155661,2024.09.05
194,How 'Bout Those Chiefs,Blane Howard,2,2,0,1,0,10600,10600,0,2249,2024.09.05
195,Right About You,Post Malone,1,1,0,1,0,9900,9900,0,1758829,2024.09.05
195,5 Leaf Clover,Luke Combs,1,1,0,1,0,9900,9900,0,1120595,2024.09.05
195,Great Is Thy Faithfulness,Carrie Underwood Feat. Cece Winans,1,1,0,1,0,9900,9900,0,89107,2024.09.05
198,Red Words,Erwins,1,0,1,1,0,9900,2400,7500,7388,2024.09.05
198,Sunday Sermons,Anne Wilson,1,0,1,1,0,9900,2400,7500,469511,2024.09.05
200,Hit The Hay Runnin',Aaron Watson,2,1,1,2,0,9100,7300,1800,115688,2024.09.05
201,Oklahoma Smokeshow,Zach Bryan,3,-3,6,1,0,9100,-6600,15700,6936665,2024.09.05
1,Chevrolet,Dustin Lynch Feat. Jelly Roll,8336,932,7404,145,0,30088600,2809400,27279200,3060632,2024.09.12
2,I Had Some Help,Post Malone,6365,-50,6415,145,0,27303900,-173300,27477200,24381107,2024.09.12
3,A Bar Song (Tipsy),Shaboozey,6684,-190,6874,141,0,27224400,-949800,28174200,29651804,2024.09.12
4,Ain't No Love In Oklahoma (From Twisters: The Album),Luke Combs,7558,480,7078,145,0,27095300,1498700,25596600,14237348,2024.09.12
5,Cowgirls,Morgan Wallen,5646,-215,5861,144,0,23327100,-924200,24251300,13088073,2024.09.12
6,Pour Me A Drink,Post Malone,6327,784,5543,145,0,22332000,2307000,20025000,7734429,2024.09.12
7,Miles On It,Marshmello & Kane Brown,5762,974,4788,144,0,20784300,3331100,17453200,11451072,2024.09.12
8,"Love You, Miss You, Mean It",Luke Bryan,5946,49,5897,145,0,20164600,182800,19981800,2856002,2024.09.12
9,This Is My Dirt,Justin Moore,5841,387,5454,145,0,19292900,1234400,18058500,567394,2024.09.12
10,Young Love & Saturday Nights,Chris Young,5224,-2262,7486,145,0,18509900,-6488100,24998000,559080,2024.09.12
11,I Am Not Okay,Jelly Roll,4951,573,4378,145,0,16952600,2186200,14766400,10867365,2024.09.12
12,Austin,Dasha,4500,90,4410,143,0,15040400,-51500,15091900,10892121,2024.09.12
13,Gonna Love You,Parmalee,4289,225,4064,145,0,14069400,773400,13296000,362248,2024.09.12
14,Lies Lies Lies,Morgan Wallen,3952,588,3364,145,0,13859300,1669400,12189900,15295520,2024.09.12
15,One Bad Habit,Tim McGraw,4126,41,4085,145,0,13262600,314400,12948200,469367,2024.09.12
16,Beautiful As You,Thomas Rhett,3789,353,3436,145,0,12414300,824500,11589800,3588916,2024.09.12
17,Messed Up As Me,Keith Urban,3349,126,3223,144,0,9152500,163000,8989500,1414213,2024.09.12
18,Cowboy Songs,George Birge,2770,343,2427,141,0,8513200,1555300,6957900,637526,2024.09.12
19,Think I’m In Love With You,Chris Stapleton,2553,204,2349,142,0,8451200,1129100,7322100,5387635,2024.09.12
20,Sounds Like The Radio,Zach Top,2843,224,2619,142,0,8280200,600600,7679600,1639960,2024.09.12
21,Bigger Houses,Dan + Shay,2719,42,2677,144,0,8066300,152500,7913800,911913,2024.09.12
22,Damn Good Day To Leave,Riley Green,2776,142,2634,145,0,7461000,369300,7091700,1327079,2024.09.12
23,You Look Like You Love Me,Ella Langley & Riley Green,2188,700,1488,140,0,7067500,1901000,5166500,8677104,2024.09.12
24,Wind Up Missin' You,Tucker Wetmore,2198,267,1931,142,0,6938400,825300,6113100,5326129,2024.09.12
25,American Girl,Dierks Bentley,2260,188,2072,142,0,6878900,550900,6328000,170123,2024.09.12
26,High Road,Koe Wetzel,1672,179,1493,101,0,5846900,706000,5140900,9168695,2024.09.12
27,Boys Back Home,Dylan Marlowe Feat. Dylan Scott,2024,164,1860,141,0,5714500,706800,5007700,2107954,2024.09.12
28,Just To Say We Did,Kenny Chesney,1251,79,1172,126,0,4095500,222400,3873100,421069,2024.09.12
29,Breakin' In Boots,Matt Stell,1852,229,1623,140,0,4048000,595600,3452400,201885,2024.09.12
30,Guy For That,Post Malone,1188,268,920,116,0,3842100,1029600,2812500,10100628,2024.09.12
31,Friends Like That,John Morgan Feat. Jason Aldean,1481,61,1420,105,0,3828500,167400,3661100,793633,2024.09.12
32,Find Another Bar,Chris Lane,1602,-9,1611,138,0,3602400,58400,3544000,78411,2024.09.12
33,This Town's Been Too Good To Us,Dylan Scott,1594,248,1346,132,0,3555900,559700,2996200,1955636,2024.09.12
34,Friday Night Heartbreaker,Jon Pardi,840,840,0,106,0,3347800,3347800,0,1320038,2024.09.12
35,Whatcha See Is Whatcha Get,Chris Janson,1443,102,1341,141,0,3279600,240700,3038900,118105,2024.09.12
36,Called Crazy,Kassi Ashton,973,50,923,102,0,3076900,34600,3042300,467968,2024.09.12
37,I Ain'T Sayin',Jordan Davis,1142,83,1059,106,0,3061900,363400,2698500,2485830,2024.09.12
38,Forever To Me,Cole Swindell,1099,-20,1119,98,0,2861800,119600,2742200,705306,2024.09.12
39,Wranglers,Miranda Lambert,1377,5,1372,131,0,2774800,-71600,2846400,1238223,2024.09.12
40,4x4xu,Lainey Wilson,922,427,495,90,0,2702500,1262000,1440500,4111461,2024.09.12
41,Holy Smokes,Bailey Zimmerman,872,149,723,73,0,2567400,566800,2000600,4181815,2024.09.12
42,Life With You,Kelsey Hart,1264,-12,1276,114,0,2523800,-75300,2599100,1156972,2024.09.12
43,Coming Home,Old Dominion,1032,195,837,119,0,2344700,182100,2162600,2602718,2024.09.12
44,Am I Okay?,Megan Moroney,704,89,615,71,0,2243100,378000,1865100,5968902,2024.09.12
45,I Tried A Ring On,Tigirlily Gold,1346,79,1267,142,0,2194500,148800,2045700,1097804,2024.09.12
46,Tie Up,Zac Brown Band,1129,13,1116,121,0,1938700,149200,1789500,562103,2024.09.12
47,Whiskey Drink,Jason Aldean,869,44,825,92,0,1919000,159000,1760000,803191,2024.09.12
48,Fall Of Summer,Scotty McCreery,905,7,898,99,0,1770200,-68400,1838600,413902,2024.09.12
49,Cowboys Cry Too,Kelsea Ballerini,1023,35,988,128,0,1763600,-28600,1792200,3205664,2024.09.12
50,Hometown Home,Locash,890,58,832,90,0,1751100,235900,1515200,78660,2024.09.12
51,Drinkin' Buddies,"Lee Brice, Hailey Whitters, And Nate Smith",645,-83,728,92,0,1751000,-303200,2054200,240799,2024.09.12
52,Truck On Fire,Carly Pearce,753,30,723,95,0,1747700,75900,1671800,1136968,2024.09.12
53,Country Back,Randy Houser,807,68,739,82,0,1370400,81000,1289400,23476,2024.09.12
54,Single Again,Josh Ross,839,28,811,102,0,1237700,43700,1194000,2384191,2024.09.12
55,Over When We'Re Sober,Brantley Gilbert,566,47,519,79,0,1182300,10100,1172200,630241,2024.09.12
56,Everything I Need,Chayce Beckham,607,45,562,76,0,1169300,150600,1018700,229119,2024.09.12
57,Love The Leavin',Drew Parker,408,-80,488,23,0,1126700,-413000,1539700,96597,2024.09.12
58,This Heart,Corey Kent,587,43,544,65,0,1066200,104200,962000,810814,2024.09.12
59,Devil You Know,Tyler Braden,429,20,409,45,0,982500,178500,804000,4604328,2024.09.12
60,Bones,Russell Dickerson,575,24,551,92,0,875500,12100,863400,1324108,2024.09.12
61,Country House,Sam Hunt,539,25,514,75,0,872100,24100,848000,239957,2024.09.12
62,Park,Tyler Hubbard,470,63,407,70,0,828400,112600,715800,910336,2024.09.12
63,Heavens To Betsy,Jackson Dean,439,26,413,70,0,703300,56200,647100,436206,2024.09.12
64,I Could Be That Rain,Randall King,307,13,294,40,0,654300,34500,619800,97269,2024.09.12
65,Strangers,Kameron Marlowe & Ella Langley,380,3,377,48,0,567800,90900,476900,1122724,2024.09.12
66,Never Been Over,Darius Rucker,352,5,347,52,0,521800,78200,443600,158735,2024.09.12
67,Pink Skies,Zach Bryan,160,1,159,7,0,393900,6100,387800,16340307,2024.09.12
68,Relapse,Warren Zeiders,300,38,262,38,0,369300,42800,326500,3722890,2024.09.12
69,I Never Lie,Zach Top,37,21,16,2,0,343300,171300,172000,4219884,2024.09.12
70,Worst Way,Riley Green,34,4,30,2,0,340400,46800,293600,4406009,2024.09.12
71,Honky Tonk Heartbreaker,Dustin Lynch,77,77,0,40,0,334800,334800,0,24695,2024.09.12
72,Beatles And Eagles,Frontmen,230,15,215,29,0,322300,38000,284300,1121,2024.09.12
73,Pray All The Way Home,Austin Snell,147,11,136,23,0,301000,30800,270200,754609,2024.09.12
74,The Bobby Bones Show Theme Song,Reid Yarberry,58,58,0,56,0,280800,280800,0,504,2024.09.12
75,Wine Into Whiskey,Tucker Wetmore,44,-3,47,2,0,276800,-28500,305300,5102001,2024.09.12
76,Not Today,Mitchell Tenpenny,302,27,275,51,0,244000,3800,240200,197705,2024.09.12
77,Bury Me In This Bar,Dalton Dover,148,-25,173,22,0,241200,1700,239500,14394,2024.09.12
78,Things I Take For Granted,Larry Fleet,158,-6,164,25,0,236100,2600,233500,550868,2024.09.12
79,I Got A Problem,Drake Milligan,64,7,57,6,0,228000,72400,155600,65457,2024.09.12
80,Wrong Ones,Post Malone,71,30,41,21,0,197500,82400,115100,4172500,2024.09.12
81,Songs About Whiskey,Anne Wilson,118,2,116,19,0,196600,33400,163200,142623,2024.09.12
82,Baby Daddy's Weekend,Elle King,180,-65,245,34,0,183200,-80100,263300,26393,2024.09.12
83,The Devil I Know,Ashley McBryde,69,-19,88,10,0,169800,-42000,211800,143670,2024.09.12
84,Good On You,Priscilla Block,109,1,108,17,0,155400,31300,124100,406298,2024.09.12
85,Golden Child,Meghan Patrick,87,54,33,26,0,128700,87100,41600,116083,2024.09.12
86,Losers,Post Malone,45,24,21,5,0,118400,33400,85000,7772461,2024.09.12
87,How Is She,Cole Swindell,17,-5,22,1,0,118100,-47500,165600,39669,2024.09.12
88,Cozy,Braxton Keith,22,0,22,3,0,116800,-15000,131800,1269523,2024.09.12
89,New To Country,Bailey Zimmerman,24,1,23,2,0,99800,5900,93900,1961920,2024.09.12
90,Acres,Brian Kelley,91,-179,270,22,0,98000,-153200,251200,108656,2024.09.12
91,Finer Things,Post Malone,19,9,10,3,0,94900,33700,61200,2599329,2024.09.12
92,Break Mine,Brothers Osborne,37,-4,41,4,0,92100,5800,86300,313052,2024.09.12
93,The Star-Spangled Banner,Chris Stapleton,19,7,12,16,0,88300,37900,50400,92579,2024.09.12
94,Wondering Why,Red Clay Strays,25,13,12,4,0,88200,50800,37400,4116307,2024.09.12
95,American Nights,Zach Bryan,36,5,31,1,0,80000,9000,71000,4637716,2024.09.12
96,First Rodeo,Sarahbeth Taite,48,48,0,48,0,76700,76700,0,1252,2024.09.12
97,One Too Many,Maggie Antone,16,16,0,15,0,74400,74400,0,104356,2024.09.12
98,Young Man,Greylan James,27,10,17,3,0,71700,60000,11700,33210,2024.09.12
99,Spin You Around (1/24),Morgan Wallen,24,-10,34,3,0,70700,-26800,97500,4810536,2024.09.12
100,Girl In The Mirror,Megan Moroney,15,-25,40,15,0,69900,-102500,172400,534182,2024.09.12
101,Go To Hell,Post Malone,4,4,0,1,0,65300,65300,0,627057,2024.09.12
102,My July,Jayson Arendt,21,21,0,21,0,59700,59700,0,2856,2024.09.12
103,Broadway Girls,Lil Durk Feat. Morgan Wallen,14,-3,17,2,0,57200,-16000,73200,5170630,2024.09.12
104,Better Than You,Joe Nichols & Annie Bosko,23,13,10,5,0,53100,33800,19300,0,2024.09.12
105,Crazy Life,Brad Tursi,9,9,0,9,0,49800,49800,0,465,2024.09.12
106,The Little Things,George Strait,6,6,0,6,0,48600,48600,0,487500,2024.09.12
107,Oklahoma Sooner,Jake Banfield,11,0,11,1,0,42600,-3100,45700,2155,2024.09.12
108,King Of Country Music,Ryan Larkins,8,-9,17,3,0,42600,-6400,49000,7420,2024.09.12
109,Honky Tonk Hall Of Fame,George Strait & Chris Stapleton,5,3,2,5,0,41400,14200,27200,1905497,2024.09.12
110,Mia Down In Mia,George Strait,4,3,1,3,0,40300,28900,11400,405828,2024.09.12
111,Cowboys And Dreamers,George Strait,6,4,2,4,0,38600,12300,26300,509976,2024.09.12
112,Work Boots,Cody Johnson,2,0,2,1,0,37900,4400,33500,212426,2024.09.12
113,Mint Tea,Johnny Blue Skies,13,-3,16,1,0,35000,-5100,40100,0,2024.09.12
114,Darlin',Chase Matthew,22,19,3,20,0,34400,30200,4200,3357014,2024.09.12
115,Leave A Light On (Talk Away The Dark),Papa Roach & Carrie Underwood,5,0,5,1,0,34100,5600,28500,574931,2024.09.12
116,Where That Came From,Randy Travis,4,-3,7,2,0,34100,-600,34700,326209,2024.09.12
117,Liar,Jelly Roll,11,0,11,2,0,31800,-2000,33800,3152797,2024.09.12
118,Man Upstairs,Tim Dugger,8,-1,9,1,0,30000,-8600,38600,3126,2024.09.12
119,Steal My Thunder,Conner Smith,7,-9,16,1,0,29300,-63400,92700,951954,2024.09.12
120,California Sober,Post Malone,13,-4,17,2,0,27900,-6000,33900,3036165,2024.09.12
121,Goes Without Saying,Post Malone,4,2,2,2,0,27500,15300,12200,1971845,2024.09.12
122,Just Like Johnny,Redferrin,29,19,10,8,0,25000,18000,7000,3425204,2024.09.12
123,Grandpa (Tell Me 'Bout The Good Old Days),Cody Johnson,2,-1,3,1,0,23600,-32300,55900,103,2024.09.12
124,Whiskey Bent,Cody Johnson,3,2,1,2,0,23500,5500,18000,612605,2024.09.12
125,Open The Gate,Zach Bryan,2,1,1,1,0,21700,1800,19900,1817523,2024.09.12
126,Nine Ball,Zach Bryan,2,0,2,1,0,21700,-16200,37900,4024613,2024.09.12
127,Fiddle In The Band,Kane Brown,8,7,1,1,0,21200,7600,13600,313925,2024.09.12
128,Oklahoma Smokeshow,Zach Bryan,6,3,3,3,0,20800,11700,9100,6630352,2024.09.12
129,Messed Around,Huser Brother Band,1,1,0,1,0,19900,19900,0,1490,2024.09.12
129,Lovin' Where It's Goin',Josh Ward,1,1,0,1,0,19900,19900,0,32117,2024.09.12
129,Gettin' By,Flatland Cavalry,1,1,0,1,0,19900,19900,0,119740,2024.09.12
129,Single At The Same Time,Jake Worthington,1,1,0,1,0,19900,19900,0,4014,2024.09.12
133,Quittin' Time,Zach Bryan,1,-1,2,1,0,19900,-5600,25500,1028840,2024.09.12
133,When My Baby's In Boots,Randall King,1,-1,2,1,0,19900,-5600,25500,0,2024.09.12
135,Be Ready,Karen Peck & New River,3,0,3,3,0,19300,0,19300,5406,2024.09.12
136,Back To Texas,Post Malone,1,1,0,1,0,18000,18000,0,606945,2024.09.12
137,"Salt, Lime & Tequila",Ryan Griffin,4,0,4,1,0,17500,-7900,25400,53689,2024.09.12
138,You'll Always Be My Baby (Written For Daughters' Weddings),Alan Jackson,6,-2,8,1,0,17400,2700,14700,44227,2024.09.12
139,Train Of Thought,Vincent Mason,4,4,0,1,0,17100,17100,0,0,2024.09.12
140,28,Zach Bryan,9,0,9,2,0,17000,-9700,26700,11754459,2024.09.12
141,Roulette On The Heart,Conner Smith,18,6,12,4,0,16300,4600,11700,354687,2024.09.12
142,Country's Cool Again,Lainey Wilson,6,6,0,6,0,15700,15700,0,419238,2024.09.12
143,Ring Finger,Lainey Wilson,6,5,1,6,0,15700,12100,3600,349046,2024.09.12
144,Change The Game,Cody Jinks,3,-3,6,3,0,15700,-3300,19000,67451,2024.09.12
145,Hung Up On You,Bryce Leatherwood,4,4,0,4,0,15600,15600,0,77327,2024.09.12
146,That's Texas,Cody Johnson,2,-1,3,1,0,15400,-8100,23500,194245,2024.09.12
147,Wish I Could Say,George Strait,1,1,0,1,0,15200,15200,0,400276,2024.09.12
147,People Get Hurt Sometimes,George Strait,1,1,0,1,0,15200,15200,0,289640,2024.09.12
147,Waymore's Blues,George Strait,1,1,0,1,0,15200,15200,0,306473,2024.09.12
147,Calling From The Car,George Strait,1,1,0,1,0,15200,15200,0,329882,2024.09.12
147,The Book,George Strait,1,1,0,1,0,15200,15200,0,336844,2024.09.12
147,The Journey Of Your Life,George Strait,1,1,0,1,0,15200,15200,0,328532,2024.09.12
147,To The Moon,George Strait,1,1,0,1,0,15200,15200,0,522719,2024.09.12
154,Three Drinks Behind,George Strait,1,0,1,1,0,15200,3800,11400,574581,2024.09.12
155,Any Given Friday Night,Luke Combs,2,0,2,1,0,14600,0,14600,163237,2024.09.12
156,Loud and Heavy,Cody Jinks,7,4,3,2,0,14400,8200,6200,1341639,2024.09.12
157,Small Town Wreck,Shawna Thompson,17,17,0,17,0,13800,13800,0,0,2024.09.12
158,We Are The Church,Ernie Haase & Signature Sound,2,2,0,2,0,13700,13700,0,19796,2024.09.12
159,Come On In,Kingdom Heirs,2,1,1,2,0,13700,7500,6200,7871,2024.09.12
160,Forgiven,Joseph Habedank,2,1,1,2,0,13100,7500,5600,5508,2024.09.12
161,Nosedive,Post Malone,5,-3,8,2,0,12500,-31000,43500,3714026,2024.09.12
162,Star Spangled Banner,Mickey Guyton,2,0,2,2,0,12300,5300,7000,0,2024.09.12
163,Grateful For The Gospel,Brian Free & Assurance,2,1,1,2,0,11800,5600,6200,12696,2024.09.12
163,Wings Of A Dove,Jonathan Wilburn,2,1,1,2,0,11800,5600,6200,0,2024.09.12
165,Help Is On The Way,Gold City,2,0,2,2,0,11800,0,11800,15256,2024.09.12
166,Rent,George Strait,1,1,0,1,0,11400,11400,0,318139,2024.09.12
167,Dive,Luke Combs,2,1,1,1,0,11200,-8700,19900,1110997,2024.09.12
168,Neon Baby,Annie Bosko,6,-2,8,2,0,11200,-1600,12800,14621,2024.09.12
169,Heart Of A Small Town,Tim Dugger,2,1,1,1,0,10900,3500,7400,12834,2024.09.12
170,Dance Like No One’s Watching,Gabby Barrett,25,-1,26,2,0,10500,-6100,16600,186182,2024.09.12
171,John 3:16 Is Calling Out To You,Perrys,1,1,0,1,0,9900,9900,0,1221,2024.09.12
171,What God Can Do,Endless Highway,1,1,0,1,0,9900,9900,0,179,2024.09.12
173,He Sent Him For Me,Inspirations,1,0,1,1,0,9900,2400,7500,0,2024.09.12
173,Red Letter Blueprint,Scotty McCreery,1,0,1,1,0,9900,2400,7500,32003,2024.09.12
173,Here Comes Jesus,Jeff & Sheri Easter,1,0,1,1,0,9900,2400,7500,19760,2024.09.12
176,Sunday Sermons,Anne Wilson,1,0,1,1,0,9900,0,9900,486835,2024.09.12
177,Whiskey Friends,Morgan Wallen,1,-1,2,1,0,9900,-8900,18800,1050312,2024.09.12
178,Yours,Post Malone,6,-7,13,2,0,9600,-15700,25300,2585824,2024.09.12
179,Use Me,Zach Top,3,3,0,2,0,9500,9500,0,1034710,2024.09.12
180,Decoration,Jillian Riscoe,4,-1,5,1,0,9100,2800,6300,6,2024.09.12
181,Hey Driver,Zach Bryan Feat. The War and Treaty,3,1,2,2,0,9000,900,8100,4607180,2024.09.12
182,Certified,Laura Bryna,15,-3,18,1,0,8800,0,8800,994,2024.09.12
183,Alright Right Now,Joe Wodarek,6,3,3,1,0,8400,3000,5400,0,2024.09.12
184,The Good I'Ll Do,Zach Bryan,3,1,2,1,0,8400,800,7600,2281200,2024.09.12
185,Now I Do,Bailey Taylor,6,3,3,1,0,8300,4300,4000,249,2024.09.12
186,Kiss It Goodbye,Morgan Gruber,7,1,6,1,0,8200,-800,9000,413,2024.09.12
187,My Jesus,Anne Wilson,1,1,0,1,0,7500,7500,0,1571415,2024.09.12
187,Friend In Jesus,CAIN,1,1,0,1,0,7500,7500,0,229712,2024.09.12
187,Been With Jesus,Craguns,1,1,0,1,0,7500,7500,0,64,2024.09.12
187,When It's Gone For Good,Gold City,1,1,0,1,0,7500,7500,0,20979,2024.09.12
187,Scars In Heaven,Casting Crowns,1,1,0,1,0,7500,7500,0,409138,2024.09.12
192,Red Words,Erwins,1,0,1,1,0,7500,-2400,9900,7449,2024.09.12
193,Hole In The Heart,Nelons,1,-1,2,1,0,7500,-4800,12300,0,2024.09.12
194,Me Without Beer,Frank Viera,5,4,1,1,0,7400,6000,1400,0,2024.09.12
195,Good Years,Neon Union,1,1,0,1,0,7300,7300,0,29709,2024.09.12
195,Key West & Colorado,Chase Rice,1,1,0,1,0,7300,7300,0,25408,2024.09.12
197,You In A Honky Tonk,Randall King,2,0,2,2,0,7300,3700,3600,333278,2024.09.12
198,Hit The Hay Runnin',Aaron Watson,2,0,2,2,0,7300,-1800,9100,83864,2024.09.12
199,Annabel,49 Winchester,2,2,0,2,0,7200,7200,0,377238,2024.09.12
200,Out Of Oklahoma,Lainey Wilson,3,-47,50,1,0,7200,-260100,267300,3130242,2024.09.12
1,Pour Me A Drink,Post Malone,7634,253,7381,145,0,27910600,1303300,26607300,6203652,2024.10.03
2,"Love You, Miss You, Mean It",Luke Bryan,7710,980,6730,145,0,27052300,3304100,23748200,4810808,2024.10.03
3,Ain't No Love In Oklahoma (From Twisters: The Album),Luke Combs,6963,-1602,8565,145,0,26176700,-4536200,30712900,12458737,2024.10.03
4,Miles On It,Marshmello & Kane Brown,6879,193,6686,144,0,25133600,1181700,23951900,10898279,2024.10.03
5,I Am Not Okay,Jelly Roll,7184,923,6261,145,0,24986400,3353400,21633000,10632196,2024.10.03
6,A Bar Song (Tipsy),Shaboozey,6021,-594,6615,141,0,24738200,-2421900,27160100,26993253,2024.10.03
7,I Had Some Help,Post Malone,5551,-645,6196,145,0,23316000,-2207800,25523800,21452770,2024.10.03
8,This Is My Dirt,Justin Moore,6439,157,6282,145,0,22088300,789800,21298500,584296,2024.10.03
9,Lies Lies Lies,Morgan Wallen,5186,596,4590,145,0,18013100,1899700,16113400,14424581,2024.10.03
10,Gonna Love You,Parmalee,5100,396,4704,145,0,16603600,868200,15735400,386300,2024.10.03
11,Austin,Dasha,4943,110,4833,143,0,16519300,468600,16050700,9024893,2024.10.03
12,You Look Like You Love Me,Ella Langley & Riley Green,3985,759,3226,144,0,14398900,2694100,11704800,7986713,2024.10.03
13,Beautiful As You,Thomas Rhett,4205,112,4093,145,0,13850300,384900,13465400,5776238,2024.10.03
14,One Bad Habit,Tim McGraw,4257,23,4234,145,0,13474700,10100,13464600,399725,2024.10.03
15,Cowboy Songs,George Birge,3740,234,3506,145,0,11520300,1121000,10399300,541272,2024.10.03
16,Bigger Houses,Dan + Shay,3124,172,2952,145,0,9952200,422200,9530000,889219,2024.10.03
17,Messed Up As Me,Keith Urban,3422,-97,3519,144,0,9749900,-725900,10475800,2120188,2024.10.03
18,Think I’m In Love With You,Chris Stapleton,2879,9,2870,143,0,9718900,-125400,9844300,5404877,2024.10.03
19,Sounds Like The Radio,Zach Top,2991,154,2837,143,0,9534400,844000,8690400,1871369,2024.10.03
20,High Road,Koe Wetzel,2762,342,2420,140,0,9200800,1337500,7863300,7788385,2024.10.03
21,I'm Gonna Love You,Cody Johnson,2108,2102,6,138,0,9095500,9065100,30400,6715090,2024.10.03
22,Wind Up Missin' You,Tucker Wetmore,2860,96,2764,144,0,8998300,730700,8267600,5694508,2024.10.03
23,Damn Good Day To Leave,Riley Green,3010,194,2816,145,0,8450300,509300,7941000,933043,2024.10.03
24,Boys Back Home,Dylan Marlowe Feat. Dylan Scott,2530,84,2446,141,0,7806600,395000,7411600,2135261,2024.10.03
25,American Girl,Dierks Bentley,2252,-56,2308,142,0,7365600,-437300,7802900,145567,2024.10.03
26,Guy For That,Post Malone,1718,199,1519,137,0,6267400,684900,5582500,8281644,2024.10.03
27,Breakin' In Boots,Matt Stell,2126,-30,2156,141,0,5187600,-28000,5215600,206523,2024.10.03
28,Friends Like That,John Morgan Feat. Jason Aldean,1826,209,1617,116,0,4482200,355300,4126900,822354,2024.10.03
29,Just To Say We Did,Kenny Chesney,1390,105,1285,128,0,4352200,223100,4129100,359472,2024.10.03
30,4x4xu,Lainey Wilson,1408,170,1238,130,0,4340800,400500,3940300,3132569,2024.10.03
31,This Town's Been Too Good To Us,Dylan Scott,1696,45,1651,139,0,4189500,191500,3998000,2020176,2024.10.03
32,I Ain'T Sayin',Jordan Davis,1482,100,1382,126,0,4114800,268400,3846400,2596677,2024.10.03
33,Find Another Bar,Chris Lane,1793,-106,1899,140,0,4082700,-89300,4172000,78209,2024.10.03
34,Holy Smokes,Bailey Zimmerman,1074,27,1047,74,0,3873500,168700,3704800,4010786,2024.10.03
35,Whatcha See Is Whatcha Get,Chris Janson,1590,-27,1617,142,0,3544000,-155400,3699400,109838,2024.10.03
36,Life With You,Kelsey Hart,1569,227,1342,118,0,3260700,391400,2869300,1159322,2024.10.03
37,Forever To Me,Cole Swindell,1295,134,1161,123,0,3193100,341100,2852000,770782,2024.10.03
38,Wranglers,Miranda Lambert,1507,-9,1516,134,0,3118400,34400,3084000,1085038,2024.10.03
39,Am I Okay?,Megan Moroney,897,40,857,80,0,2961600,20700,2940900,5913976,2024.10.03
40,Whiskey Drink,Jason Aldean,1180,154,1026,112,0,2769800,443600,2326200,915054,2024.10.03
41,Called Crazy,Kassi Ashton,828,-195,1023,91,0,2431100,-472700,2903800,532276,2024.10.03
42,Hometown Home,Locash,1011,-1,1012,94,0,2200300,206000,1994300,59344,2024.10.03
43,Cowboys Cry Too,Kelsea Ballerini,1127,-17,1144,132,0,2176200,-30900,2207100,3148391,2024.10.03
44,Coming Home,Old Dominion,936,-21,957,118,0,2174300,-142000,2316300,2405013,2024.10.03
45,I Tried A Ring On,Tigirlily Gold,1343,36,1307,141,0,2134700,-26900,2161600,1034946,2024.10.03
46,Fall Of Summer,Scotty McCreery,1085,88,997,115,0,2102900,84700,2018200,371905,2024.10.03
47,Truck On Fire,Carly Pearce,886,-21,907,109,0,1931700,-117500,2049200,1021458,2024.10.03
48,Single Again,Josh Ross,972,102,870,104,0,1772800,270800,1502000,2418066,2024.10.03
49,Country Back,Randy Houser,834,-11,845,86,0,1460700,68900,1391800,12893,2024.10.03
50,Everything I Need,Chayce Beckham,726,33,693,72,0,1452800,-42200,1495000,242744,2024.10.03
51,Friday Night Heartbreaker,Jon Pardi,494,-16,510,78,0,1264000,-36900,1300900,764731,2024.10.03
52,Over When We'Re Sober,Brantley Gilbert,620,42,578,83,0,1201500,45900,1155600,732447,2024.10.03
53,Country House,Sam Hunt,575,17,558,75,0,1160900,75800,1085100,240980,2024.10.03
54,This Heart,Corey Kent,590,-18,608,62,0,1153200,5200,1148000,709645,2024.10.03
55,Park,Tyler Hubbard,542,4,538,72,0,1073800,22300,1051500,822298,2024.10.03
56,Bones,Russell Dickerson,602,-35,637,82,0,1050000,-21700,1071700,1264663,2024.10.03
57,Heavens To Betsy,Jackson Dean,569,25,544,83,0,1009300,3400,1005900,394981,2024.10.03
58,What Kinda Man,Parker Mccollum,447,-15,462,66,0,991800,-58000,1049800,829390,2024.10.03
59,Devil You Know,Tyler Braden,456,11,445,45,0,956500,80500,876000,4773027,2024.10.03
60,Love The Leavin',Drew Parker,344,18,326,24,0,775400,74400,701000,77315,2024.10.03
61,Truck Still Works,Brad Paisley,302,-897,1199,60,0,706700,-4234300,4941000,582810,2024.10.03
62,I Never Lie,Zach Top,78,38,40,9,0,594100,416400,177700,5990976,2024.10.03
63,I Could Be That Rain,Randall King,397,21,376,62,0,522400,21100,501300,101728,2024.10.03
64,Relapse,Warren Zeiders,345,-24,369,36,0,498800,-121300,620100,3450296,2024.10.03
65,Not Today,Mitchell Tenpenny,349,64,285,94,0,480200,270400,209800,413595,2024.10.03
66,Strangers,Kameron Marlowe & Ella Langley,369,6,363,46,0,453800,9100,444700,933385,2024.10.03
67,Golden Child,Meghan Patrick,361,119,242,96,0,406600,151800,254800,50941,2024.10.03
68,Worst Way,Riley Green,32,-2,34,2,0,326900,-12400,339300,4548974,2024.10.03
69,Mind Of A Country Boy,Luke Bryan,44,44,0,44,0,282700,282700,0,440118,2024.10.03
70,"Tele-Man (Feat. Vince Gill, Jo)",Ira Dean & Ronnie Dunn,57,57,0,56,0,273100,273100,0,59446,2024.10.03
71,Pink Skies,Zach Bryan,116,-12,128,6,0,267200,-36500,303700,14911384,2024.10.03
72,I Got A Problem,Drake Milligan,78,-6,84,6,0,255200,23200,232000,52332,2024.10.03
73,Better Than You,Joe Nichols & Annie Bosko,123,37,86,36,0,249500,144200,105300,136421,2024.10.03
74,Losers,Post Malone,82,0,82,7,0,239200,2000,237200,4951626,2024.10.03
75,Things I Take For Granted,Larry Fleet,141,-9,150,22,0,197400,-18000,215400,379769,2024.10.03
76,Songs About Whiskey,Anne Wilson,132,-7,139,20,0,179800,900,178900,131430,2024.10.03
77,Young Man,Greylan James,38,10,28,3,0,179200,119400,59800,31580,2024.10.03
78,Beatles And Eagles,Frontmen,203,-20,223,29,0,177900,-7800,185700,1263,2024.10.03
79,Last Night Lonely,Dylan Marlowe,39,39,0,39,0,170100,170100,0,0,2024.10.03
80,Wrong Ones,Post Malone,49,-17,66,3,0,169600,-11200,180800,2336321,2024.10.03
81,Hung Up On You,Bryce Leatherwood,184,69,115,35,0,163700,27000,136700,32937,2024.10.03
82,Iris,Mitchell Tenpenny,38,38,0,38,0,159400,159400,0,199422,2024.10.03
83,The Devil I Know,Ashley McBryde,64,0,64,8,0,158600,-13000,171600,123407,2024.10.03
84,Pray All The Way Home,Austin Snell,83,-56,139,14,0,144200,-127200,271400,784314,2024.10.03
85,Wine Into Whiskey,Tucker Wetmore,26,12,14,4,0,136200,85000,51200,4764749,2024.10.03
86,How Is She,Cole Swindell,14,0,14,1,0,118900,24000,94900,38323,2024.10.03
87,Just Like Johnny,Redferrin,116,20,96,17,0,118800,-1200,120000,3357264,2024.10.03
88,Country Song Came On,Luke Bryan,20,19,1,20,0,116400,107900,8500,764383,2024.10.03
89,Would If I Could,Ernest Feat. Lainey Wilson,63,45,18,24,0,113000,65500,47500,791287,2024.10.03
90,Darlin',Chase Matthew,74,-5,79,18,0,106900,-2200,109100,3096854,2024.10.03
91,Wondering Why,Red Clay Strays,23,1,22,5,0,96000,-17100,113100,4176761,2024.10.03
92,Break Mine,Brothers Osborne,35,-17,52,3,0,94400,-34800,129200,319135,2024.10.03
93,Never Been Over,Darius Rucker,88,-41,129,24,0,94300,-16900,111200,144559,2024.10.03
94,Cozy,Braxton Keith,19,-1,20,2,0,86700,15700,71000,1116966,2024.10.03
95,New To Country,Bailey Zimmerman,28,-2,30,3,0,84600,-12100,96700,1728199,2024.10.03
96,Train Of Thought,Vincent Mason,21,14,7,13,0,84000,27400,56600,0,2024.10.03
97,Good On You,Priscilla Block,84,-6,90,13,0,79500,-41800,121300,325000,2024.10.03
98,Spin You Around (1/24),Morgan Wallen,27,-2,29,3,0,79400,-12200,91600,5001115,2024.10.03
99,King Of Dallas,Abby Anderson,48,48,0,47,0,76500,76500,0,20374,2024.10.03
100,Liar,Jelly Roll,21,5,16,2,0,71900,17700,54200,4914703,2024.10.03
101,Southern And Slow,Luke Bryan,15,15,0,14,0,69100,69100,0,161050,2024.10.03
102,Broadway Girls,Lil Durk Feat. Morgan Wallen,17,-11,28,2,0,68600,-26400,95000,4793679,2024.10.03
103,The Star-Spangled Banner,Chris Stapleton,16,2,14,13,0,67500,16000,51500,74540,2024.10.03
104,Bury Me In This Bar,Dalton Dover,51,-27,78,10,0,67500,-63200,130700,13011,2024.10.03
105,American Nights,Zach Bryan,17,-1,18,1,0,48600,-200,48800,3565054,2024.10.03
106,Fiddle In The Band,Kane Brown,13,-6,19,1,0,45300,-22500,67800,303503,2024.10.03
107,Good News Sold,Jordan Davis,8,8,0,8,0,40900,40900,0,229280,2024.10.03
108,Man Upstairs,Tim Dugger,10,-3,13,1,0,38800,-20400,59200,2552,2024.10.03
109,Work Boots,Cody Johnson,3,1,2,1,0,37200,-700,37900,276651,2024.10.03
110,Kansas,Luke Bryan,8,8,0,8,0,35600,35600,0,1661811,2024.10.03
111,Now Or Never,Corey Kent,11,11,0,1,0,33400,33400,0,2045782,2024.10.03
112,Money On Me,Morgan Wallen,13,13,0,13,0,31600,31600,0,448542,2024.10.03
113,Heart Of A Small Town,Tim Dugger,3,1,2,1,0,27200,14900,12300,9190,2024.10.03
114,Mint Tea,Johnny Blue Skies,12,-3,15,1,0,26000,1300,24700,0,2024.10.03
115,Hippies And Cowboys,Sarah Darling,21,-30,51,17,0,25000,-16400,41400,0,2024.10.03
116,Baby Daddy's Weekend,Elle King,22,-9,31,4,0,22400,-2300,24700,39497,2024.10.03
117,Feelin' Country,Thomas Rhett,6,1,5,2,0,21900,1500,20400,416655,2024.10.03
118,Goes Without Saying,Post Malone,2,1,1,1,0,21700,3700,18000,1099649,2024.10.03
119,Country Right,Dylan Schneider,4,4,0,4,0,21000,21000,0,49154,2024.10.03
120,Record High,Randall King,1,1,0,1,0,19900,19900,0,31451,2024.10.03
120,Messed Around,Huser Brother Band,1,1,0,1,0,19900,19900,0,1388,2024.10.03
120,Follow,William Beckmann,1,1,0,1,0,19900,19900,0,9764,2024.10.03
120,State You Left Me In,Jake Worthington,1,1,0,1,0,19900,19900,0,19835,2024.10.03
120,Loving All Night,Jesse Raub Jr.,1,1,0,1,0,19900,19900,0,822,2024.10.03
120,Back To Texas,Post Malone,1,1,0,1,0,19900,19900,0,338046,2024.10.03
120,Dancin' With The Devil,Josh Ward,1,1,0,1,0,19900,19900,0,8078,2024.10.03
127,Whiskey Bent,Cody Johnson,1,0,1,1,0,19900,18100,1800,596579,2024.10.03
128,Heart Like A Hometown,Keith Urban,7,6,1,7,0,19200,16500,2700,197243,2024.10.03
129,Carhartt,Dylan Schneider,5,4,1,5,0,19200,11900,7300,217740,2024.10.03
130,Greener Pasture,Carter Faith,8,-3,11,1,0,18900,-15600,34500,85203,2024.10.03
131,Loud and Heavy,Cody Jinks,7,0,7,1,0,18500,2900,15600,1317388,2024.10.03
132,Lonely Road,mgk & Jelly Roll,5,4,1,5,0,17500,15300,2200,6898649,2024.10.03
133,Maxed Out,Bayker Blankenship,4,3,1,2,0,17000,13600,3400,3181591,2024.10.03
134,Roulette On The Heart,Conner Smith,13,0,13,3,0,17000,3900,13100,370437,2024.10.03
135,The Good I'Ll Do,Zach Bryan,6,1,5,1,0,16800,7300,9500,2206086,2024.10.03
136,The Straw,Kassi Ashton,9,-31,40,8,0,16400,-156000,172400,26367,2024.10.03
137,Good Ol' Boys,Mae Estes,12,4,8,1,0,16300,5600,10700,24177,2024.10.03
138,Closing Time In California,Luke Bryan,5,5,0,5,0,15700,15700,0,275667,2024.10.03
139,Let 'Em Talk,Ty Myers,3,2,1,3,0,15200,13400,1800,825816,2024.10.03
140,"Salt, Lime & Tequila",Ryan Griffin,3,3,0,1,0,14900,14900,0,50374,2024.10.03
141,Mid-Twenties Crisis,Dylan Marlowe,3,3,0,3,0,14800,14800,0,209658,2024.10.03
142,Any Given Friday Night,Luke Combs,2,0,2,1,0,14600,0,14600,156375,2024.10.03
143,Days That End In Why,Morgan Wallen,7,1,6,2,0,13800,7800,6000,561392,2024.10.03
144,Grandpa (Tell Me 'Bout The Good Old Days),Cody Johnson,1,0,1,1,0,13600,11800,1800,116,2024.10.03
145,Jeans & Jesus,Sound,2,1,1,2,0,13100,7500,5600,0,2024.10.03
146,Hole In The Heart,Nelons,2,0,2,2,0,13100,0,13100,0,2024.10.03
146,Fall Into Place,Jeff & Sheri Easter,2,0,2,2,0,13100,0,13100,3468,2024.10.03
148,Forever Bound,12/Oc,7,0,7,1,0,12200,-2400,14600,1686,2024.10.03
149,For The Kids,Luke Bryan,1,1,0,1,0,11900,11900,0,397835,2024.10.03
150,Your Healing Is On The Way,Greater Vision,2,0,2,2,0,11800,0,11800,5523,2024.10.03
151,Oklahoma Smokeshow,Zach Bryan,5,2,3,2,0,11400,-800,12200,6027003,2024.10.03
152,Mia Down In Mia,George Strait,1,0,1,1,0,11400,1100,10300,141438,2024.10.03
153,Love Me Back To Life,Jordan Family Band,2,1,1,1,0,11200,5600,5600,1106,2024.10.03
153,Big Ole Stone (Victory),Triumphant Quartet,2,1,1,1,0,11200,5600,5600,7873,2024.10.03
155,Oklahoma Sooner,Jake Banfield,3,0,3,1,0,11200,0,11200,1996,2024.10.03
156,John Deere Green,"HIXTAPE Feat. HARDY, Morgan Wallen, Joe Diffie",2,1,1,1,0,10600,1200,9400,0,2024.10.03
157,Am I The Only One,Aaron Lewis,2,0,2,1,0,10400,9600,800,524099,2024.10.03
158,Sun To Me,Zach Bryan,6,0,6,2,0,10400,6000,4400,6502835,2024.10.03
159,Certified,Laura Bryna,17,0,17,1,0,10300,0,10300,3099,2024.10.03
160,M-E-X-I-C-O,Post Malone,1,1,0,1,0,9900,9900,0,846627,2024.10.03
160,Friend In Jesus,CAIN,1,1,0,1,0,9900,9900,0,274813,2024.10.03
160,No One Greater,Browns,1,1,0,1,0,9900,9900,0,2408,2024.10.03
160,Looks Like Jesus,Brian Free & Assurance,1,1,0,1,0,9900,9900,0,840,2024.10.03
164,Strong,Anne Wilson,1,0,1,1,0,9900,0,9900,985702,2024.10.03
165,'98 Braves,Morgan Wallen,1,-1,2,1,0,9900,-2800,12700,1400719,2024.10.03
166,Nosedive,Post Malone,1,-3,4,1,0,9900,4000,5900,2199371,2024.10.03
167,Hey Driver,Zach Bryan Feat. The War and Treaty,5,1,4,1,0,9600,300,9300,4272233,2024.10.03
168,Wolves Cry,Bryan Martin,4,4,0,4,0,9500,9500,0,932753,2024.10.03
169,Decoration,Jillian Riscoe,3,0,3,1,0,9500,2000,7500,10,2024.10.03
170,Steal My Thunder,Conner Smith,5,-7,12,1,0,9500,-47700,57200,696573,2024.10.03
171,California Sober,Post Malone,7,0,7,1,0,8700,-1500,10200,1695607,2024.10.03
172,Dance Like No One’s Watching,Gabby Barrett,15,-1,16,1,0,8700,-3200,11900,181326,2024.10.03
173,Trouble,Josh Ross,2,2,0,1,0,8100,8100,0,631615,2024.10.03
174,Build A Bridge,Ashley Cooke,5,1,4,1,0,8000,2800,5200,4774,2024.10.03
175,Whatever Gets You Through It,Morgan Gruber,9,3,6,1,0,7900,2400,5500,162,2024.10.03
176,Fake Id,Sydney Mack,5,1,4,1,0,7600,2200,5400,760,2024.10.03
177,Here Comes Jesus,Jeff & Sheri Easter,1,1,0,1,0,7500,7500,0,19540,2024.10.03
177,Sunday Sermons,Anne Wilson,1,1,0,1,0,7500,7500,0,512665,2024.10.03
177,Testify,Legacy Five,1,1,0,1,0,7500,7500,0,1327,2024.10.03
180,The Building,Emily Ann Roberts,1,0,1,1,0,7500,0,7500,29441,2024.10.03
181,Forgiven,Joseph Habedank,1,0,1,1,0,7500,-2400,9900,9619,2024.10.03
182,Where That Came From,Randy Travis,2,0,2,1,0,7400,-8100,15500,320141,2024.10.03
183,Hey Mercedes,Post Malone,2,0,2,1,0,7400,-14300,21700,563950,2024.10.03
184,Go To Hell,Post Malone,2,0,2,1,0,7400,-16200,23600,348499,2024.10.03
185,Nine Ball,Zach Bryan,2,-1,3,1,0,7400,-36100,43500,3879802,2024.10.03
186,Country's Cool Again,Lainey Wilson,1,1,0,1,0,7300,7300,0,376093,2024.10.03
187,I Wrote The Book,Morgan Wallen,3,3,0,3,0,6200,6200,0,2548803,2024.10.03
188,There's Always A Place At The Table,Sunday Drive,1,1,0,1,0,6200,6200,0,322,2024.10.03
188,"Liar, Liar",Brian Free & Assurance,1,1,0,1,0,6200,6200,0,1848,2024.10.03
188,Church Of The Great I Am,Kingsmen,1,1,0,1,0,6200,6200,0,4792,2024.10.03
188,What You Could Never Get Over,Kingdom Heirs,1,1,0,1,0,6200,6200,0,168,2024.10.03
192,Think About There,Greater Vision,1,0,1,1,0,6200,0,6200,14192,2024.10.03
192,Wings Of A Dove,Jonathan Wilburn,1,0,1,1,0,6200,0,6200,0,2024.10.03
192,"I, John",Blackwood Brothers Quartet,1,0,1,1,0,6200,0,6200,53,2024.10.03
192,In God's Time,Jordan Family Band,1,0,1,1,0,6200,0,6200,3517,2024.10.03
192,Ready To Leave,Down East Boys,1,0,1,1,0,6200,0,6200,857,2024.10.03
192,The End,Endless Highway,1,0,1,1,0,6200,0,6200,223,2024.10.03
192,He Bought Me,Old Paths,1,0,1,1,0,6200,0,6200,1713,2024.10.03
192,We Are The Church,Ernie Haase & Signature Sound,1,0,1,1,0,6200,0,6200,22155,2024.10.03
192,All Things,Sound,1,0,1,1,0,6200,0,6200,1269,2024.10.03
192,Back To The Garden,Erwins,1,0,1,1,0,6200,0,6200,0,2024.10.03
1,Pour Me A Drink,Post Malone,8574,940,7634,145,0,31302000,3391400,27910600,6166562,2024.10.10
2,I Am Not Okay,Jelly Roll,7609,425,7184,145,0,27459000,2472600,24986400,10447924,2024.10.10
3,Miles On It,Marshmello & Kane Brown,7236,357,6879,144,0,26542200,1408600,25133600,10984573,2024.10.10
4,A Bar Song (Tipsy),Shaboozey,5951,-70,6021,141,0,23797900,-940300,24738200,26712389,2024.10.10
5,This Is My Dirt,Justin Moore,6562,123,6439,145,0,22590400,502100,22088300,462757,2024.10.10
6,I Had Some Help,Post Malone,5344,-207,5551,145,0,22490800,-825200,23316000,20738183,2024.10.10
7,"Love You, Miss You, Mean It",Luke Bryan,5801,-1909,7710,145,0,20690600,-6361700,27052300,4292347,2024.10.10
8,Ain't No Love In Oklahoma (From Twisters: The Album),Luke Combs,5464,-1499,6963,144,0,20408200,-5768500,26176700,12404401,2024.10.10
9,Lies Lies Lies,Morgan Wallen,5912,726,5186,145,0,20151500,2138400,18013100,13857626,2024.10.10
10,Gonna Love You,Parmalee,5292,192,5100,145,0,17508400,904800,16603600,403502,2024.10.10
11,Austin,Dasha,4904,-39,4943,143,0,16588900,69600,16519300,8011252,2024.10.10
12,You Look Like You Love Me,Ella Langley & Riley Green,4377,392,3985,144,0,15653800,1254900,14398900,8433593,2024.10.10
13,Beautiful As You,Thomas Rhett,4405,200,4205,145,0,14566700,716400,13850300,4933465,2024.10.10
14,One Bad Habit,Tim McGraw,4339,82,4257,145,0,14160900,686200,13474700,342729,2024.10.10
15,Cowboy Songs,George Birge,4190,450,3740,145,0,13000800,1480500,11520300,567937,2024.10.10
16,High Road,Koe Wetzel,3220,458,2762,141,0,11066100,1865300,9200800,7778554,2024.10.10
17,Bigger Houses,Dan + Shay,3208,84,3124,145,0,10555200,603000,9952200,915705,2024.10.10
18,Messed Up As Me,Keith Urban,3453,31,3422,144,0,9818900,69000,9749900,2016335,2024.10.10
19,Sounds Like The Radio,Zach Top,3041,50,2991,144,0,9752100,217700,9534400,2179000,2024.10.10
20,Think I’m In Love With You,Chris Stapleton,2830,-49,2879,143,0,9389300,-329600,9718900,5390489,2024.10.10
21,Wind Up Missin' You,Tucker Wetmore,2980,120,2860,144,0,9324800,326500,8998300,7164887,2024.10.10
22,Boys Back Home,Dylan Marlowe Feat. Dylan Scott,2801,271,2530,142,0,8537600,731000,7806600,2173789,2024.10.10
23,Damn Good Day To Leave,Riley Green,2977,-33,3010,145,0,8518200,67900,8450300,1040678,2024.10.10
24,American Girl,Dierks Bentley,2387,135,2252,142,0,7855500,489900,7365600,141978,2024.10.10
25,Guy For That,Post Malone,1905,187,1718,140,0,6625200,357800,6267400,6169838,2024.10.10
26,Breakin' In Boots,Matt Stell,2047,-79,2126,141,0,4932300,-255300,5187600,217711,2024.10.10
27,4x4xu,Lainey Wilson,1588,180,1408,141,0,4931600,590800,4340800,3254224,2024.10.10
28,Find Another Bar,Chris Lane,1973,180,1793,141,0,4766700,684000,4082700,83272,2024.10.10
29,Friends Like That,John Morgan Feat. Jason Aldean,1909,83,1826,121,0,4600300,118100,4482200,813970,2024.10.10
30,This Town's Been Too Good To Us,Dylan Scott,1790,94,1696,133,0,4575100,385600,4189500,2186726,2024.10.10
31,Just To Say We Did,Kenny Chesney,1418,28,1390,126,0,4430300,78100,4352200,367777,2024.10.10
32,Holy Smokes,Bailey Zimmerman,1133,59,1074,78,0,4136000,262500,3873500,4071361,2024.10.10
33,I Ain'T Sayin',Jordan Davis,1498,16,1482,127,0,4129800,15000,4114800,2798734,2024.10.10
34,I'm Gonna Love You,Cody Johnson,1127,-981,2108,107,0,3633800,-5461700,9095500,6304550,2024.10.10
35,Whatcha See Is Whatcha Get,Chris Janson,1605,15,1590,143,0,3586600,42600,3544000,110368,2024.10.10
36,Forever To Me,Cole Swindell,1357,62,1295,121,0,3426700,233600,3193100,752397,2024.10.10
37,Life With You,Kelsey Hart,1531,-38,1569,117,0,3413600,152900,3260700,1132211,2024.10.10
38,Wranglers,Miranda Lambert,1554,47,1507,138,0,3236200,117800,3118400,1070344,2024.10.10
39,Am I Okay?,Megan Moroney,948,51,897,90,0,3100100,138500,2961600,6639885,2024.10.10
40,Whiskey Drink,Jason Aldean,1293,113,1180,116,0,3046800,277000,2769800,886760,2024.10.10
41,Called Crazy,Kassi Ashton,928,100,828,95,0,2618100,187000,2431100,624517,2024.10.10
42,Hometown Home,Locash,1142,131,1011,104,0,2597600,397300,2200300,71015,2024.10.10
43,Coming Home,Old Dominion,977,41,936,129,0,2327200,152900,2174300,1478897,2024.10.10
44,Fall Of Summer,Scotty McCreery,1104,19,1085,116,0,2291500,188600,2102900,366513,2024.10.10
45,Cowboys Cry Too,Kelsea Ballerini,1171,44,1127,132,0,2290800,114600,2176200,3109485,2024.10.10
46,I Tried A Ring On,Tigirlily Gold,1426,83,1343,140,0,2274800,140100,2134700,546105,2024.10.10
47,Truck On Fire,Carly Pearce,961,75,886,108,0,2129200,197500,1931700,1048629,2024.10.10
48,Single Again,Josh Ross,961,-11,972,103,0,1902000,129200,1772800,2410349,2024.10.10
49,Everything I Need,Chayce Beckham,753,27,726,71,0,1526300,73500,1452800,253130,2024.10.10
50,Friday Night Heartbreaker,Jon Pardi,544,50,494,71,0,1462900,198900,1264000,477672,2024.10.10
51,Country Back,Randy Houser,846,12,834,86,0,1440700,-20000,1460700,13901,2024.10.10
52,This Heart,Corey Kent,575,-15,590,62,0,1212700,59500,1153200,703338,2024.10.10
53,Heavens To Betsy,Jackson Dean,626,57,569,84,0,1198300,189000,1009300,398208,2024.10.10
54,Over When We'Re Sober,Brantley Gilbert,624,4,620,79,0,1188000,-13500,1201500,812260,2024.10.10
55,Truck Still Works,Brad Paisley,515,213,302,81,0,1179800,473100,706700,385197,2024.10.10
56,Country House,Sam Hunt,567,-8,575,76,0,1169400,8500,1160900,233974,2024.10.10
57,Love The Leavin',Drew Parker,438,94,344,24,0,1159100,383700,775400,69680,2024.10.10
58,What Kinda Man,Parker Mccollum,486,39,447,57,0,1120500,128700,991800,828467,2024.10.10
59,Park,Tyler Hubbard,567,25,542,81,0,1099800,26000,1073800,792866,2024.10.10
60,Devil You Know,Tyler Braden,481,25,456,46,0,1067900,111400,956500,3852831,2024.10.10
61,Bones,Russell Dickerson,625,23,602,97,0,1065400,15400,1050000,1214436,2024.10.10
62,I Never Lie,Zach Top,144,66,78,10,0,1013700,419600,594100,6458469,2024.10.10
63,I Could Be That Rain,Randall King,424,27,397,64,0,697400,175000,522400,102808,2024.10.10
64,Better Than You,Joe Nichols & Annie Bosko,340,217,123,89,0,525100,275600,249500,116379,2024.10.10
65,Worst Way,Riley Green,45,13,32,1,0,493100,166200,326900,4896474,2024.10.10
66,Relapse,Warren Zeiders,332,-13,345,37,0,485600,-13200,498800,3730387,2024.10.10
67,Strangers,Kameron Marlowe & Ella Langley,355,-14,369,47,0,467100,13300,453800,1100571,2024.10.10
68,Would If I Could,Ernest Feat. Lainey Wilson,184,121,63,45,0,414500,301500,113000,836808,2024.10.10
69,Wine Into Whiskey,Tucker Wetmore,54,28,26,3,0,400300,264100,136200,4722476,2024.10.10
70,Happy Trails,Anna Vaus,106,106,0,58,0,359200,359200,0,6463,2024.10.10
71,Golden Child,Meghan Patrick,354,-7,361,53,0,332800,-73800,406600,50784,2024.10.10
72,Not Today,Mitchell Tenpenny,322,-27,349,54,0,285500,-194700,480200,410666,2024.10.10
73,Hung Up On You,Bryce Leatherwood,272,88,184,49,0,257400,93700,163700,25738,2024.10.10
74,Pink Skies,Zach Bryan,111,-5,116,7,0,254000,-13200,267200,14799279,2024.10.10
75,Losers,Post Malone,87,5,82,7,0,235300,-3900,239200,4779538,2024.10.10
76,I Got A Problem,Drake Milligan,62,-16,78,6,0,194300,-60900,255200,46089,2024.10.10
77,Beatles And Eagles,Frontmen,212,9,203,29,0,188300,10400,177900,1034,2024.10.10
78,Darlin',Chase Matthew,87,13,74,22,0,183300,76400,106900,3362899,2024.10.10
79,Things I Take For Granted,Larry Fleet,126,-15,141,21,0,182500,-14900,197400,402876,2024.10.10
80,Songs About Whiskey,Anne Wilson,138,6,132,21,0,172100,-7700,179800,136434,2024.10.10
81,Rooster/Country Boy Can Survive (Mashup),Joe Nichols,39,39,0,39,0,168100,168100,0,0,2024.10.10
82,Young Man,Greylan James,38,0,38,3,0,156600,-22600,179200,33029,2024.10.10
83,The Devil I Know,Ashley McBryde,47,-17,64,6,0,153200,-5400,158600,126248,2024.10.10
84,Wrong Ones,Post Malone,42,-7,49,4,0,149800,-19800,169600,2065104,2024.10.10
85,Just Like Johnny,Redferrin,137,21,116,20,0,139500,20700,118800,3450247,2024.10.10
86,New To Country,Bailey Zimmerman,25,-3,28,3,0,116700,32100,84600,1874798,2024.10.10
87,How Is She,Cole Swindell,17,3,14,1,0,104200,-14700,118900,38205,2024.10.10
88,Spin You Around (1/24),Morgan Wallen,33,6,27,3,0,99900,20500,79400,5135071,2024.10.10
89,Break Mine,Brothers Osborne,38,3,35,4,0,98600,4200,94400,320810,2024.10.10
90,Now Or Never,Corey Kent,27,16,11,1,0,96000,62600,33400,2089563,2024.10.10
91,Wondering Why,Red Clay Strays,24,1,23,5,0,94800,-1200,96000,4296266,2024.10.10
92,Pray All The Way Home,Austin Snell,51,-32,83,7,0,92000,-52200,144200,739715,2024.10.10
93,One Hit Wonders,Maddie & Tae,49,49,0,48,0,87300,87300,0,50664,2024.10.10
94,Good On You,Priscilla Block,86,2,84,12,0,85000,5500,79500,328083,2024.10.10
95,Wolves Cry,Bryan Martin,27,23,4,5,0,78900,69400,9500,888569,2024.10.10
96,Cozy,Braxton Keith,19,0,19,2,0,72900,-13800,86700,1380555,2024.10.10
97,Broadway Girls,Lil Durk Feat. Morgan Wallen,16,-1,17,3,0,72600,4000,68600,4802264,2024.10.10
98,Never Been Over,Darius Rucker,40,-48,88,5,0,59500,-34800,94300,145075,2024.10.10
99,My Bar,Priscilla Block,9,8,1,7,0,59000,55800,3200,102062,2024.10.10
100,American Nights,Zach Bryan,18,1,17,1,0,45700,-2900,48600,3369316,2024.10.10
101,Let 'Em Talk,Ty Myers,15,12,3,2,0,45200,30000,15200,833943,2024.10.10
102,Man Upstairs,Tim Dugger,10,0,10,1,0,43400,4600,38800,4363,2024.10.10
103,Gettin' Older,Chris Young,8,8,0,8,0,42800,42800,0,50259,2024.10.10
103,Jesus At The Taco Truck,"Shy Carter, Frank Ray",8,8,0,8,0,42800,42800,0,1232,2024.10.10
105,The Star-Spangled Banner,Chris Stapleton,14,-2,16,12,0,42300,-25200,67500,71050,2024.10.10
106,Bury Me In This Bar,Dalton Dover,35,-16,51,8,0,40800,-26700,67500,11899,2024.10.10
107,You In A Honky Tonk,Randall King,3,2,1,2,0,39700,34100,5600,344259,2024.10.10
108,Fiddle In The Band,Kane Brown,10,-3,13,2,0,39300,-6000,45300,303725,2024.10.10
109,Liar,Jelly Roll,16,-5,21,1,0,38400,-33500,71900,5253664,2024.10.10
110,Country Song Came On,Luke Bryan,18,-2,20,18,0,38200,-78200,116400,445356,2024.10.10
111,Work Boots,Cody Johnson,2,-1,3,1,0,37900,700,37200,270068,2024.10.10
112,Hey Mom I Made It,Sacha,15,15,0,15,0,33000,33000,0,26236,2024.10.10
113,Mint Tea,Johnny Blue Skies,12,0,12,1,0,32700,6700,26000,0,2024.10.10
114,Just A Bottle,Orlando Mendez,34,34,0,17,0,27600,27600,0,426,2024.10.10
115,Taught Me The Rest,Landon Parker,33,33,0,17,0,27400,27400,0,31746,2024.10.10
116,Train Of Thought,Vincent Mason,9,-12,21,1,0,27200,-56800,84000,0,2024.10.10
117,Good Ol' Boys,Mae Estes,10,-2,12,1,0,26200,9900,16300,24979,2024.10.10
118,Greener Pasture,Carter Faith,10,2,8,1,0,24900,6000,18900,87486,2024.10.10
119,Old School,Toby Keith,5,5,0,5,0,24700,24700,0,20577,2024.10.10
120,I Wrote The Book,Morgan Wallen,11,8,3,11,0,23800,17600,6200,2554491,2024.10.10
121,A Little Bit Closer,Braxton Keith,2,2,0,1,0,23600,23600,0,239460,2024.10.10
122,That's Texas,Cody Johnson,2,1,1,1,0,23600,21800,1800,237168,2024.10.10
123,Last Rodeo,Restless Road,2,2,0,2,0,23400,23400,0,213450,2024.10.10
124,New Kind Of Emotion,Runaway June,10,10,0,2,0,23300,23300,0,78694,2024.10.10
125,Nine Ball,Zach Bryan,2,0,2,1,0,21700,14300,7400,3662897,2024.10.10
126,Carhartt,Dylan Schneider,5,0,5,5,0,21000,1800,19200,192278,2024.10.10
127,Texas Is The Last Stop,Midland,1,1,0,1,0,19900,19900,0,8276,2024.10.10
128,Use Me,Zach Top,1,0,1,1,0,19900,18100,1800,1267700,2024.10.10
129,Hey Mercedes,Post Malone,1,-1,2,1,0,19900,12500,7400,505361,2024.10.10
130,Leave You Alone,Kane Brown,5,5,0,5,0,19500,19500,0,179627,2024.10.10
131,Can't Pass The Bar,Scotty McCreery,4,4,0,4,0,19400,19400,0,60450,2024.10.10
132,She's Still Got It,Luke Bryan,7,7,0,7,0,19200,19200,0,121844,2024.10.10
133,John Deere Green,"HIXTAPE Feat. HARDY, Morgan Wallen, Joe Diffie",3,1,2,2,0,18000,7400,10600,0,2024.10.10
134,Grandpa (Tell Me 'Bout The Good Old Days),Cody Johnson,1,0,1,1,0,18000,4400,13600,103,2024.10.10
135,Loud and Heavy,Cody Jinks,5,-2,7,1,0,16700,-1800,18500,1330105,2024.10.10
136,Break It Right Back,Megan Moroney,4,4,0,2,0,16000,16000,0,3524315,2024.10.10
137,A Lot More Free,Max Mcnown,7,4,3,1,0,15600,12900,2700,2867681,2024.10.10
138,Favor,49 Winchester,2,2,0,1,0,15000,15000,0,49455,2024.10.10
139,Any Given Friday Night,Luke Combs,2,0,2,1,0,14600,0,14600,158401,2024.10.10
140,Roulette On The Heart,Conner Smith,13,0,13,3,0,14100,-2900,17000,373657,2024.10.10
141,Help Is On The Way,Gold City,2,2,0,2,0,13700,13700,0,18386,2024.10.10
142,Back To The Garden,Erwins,2,1,1,2,0,13700,7500,6200,0,2024.10.10
143,Angels Were Gone,Larry Fleet,1,1,0,1,0,13600,13600,0,10312,2024.10.10
144,'98 Braves,Morgan Wallen,2,1,1,2,0,13200,3300,9900,1407059,2024.10.10
145,The God I Know,Erwins,2,2,0,2,0,13100,13100,0,4838,2024.10.10
146,The Good I'Ll Do,Zach Bryan,5,-1,6,1,0,12900,-3900,16800,2097194,2024.10.10
147,Oklahoma Sooner,Jake Banfield,3,0,3,1,0,12300,1100,11200,1695,2024.10.10
148,Oklahoma Smokeshow,Zach Bryan,3,-2,5,1,0,12200,800,11400,6133888,2024.10.10
149,Baby Daddy's Weekend,Elle King,17,-5,22,3,0,12200,-10200,22400,38405,2024.10.10
150,Certified,Laura Bryna,14,-3,17,1,0,11900,1600,10300,921,2024.10.10
151,Be Ready,Karen Peck & New River,2,1,1,2,0,11800,6200,5600,10801,2024.10.10
152,Song While You'Re Away,Tyler Childers,2,0,2,2,0,11800,10000,1800,486900,2024.10.10
153,Forever Bound,12/Oc,5,-2,7,1,0,11200,-1000,12200,1447,2024.10.10
154,Bury Me Inside The Ocean,Orlando Mendez,16,16,0,16,0,11000,11000,0,158,2024.10.10
155,Runnin' Through That T,Thomas Edwards (Country),1,1,0,1,0,10800,10800,0,2064,2024.10.10
156,"Salt, Lime & Tequila",Ryan Griffin,3,0,3,1,0,10300,-4600,14900,50446,2024.10.10
157,Mansions,Sound Street,1,1,0,1,0,9900,9900,0,942,2024.10.10
157,By Your Grace,Cody Johnson,1,1,0,1,0,9900,9900,0,489725,2024.10.10
157,My Jesus,Anne Wilson,1,1,0,1,0,9900,9900,0,1516472,2024.10.10
157,Been With Jesus,Craguns,1,1,0,1,0,9900,9900,0,60,2024.10.10
161,Jeans & Jesus,Sound,1,-1,2,1,0,9900,-3200,13100,0,2024.10.10
162,Days That End In Why,Morgan Wallen,6,-1,7,2,0,9400,-4400,13800,538909,2024.10.10
163,Star Spangled Banner,Mickey Guyton,1,1,0,1,0,9200,9200,0,0,2024.10.10
164,Maxed Out,Bayker Blankenship,4,0,4,1,0,9100,-7900,17000,3345675,2024.10.10
165,Sun To Me,Zach Bryan,7,1,6,2,0,9000,-1400,10400,6269356,2024.10.10
166,Dance Like No One’s Watching,Gabby Barrett,14,-1,15,1,0,8600,-100,8700,170297,2024.10.10
167,Hey Driver,Zach Bryan Feat. The War and Treaty,3,-2,5,1,0,8600,-1000,9600,4151374,2024.10.10
168,Heart Of A Small Town,Tim Dugger,2,-1,3,1,0,8400,-18800,27200,15097,2024.10.10
169,Hippies And Cowboys,Sarah Darling,3,-18,21,1,0,8400,-16600,25000,1907,2024.10.10
170,Acres,Brian Kelley,11,3,8,2,0,8300,3800,4500,114963,2024.10.10
171,Weren'T For The Wind,Ella Langley,2,2,0,2,0,8000,8000,0,2141659,2024.10.10
172,Faith From A Farmer,Conner Smith,2,2,0,1,0,7700,7700,0,53482,2024.10.10
173,Anywhere Jesus Is,Scotty Inman,1,1,0,1,0,7500,7500,0,735,2024.10.10
173,My Feet Are On The Rock,Gaither Vocal Band,1,1,0,1,0,7500,7500,0,980,2024.10.10
173,Red Letter Blueprint,Scotty McCreery,1,1,0,1,0,7500,7500,0,31711,2024.10.10
173,Means Something To Me,Tate Emmons,1,1,0,1,0,7500,7500,0,352,2024.10.10
173,Checking In,For King & Country & Lee Brice,1,1,0,1,0,7500,7500,0,75186,2024.10.10
173,Storms I Never See,Peach Goldman,1,1,0,1,0,7500,7500,0,6434,2024.10.10
179,Dive,Luke Combs,2,1,1,1,0,7400,1800,5600,1009916,2024.10.10
180,Nostalgia,Conner Smith,1,1,0,1,0,7300,7300,0,286588,2024.10.10
180,Someday When I'M Old,Jamey Johnson,1,1,0,1,0,7300,7300,0,365037,2024.10.10
182,Stop Draggin' My Heart Around,Lady A,1,0,1,1,0,7300,5500,1800,33025,2024.10.10
183,Hit The Hay Runnin',Aaron Watson,2,0,2,2,0,7300,3700,3600,31948,2024.10.10
184,Feelin' Country,Thomas Rhett,4,-2,6,1,0,7300,-14600,21900,369760,2024.10.10
185,Lonely Road,mgk & Jelly Roll,6,1,5,5,0,7000,-10500,17500,7081697,2024.10.10
186,Me To Me,Morgan Wallen,2,0,2,2,0,7000,1400,5600,646702,2024.10.10
187,There Is A Name,LeFevre Quartet,1,1,0,1,0,6200,6200,0,10077,2024.10.10
187,Come To The Well,Inspirations,1,1,0,1,0,6200,6200,0,8426,2024.10.10
187,Warmin' Up,Perrys,1,1,0,1,0,6200,6200,0,10274,2024.10.10
187,Waiting For Me,Truesong,1,1,0,1,0,6200,6200,0,792,2024.10.10
187,My God,Scotty Inman,1,1,0,1,0,6200,6200,0,40569,2024.10.10
187,Be The Reason,Steeles,1,1,0,1,0,6200,6200,0,3390,2024.10.10
187,Prayin' In A Deer Stand,Luke Bryan,1,1,0,1,0,6200,6200,0,33978,2024.10.10
187,Like Jesus Can,Taranda Greene,1,1,0,1,0,6200,6200,0,1220,2024.10.10
187,A Good Day Coming On,Kingdom Heirs,1,1,0,1,0,6200,6200,0,0,2024.10.10
196,All Things,Sound,1,0,1,1,0,6200,0,6200,1269,2024.10.10
196,"Liar, Liar",Brian Free & Assurance,1,0,1,1,0,6200,0,6200,1545,2024.10.10
196,Wings Of A Dove,Jonathan Wilburn,1,0,1,1,0,6200,0,6200,0,2024.10.10
196,We Are The Church,Ernie Haase & Signature Sound,1,0,1,1,0,6200,0,6200,21570,2024.10.10
196,Think About There,Greater Vision,1,0,1,1,0,6200,0,6200,12630,2024.10.10
196,The End,Endless Highway,1,0,1,1,0,6200,0,6200,175,2024.10.10
196,In God's Time,Jordan Family Band,1,0,1,1,0,6200,0,6200,3935,2024.10.10
196,He Bought Me,Old Paths,1,0,1,1,0,6200,0,6200,1674,2024.10.10
204,Am I The Only One,Aaron Lewis,2,0,2,1,0,6200,-4200,10400,530875,2024.10.10
1,Pour Me A Drink,Post Malone,7853,-721,8574,145,0,29747000,-1555000,31302000,4537035,2024.10.17
2,I Am Not Okay,Jelly Roll,8039,430,7609,145,0,29398500,1939500,27459000,10166909,2024.10.17
3,Miles On It,Marshmello & Kane Brown,7495,259,7236,144,0,27743500,1201300,26542200,9855767,2024.10.17
4,This Is My Dirt,Justin Moore,7940,1378,6562,145,0,26988200,4397800,22590400,505821,2024.10.17
5,A Bar Song (Tipsy),Shaboozey,5940,-11,5951,142,0,23440200,-357700,23797900,22439458,2024.10.17
6,Lies Lies Lies,Morgan Wallen,6504,592,5912,145,0,22562300,2410800,20151500,12624896,2024.10.17
7,I Had Some Help,Post Malone,4903,-441,5344,145,0,20750600,-1740200,22490800,17832094,2024.10.17
8,Ain't No Love In Oklahoma (From Twisters: The Album),Luke Combs,5081,-383,5464,143,0,18618300,-1789900,20408200,10877435,2024.10.17
9,Gonna Love You,Parmalee,5441,149,5292,145,0,18312700,804300,17508400,371834,2024.10.17
10,You Look Like You Love Me,Ella Langley & Riley Green,4665,288,4377,144,0,16578100,924300,15653800,8058347,2024.10.17
11,Austin,Dasha,4936,32,4904,142,0,16501700,-87200,16588900,7738838,2024.10.17
12,Beautiful As You,Thomas Rhett,4592,187,4405,145,0,14973800,407100,14566700,4779687,2024.10.17
13,One Bad Habit,Tim McGraw,4344,5,4339,145,0,14331800,170900,14160900,284703,2024.10.17
14,Cowboy Songs,George Birge,4296,106,4190,145,0,13836500,835700,13000800,556667,2024.10.17
15,High Road,Koe Wetzel,3703,483,3220,142,0,12440700,1374600,11066100,6980874,2024.10.17
16,Bigger Houses,Dan + Shay,3550,342,3208,145,0,11472300,917100,10555200,790689,2024.10.17
17,Wind Up Missin' You,Tucker Wetmore,3275,295,2980,144,0,10587200,1262400,9324800,6280016,2024.10.17
18,Sounds Like The Radio,Zach Top,3162,121,3041,144,0,10316400,564300,9752100,2037441,2024.10.17
19,Messed Up As Me,Keith Urban,3532,79,3453,144,0,10186600,367700,9818900,1726593,2024.10.17
20,Boys Back Home,Dylan Marlowe Feat. Dylan Scott,3192,391,2801,143,0,10035600,1498000,8537600,1974877,2024.10.17
21,Think I’m In Love With You,Chris Stapleton,2857,27,2830,143,0,9336600,-52700,9389300,4690742,2024.10.17
22,Damn Good Day To Leave,Riley Green,3037,60,2977,145,0,8932300,414100,8518200,856686,2024.10.17
23,American Girl,Dierks Bentley,2420,33,2387,143,0,7949900,94400,7855500,116636,2024.10.17
24,Guy For That,Post Malone,1998,93,1905,138,0,7178000,552800,6625200,5626845,2024.10.17
25,4x4xu,Lainey Wilson,1822,234,1588,143,0,5881500,949900,4931600,2683292,2024.10.17
26,This Town's Been Too Good To Us,Dylan Scott,1950,160,1790,143,0,5357100,782000,4575100,1838826,2024.10.17
27,Breakin' In Boots,Matt Stell,2061,14,2047,142,0,5102700,170400,4932300,206896,2024.10.17
28,Find Another Bar,Chris Lane,2018,45,1973,140,0,5025400,258700,4766700,75523,2024.10.17
29,Friends Like That,John Morgan Feat. Jason Aldean,1897,-12,1909,125,0,4812900,212600,4600300,814510,2024.10.17
30,I Ain'T Sayin',Jordan Davis,1649,151,1498,130,0,4609600,479800,4129800,2531939,2024.10.17
31,Holy Smokes,Bailey Zimmerman,1238,105,1133,97,0,4312100,176100,4136000,3870923,2024.10.17
32,I'm Gonna Love You,Cody Johnson,1210,83,1127,109,0,4194700,560900,3633800,6542826,2024.10.17
33,Forever To Me,Cole Swindell,1428,71,1357,116,0,4004800,578100,3426700,553380,2024.10.17
34,Am I Okay?,Megan Moroney,1060,112,948,91,0,3663100,563000,3100100,5473087,2024.10.17
35,Whatcha See Is Whatcha Get,Chris Janson,1552,-53,1605,143,0,3602200,15600,3586600,102136,2024.10.17
36,Just To Say We Did,Kenny Chesney,1352,-66,1418,128,0,3459900,-970400,4430300,307472,2024.10.17
37,Hometown Home,Locash,1378,236,1142,107,0,3429300,831700,2597600,67172,2024.10.17
38,Life With You,Kelsey Hart,1543,12,1531,119,0,3418800,5200,3413600,897482,2024.10.17
39,Whiskey Drink,Jason Aldean,1376,83,1293,121,0,3256800,210000,3046800,746176,2024.10.17
40,Wranglers,Miranda Lambert,1494,-60,1554,139,0,3130600,-105600,3236200,870927,2024.10.17
41,Coming Home,Old Dominion,1107,130,977,125,0,2512000,184800,2327200,1146581,2024.10.17
42,I Tried A Ring On,Tigirlily Gold,1467,41,1426,141,0,2400200,125400,2274800,282285,2024.10.17
43,Fall Of Summer,Scotty McCreery,1075,-29,1104,109,0,2344700,53200,2291500,342950,2024.10.17
44,Cowboys Cry Too,Kelsea Ballerini,1161,-10,1171,132,0,2263500,-27300,2290800,2867357,2024.10.17
45,Single Again,Josh Ross,1153,192,961,103,0,2214600,312600,1902000,2091972,2024.10.17
46,Truck On Fire,Carly Pearce,986,25,961,113,0,2072300,-56900,2129200,747279,2024.10.17
47,Friday Night Heartbreaker,Jon Pardi,580,36,544,87,0,1557900,95000,1462900,409006,2024.10.17
48,Country Back,Randy Houser,848,2,846,86,0,1525500,84800,1440700,13497,2024.10.17
49,I Never Lie,Zach Top,221,77,144,14,0,1508100,494400,1013700,6104150,2024.10.17
50,Everything I Need,Chayce Beckham,744,-9,753,71,0,1481800,-44500,1526300,239298,2024.10.17
51,Heavens To Betsy,Jackson Dean,700,74,626,88,0,1458500,260200,1198300,362112,2024.10.17
52,This Heart,Corey Kent,562,-13,575,60,0,1262800,50100,1212700,545422,2024.10.17
53,Country House,Sam Hunt,600,33,567,85,0,1255300,85900,1169400,198103,2024.10.17
54,Love The Leavin',Drew Parker,467,29,438,24,0,1223400,64300,1159100,68023,2024.10.17
55,Devil You Know,Tyler Braden,485,4,481,49,0,1183400,115500,1067900,3302526,2024.10.17
56,Over When We'Re Sober,Brantley Gilbert,632,8,624,81,0,1170900,-17100,1188000,721907,2024.10.17
57,Park,Tyler Hubbard,564,-3,567,78,0,1162400,62600,1099800,718211,2024.10.17
58,What Kinda Man,Parker Mccollum,481,-5,486,60,0,1119700,-800,1120500,928959,2024.10.17
59,Truck Still Works,Brad Paisley,519,4,515,62,0,1118000,-61800,1179800,298171,2024.10.17
60,Bones,Russell Dickerson,652,27,625,90,0,1073300,7900,1065400,891322,2024.10.17
61,Would If I Could,Ernest Feat. Lainey Wilson,366,182,184,58,0,861300,446800,414500,833419,2024.10.17
62,I Could Be That Rain,Randall King,471,47,424,62,0,840900,143500,697400,96445,2024.10.17
63,Worst Way,Riley Green,67,22,45,3,0,745100,252000,493100,4673864,2024.10.17
64,Darkest Hour (Helene Edit),Eric Church,302,302,0,80,0,643800,643800,0,461761,2024.10.17
65,Relapse,Warren Zeiders,386,54,332,39,0,638300,152700,485600,3293436,2024.10.17
66,Wine Into Whiskey,Tucker Wetmore,66,12,54,3,0,564900,164600,400300,3907086,2024.10.17
67,Backseat Driver,Kane Brown,129,129,0,64,0,551900,551900,0,2110675,2024.10.17
68,Better Than You,Joe Nichols & Annie Bosko,365,25,340,72,0,443100,-82000,525100,66008,2024.10.17
69,Can'T Help My Country,Tiera Kennedy,106,106,0,58,0,359200,359200,0,13691,2024.10.17
70,Golden Child,Meghan Patrick,361,7,354,55,0,336300,3500,332800,58988,2024.10.17
71,Espresso,Sabrina Carpenter,77,77,0,39,0,331500,331500,0,17226472,2024.10.17
72,Strangers,Kameron Marlowe & Ella Langley,235,-120,355,40,0,318300,-148800,467100,849616,2024.10.17
73,Not Today,Mitchell Tenpenny,318,-4,322,50,0,295400,9900,285500,394027,2024.10.17
74,Pink Skies,Zach Bryan,105,-6,111,7,0,252600,-1400,254000,13191421,2024.10.17
75,If I Die Before You,Chris Lane,57,57,0,42,0,251500,251500,0,378016,2024.10.17
76,Hung Up On You,Bryce Leatherwood,249,-23,272,41,0,237800,-19600,257400,17059,2024.10.17
77,I Got A Problem,Drake Milligan,63,1,62,5,0,206400,12100,194300,44722,2024.10.17
78,Just Like Johnny,Redferrin,163,26,137,21,0,198300,58800,139500,3275500,2024.10.17
79,Wolves Cry,Bryan Martin,59,32,27,7,0,194600,115700,78900,763170,2024.10.17
80,Losers,Post Malone,61,-26,87,5,0,170000,-65300,235300,3995469,2024.10.17
81,Songs About Whiskey,Anne Wilson,117,-21,138,18,0,168700,-3400,172100,127129,2024.10.17
82,Liar,Jelly Roll,57,41,16,13,0,168300,129900,38400,6172390,2024.10.17
83,Darlin',Chase Matthew,117,30,87,23,0,155100,-28200,183300,2912454,2024.10.17
84,Beatles And Eagles,Frontmen,200,-12,212,30,0,147900,-40400,188300,838,2024.10.17
85,The Devil I Know,Ashley McBryde,48,1,47,5,0,146600,-6600,153200,116009,2024.10.17
86,Wrong Ones,Post Malone,39,-3,42,4,0,142800,-7000,149800,1839911,2024.10.17
87,How Is She,Cole Swindell,16,-1,17,1,0,120900,16700,104200,31876,2024.10.17
88,Wondering Why,Red Clay Strays,24,0,24,4,0,115400,20600,94800,4060228,2024.10.17
89,Things I Take For Granted,Larry Fleet,63,-63,126,15,0,101600,-80900,182500,340128,2024.10.17
90,Break Mine,Brothers Osborne,40,2,38,3,0,100100,1500,98600,287058,2024.10.17
91,Spin You Around (1/24),Morgan Wallen,30,-3,33,4,0,98500,-1400,99900,4525684,2024.10.17
92,Now Or Never,Corey Kent,25,-2,27,1,0,90300,-5700,96000,1929556,2024.10.17
93,Good On You,Priscilla Block,55,-31,86,12,0,84700,-300,85000,238921,2024.10.17
94,Cozy,Braxton Keith,18,-1,19,2,0,75400,2500,72900,1278351,2024.10.17
95,Never Been Over,Darius Rucker,40,0,40,4,0,71800,12300,59500,121445,2024.10.17
96,Broadway Girls,Lil Durk Feat. Morgan Wallen,16,0,16,2,0,65700,-6900,72600,4297378,2024.10.17
97,Pray All The Way Home,Austin Snell,38,-13,51,6,0,62900,-29100,92000,588766,2024.10.17
98,Maxed Out,Bayker Blankenship,9,5,4,1,0,62800,53700,9100,2900788,2024.10.17
99,Gonna Be You,Dolly Parton,45,45,0,45,0,62400,62400,0,253920,2024.10.17
100,Young Man,Greylan James,28,-10,38,3,0,60500,-96100,156600,31577,2024.10.17
101,Winning Streak,Jelly Roll,14,14,0,7,0,55800,55800,0,5055164,2024.10.17
102,The Star-Spangled Banner,Chris Stapleton,11,-3,14,11,0,49400,7100,42300,58257,2024.10.17
103,Let 'Em Talk,Ty Myers,16,1,15,2,0,47100,1900,45200,956500,2024.10.17
104,Train Of Thought,Vincent Mason,7,-2,9,2,0,46000,18800,27200,0,2024.10.17
105,Highway,Shaboozey,20,20,0,9,0,41200,41200,0,830449,2024.10.17
106,American Nights,Zach Bryan,19,1,18,1,0,40800,-4900,45700,3021684,2024.10.17
107,You In A Honky Tonk,Randall King,3,0,3,2,0,39700,0,39700,316984,2024.10.17
108,Man Upstairs,Tim Dugger,8,-2,10,1,0,35000,-8400,43400,2052,2024.10.17
109,My Bar,Priscilla Block,7,-2,9,3,0,34600,-24400,59000,88749,2024.10.17
110,Get By,Jelly Roll,7,7,0,6,0,33100,33100,0,2897968,2024.10.17
111,Hippies And Cowboys,Sarah Darling,32,29,3,17,0,32300,23900,8400,2360,2024.10.17
112,Back To Texas,Post Malone,3,2,1,1,0,27300,25500,1800,269893,2024.10.17
113,Work Boots,Cody Johnson,3,1,2,1,0,27300,-10600,37900,270077,2024.10.17
114,Mint Tea,Johnny Blue Skies,15,3,12,1,0,26300,-6400,32700,0,2024.10.17
115,Love Somebody,Morgan Wallen,13,13,0,9,0,25700,25700,0,54000,2024.10.17
116,Time's Ticking,Justin Moore,9,9,0,9,0,25700,25700,0,652811,2024.10.17
117,Greener Pasture,Carter Faith,10,0,10,1,0,24400,-500,24900,81931,2024.10.17
118,Wild Horses,Kin Faux,2,2,0,2,0,21700,21700,0,3176,2024.10.17
119,Lovin' Where It's Goin',Josh Ward,1,1,0,1,0,19900,19900,0,26182,2024.10.17
120,Record High,Randall King,1,0,1,1,0,19900,19900,0,22408,2024.10.17
121,Oklahoma Smokeshow,Zach Bryan,8,5,3,2,0,19800,7600,12200,5618646,2024.10.17
122,Baby Daddy's Weekend,Elle King,12,-5,17,4,0,19100,6900,12200,32487,2024.10.17
123,Loud and Heavy,Cody Jinks,7,2,5,1,0,17700,1000,16700,1074973,2024.10.17
124,Hey Mama,Jelly Roll,4,4,0,3,0,17600,17600,0,1305958,2024.10.17
125,Hey Driver,Zach Bryan Feat. The War and Treaty,7,4,3,3,0,17600,9000,8600,3805679,2024.10.17
126,Heart Of Stone,Jelly Roll,5,5,0,5,0,16100,16100,0,2092152,2024.10.17
127,The Worst,Justin Moore,6,6,0,6,0,15700,15700,0,184603,2024.10.17
128,Mia Down In Mia,George Strait,2,2,0,2,0,14800,14800,0,119787,2024.10.17
129,Any Given Friday Night,Luke Combs,2,0,2,1,0,14600,0,14600,124260,2024.10.17
130,New To Country,Bailey Zimmerman,6,-19,25,2,0,14600,-102100,116700,1553281,2024.10.17
131,Unpretty,Jelly Roll,4,4,0,3,0,13900,13900,0,1624740,2024.10.17
132,Roulette On The Heart,Conner Smith,11,-2,13,3,0,13700,-400,14100,324063,2024.10.17
133,There’s A Waylon,Larry Fleet,1,0,1,1,0,13600,8000,5600,6950,2024.10.17
134,Everyone Bleeds,Jelly Roll,3,3,0,3,0,13300,13300,0,1563322,2024.10.17
135,Bury Me In This Bar,Dalton Dover,22,-13,35,5,0,12400,-28400,40800,10306,2024.10.17
136,A Lot More Free,Max Mcnown,9,2,7,3,0,12200,-3400,15600,3284144,2024.10.17
137,Your Healing Is On The Way,Greater Vision,2,2,0,2,0,11800,11800,0,2443,2024.10.17
138,Be Ready,Karen Peck & New River,2,0,2,2,0,11800,0,11800,10599,2024.10.17
139,Heart Of A Small Town,Tim Dugger,3,1,2,2,0,11500,3100,8400,9671,2024.10.17
140,Three Drinks Behind,George Strait,1,1,0,1,0,11400,11400,0,283476,2024.10.17
141,Feelin' Country,Thomas Rhett,3,-1,4,1,0,11300,4000,7300,314681,2024.10.17
142,Forever Bound,12/Oc,6,1,5,1,0,11100,-100,11200,1722,2024.10.17
143,Someone In This Room,Jessie Murph,1,1,0,1,0,10600,10600,0,1394575,2024.10.17
144,Good Ol' Boys,Mae Estes,9,-1,10,1,0,10600,-15600,26200,97491,2024.10.17
145,Thank God I'M Not God,Nathan Woodard,1,1,0,1,0,9900,9900,0,3,2024.10.17
145,Whiskey Friends,Morgan Wallen,1,1,0,1,0,9900,9900,0,859748,2024.10.17
145,5 Leaf Clover,Luke Combs,1,1,0,1,0,9900,9900,0,752458,2024.10.17
148,Little Light,Jelly Roll,2,2,0,2,0,9700,9700,0,1040864,2024.10.17
149,The Good I'Ll Do,Zach Bryan,3,-2,5,1,0,8900,-4000,12900,1832502,2024.10.17
150,Oklahoma Sooner,Jake Banfield,3,0,3,1,0,8600,-3700,12300,1785,2024.10.17
151,You Know It’s Coming,Justin Moore,1,1,0,1,0,8500,8500,0,133495,2024.10.17
152,John Deere Green,"HIXTAPE Feat. HARDY, Morgan Wallen, Joe Diffie",1,-2,3,1,0,8200,-9800,18000,0,2024.10.17
153,Star Spangled Banner,Mickey Guyton,1,0,1,1,0,7900,-1300,9200,0,2024.10.17
154,People Like Us,Tim McGraw,2,2,0,2,0,7700,7700,0,564977,2024.10.17
155,"Salt, Lime & Tequila",Ryan Griffin,2,-1,3,1,0,7700,-2600,10300,42353,2024.10.17
156,No One Greater,Browns,1,1,0,1,0,7500,7500,0,1358,2024.10.17
156,A Hundred Different Altars,Steeles,1,1,0,1,0,7500,7500,0,614,2024.10.17
158,Means Something To Me,Tate Emmons,1,0,1,1,0,7500,0,7500,391,2024.10.17
159,Go To Hell,Post Malone,2,2,0,1,0,7400,7400,0,282460,2024.10.17
159,Grace,Jelly Roll,2,2,0,1,0,7400,7400,0,1293304,2024.10.17
161,"Tele-Man (Feat. Vince Gill, Jo)",Ira Dean & Ronnie Dunn,1,1,0,1,0,7300,7300,0,27333,2024.10.17
161,Broken Heart Thing (Feat. Dust,Madeline Merlo,1,1,0,1,0,7300,7300,0,682022,2024.10.17
163,Run Your Mouth,Gavin Adcock,2,1,1,2,0,7300,3400,3900,2780735,2024.10.17
164,Change My Mind,Riley Green,1,0,1,1,0,7300,2600,4700,1474149,2024.10.17
165,Am I The Only One,Aaron Lewis,2,0,2,1,0,6600,400,6200,363629,2024.10.17
166,He Pilots My Ship,Tribute Quartet,1,1,0,1,0,6200,6200,0,6984,2024.10.17
166,That Is That,Adams Voice,1,1,0,1,0,6200,6200,0,5,2024.10.17
166,Hallelujah For The Blood,Paid In Full,1,1,0,1,0,6200,6200,0,210,2024.10.17
166,"I, John",Blackwood Brothers Quartet,1,1,0,1,0,6200,6200,0,47,2024.10.17
166,Tell The Grave,Perrys,1,1,0,1,0,6200,6200,0,1922,2024.10.17
166,Grateful For The Gospel,Brian Free & Assurance,1,1,0,1,0,6200,6200,0,8734,2024.10.17
166,Address Change Notification,Southbound,1,1,0,1,0,6200,6200,0,3810,2024.10.17
173,Fake Id,Sydney Mack,4,0,4,1,0,6200,1000,5200,888,2024.10.17
174,The End,Endless Highway,1,0,1,1,0,6200,0,6200,163,2024.10.17
174,In God's Time,Jordan Family Band,1,0,1,1,0,6200,0,6200,1779,2024.10.17
174,Like Jesus Can,Taranda Greene,1,0,1,1,0,6200,0,6200,861,2024.10.17
174,Be The Reason,Steeles,1,0,1,1,0,6200,0,6200,3541,2024.10.17
174,Come To The Well,Inspirations,1,0,1,1,0,6200,0,6200,5445,2024.10.17
174,He Bought Me,Old Paths,1,0,1,1,0,6200,0,6200,574,2024.10.17
174,All Things,Sound,1,0,1,1,0,6200,0,6200,1091,2024.10.17
174,My God,Scotty Inman,1,0,1,1,0,6200,0,6200,16070,2024.10.17
174,Think About There,Greater Vision,1,0,1,1,0,6200,0,6200,12038,2024.10.17
174,We Are The Church,Ernie Haase & Signature Sound,1,0,1,1,0,6200,0,6200,16888,2024.10.17
174,Wings Of A Dove,Jonathan Wilburn,1,0,1,1,0,6200,0,6200,0,2024.10.17
185,Mansions,Sound Street,1,0,1,1,0,6200,-3700,9900,726,2024.10.17
186,Back To The Garden,Erwins,1,-1,2,1,0,6200,-7500,13700,0,2024.10.17
186,Help Is On The Way,Gold City,1,-1,2,1,0,6200,-7500,13700,16370,2024.10.17
188,Long Live Cowgirls,Ian Munsick & Cody Johnson,2,-8,10,2,0,6200,1200,5000,601529,2024.10.17
189,Whatever Gets You Through It,Morgan Gruber,6,-1,7,1,0,5900,300,5600,143,2024.10.17
190,You'll Always Be My Baby (Written For Daughters' Weddings),Alan Jackson,2,0,2,1,0,5800,2400,3400,33297,2024.10.17
191,Steal My Thunder,Conner Smith,3,2,1,1,0,5700,3800,1900,544404,2024.10.17
192,Now I Do,Bailey Taylor,4,2,2,1,0,5600,2400,3200,116,2024.10.17
193,Gettin' Ready To Go,River's Edge,1,1,0,1,0,5600,5600,0,0,2024.10.17
193,Sing Me There,Kramers,1,1,0,1,0,5600,5600,0,1254,2024.10.17
193,Black Leather Bind,Justin Cole,1,1,0,1,0,5600,5600,0,14,2024.10.17
193,What Are You Waiting For,Tim Menzies,1,1,0,1,0,5600,5600,0,57,2024.10.17
193,Wasted Words,Craguns,1,1,0,1,0,5600,5600,0,293,2024.10.17
193,Made A Mess,Tim Menzies,1,1,0,1,0,5600,5600,0,808,2024.10.17
193,Something To Shout About,Down East Boys,1,1,0,1,0,5600,5600,0,3291,2024.10.17
193,Door Wide Open,Gordon Mote,1,1,0,1,0,5600,5600,0,232,2024.10.17
193,You Can'T Hurry God,Perrys,1,1,0,1,0,5600,5600,0,8311,2024.10.17
193,Everything Good,Zane & Donna King,1,1,0,1,0,5600,5600,0,0,2024.10.17
193,He Forgives And Forgets,Gordon Mote,1,1,0,1,0,5600,5600,0,984,2024.10.17
193,This Ain'T That Song,Blake & Jenna Bolerjack,1,1,0,1,0,5600,5600,0,18,2024.10.17
193,Heaven's Getting Sweeter Each Day,"Kristen Bearfield & Brooke Aldridge Feat. Darin Aldridge, Mark Fain & Andy Leftw",1,1,0,1,0,5600,5600,0,0,2024.10.17
193,Country Faith,Kristen Leigh Bearfield Feat. Karen Peck,1,1,0,1,0,5600,5600,0,0,2024.10.17
193,One Wide River To Cross,Mark Bishop,1,1,0,1,0,5600,5600,0,263,2024.10.17
193,Praying For The Prodigal,Kingsmen,1,1,0,1,0,5600,5600,0,1855,2024.10.17
193,Nobody Knows Better Than Me,Tiffany Coburn,1,1,0,1,0,5600,5600,0,0,2024.10.17
193,I Left It In The Water,Southbound,1,1,0,1,0,5600,5600,0,14610,2024.10.17
193,I'd Rather Hear Preachin',Greater Vision,1,1,0,1,0,5600,5600,0,0,2024.10.17
193,Count For Something,Jay Stone Singers,1,1,0,1,0,5600,5600,0,14,2024.10.17
193,When My Baby's In Boots,Randall King,1,1,0,1,0,5600,5600,0,0,2024.10.17
193,Bigger On The Inside,Legacy Five,1,1,0,1,0,5600,5600,0,9191,2024.10.17
193,I Want To Get Closer,Tribute Quartet,1,1,0,1,0,5600,5600,0,610,2024.10.17
216,Back 40 Back,Luke Combs,2,1,1,1,0,5600,2800,2800,134343,2024.10.17
217,Where That Came From,Randy Travis,1,0,1,1,0,5600,3800,1800,271114,2024.10.17
218,"What I Don'T Know How To Do, Jesus Does",Mark Bishop,1,0,1,1,0,5600,0,5600,3876,2024.10.17
218,Love Me Back To Life,Jordan Family Band,1,0,1,1,0,5600,0,5600,479,2024.10.17
218,Hole In The Heart,Nelons,1,0,1,1,0,5600,0,5600,0,2024.10.17
218,Praise The Lord,Collingsworth Family,1,0,1,1,0,5600,0,5600,25238,2024.10.17
218,The Things We Cannot Change,LeFevre Quartet,1,0,1,1,0,5600,0,5600,2066,2024.10.17
218,Man On The Middle Cross,Scotty Inman,1,0,1,1,0,5600,0,5600,0,2024.10.17
218,"Jesus 1, Death 0",Truesong,1,0,1,1,0,5600,0,5600,0,2024.10.17
218,Keep Turning Your Eyes On Jesus,Booth Brothers,1,0,1,1,0,5600,0,5600,0,2024.10.17
218,Jesus Walked In,Joseph Habedank,1,0,1,1,0,5600,0,5600,0,2024.10.17
218,Big Ole Stone (Victory),Triumphant Quartet,1,0,1,1,0,5600,0,5600,4020,2024.10.17
218,Why Wouldn't I Run,Lee Park Worship,1,0,1,1,0,5600,0,5600,0,2024.10.17
218,Cross Over,Allens,1,0,1,1,0,5600,0,5600,191,2024.10.17
218,More Than You Know,Tim Livingston,1,0,1,1,0,5600,0,5600,23,2024.10.17
231,Me To Me,Morgan Wallen,2,0,2,1,0,5600,-1400,7000,592107,2024.10.17
1,Miles On It,Marshmello & Kane Brown,8707,1212,7495,144,0,31509800,3766300,27743500,10532913,2024.10.24
2,I Am Not Okay,Jelly Roll,8243,204,8039,145,0,30327400,928900,29398500,10912444,2024.10.24
3,Pour Me A Drink,Post Malone,7132,-721,7853,145,0,28550900,-1196100,29747000,5023696,2024.10.24
4,Lies Lies Lies,Morgan Wallen,6990,486,6504,145,0,23891100,1328800,22562300,13708075,2024.10.24
5,A Bar Song (Tipsy),Shaboozey,5462,-478,5940,141,0,22230600,-1209600,23440200,24261643,2024.10.24
6,This Is My Dirt,Justin Moore,5563,-2377,7940,145,0,18923000,-8065200,26988200,516824,2024.10.24
7,Gonna Love You,Parmalee,5463,22,5441,145,0,18069700,-243000,18312700,434584,2024.10.24
8,You Look Like You Love Me,Ella Langley & Riley Green,4815,150,4665,145,0,17327300,749200,16578100,7959152,2024.10.24
9,Austin,Dasha,4892,-44,4936,142,0,16399300,-102400,16501700,8198655,2024.10.24
10,Beautiful As You,Thomas Rhett,4835,243,4592,145,0,16050700,1076900,14973800,4150098,2024.10.24
11,One Bad Habit,Tim McGraw,4544,200,4344,145,0,15482200,1150400,14331800,408309,2024.10.24
12,Cowboy Songs,George Birge,4543,247,4296,145,0,14851600,1015100,13836500,589551,2024.10.24
13,Love Somebody,Morgan Wallen,2999,2986,13,142,0,13340200,13314500,25700,31211115,2024.10.24
14,High Road,Koe Wetzel,3939,236,3703,143,0,12960800,520100,12440700,7686506,2024.10.24
15,Bigger Houses,Dan + Shay,3747,197,3550,145,0,12423900,951600,11472300,743635,2024.10.24
16,Boys Back Home,Dylan Marlowe Feat. Dylan Scott,3500,308,3192,143,0,11354200,1318600,10035600,2066976,2024.10.24
17,Sounds Like The Radio,Zach Top,3516,354,3162,144,0,11136700,820300,10316400,2015448,2024.10.24
18,Wind Up Missin' You,Tucker Wetmore,3460,185,3275,145,0,11118100,530900,10587200,6636208,2024.10.24
19,Messed Up As Me,Keith Urban,3581,49,3532,145,0,10333300,146700,10186600,1791570,2024.10.24
20,Think I’m In Love With You,Chris Stapleton,2950,93,2857,144,0,9739600,403000,9336600,5333019,2024.10.24
21,Damn Good Day To Leave,Riley Green,3024,-13,3037,145,0,9023600,91300,8932300,1500259,2024.10.24
22,Guy For That,Post Malone,2272,274,1998,138,0,7962800,784800,7178000,5880129,2024.10.24
23,American Girl,Dierks Bentley,2441,21,2420,143,0,7897900,-52000,7949900,166833,2024.10.24
24,4x4xu,Lainey Wilson,2152,330,1822,145,0,6694100,812600,5881500,3251458,2024.10.24
25,I Ain'T Sayin',Jordan Davis,1956,307,1649,142,0,5659600,1050000,4609600,3230562,2024.10.24
26,This Town's Been Too Good To Us,Dylan Scott,1904,-46,1950,142,0,5553700,196600,5357100,2288035,2024.10.24
27,Breakin' In Boots,Matt Stell,2203,142,2061,142,0,5410400,307700,5102700,204540,2024.10.24
28,Friends Like That,John Morgan Feat. Jason Aldean,1954,57,1897,126,0,4970100,157200,4812900,723651,2024.10.24
29,Find Another Bar,Chris Lane,1880,-138,2018,141,0,4736500,-288900,5025400,81438,2024.10.24
30,Forever To Me,Cole Swindell,1491,63,1428,117,0,4377900,373100,4004800,780214,2024.10.24
31,Holy Smokes,Bailey Zimmerman,1248,10,1238,98,0,4342600,30500,4312100,4229074,2024.10.24
32,I'm Gonna Love You,Cody Johnson,1238,28,1210,112,0,4114400,-80300,4194700,5928555,2024.10.24
33,Am I Okay?,Megan Moroney,1125,65,1060,92,0,3789800,126700,3663100,5161907,2024.10.24
34,Hometown Home,Locash,1356,-22,1378,112,0,3755500,326200,3429300,82071,2024.10.24
35,Life With You,Kelsey Hart,1709,166,1543,119,0,3676300,257500,3418800,1074457,2024.10.24
36,Whatcha See Is Whatcha Get,Chris Janson,1564,12,1552,142,0,3534500,-67700,3602200,111420,2024.10.24
37,Whiskey Drink,Jason Aldean,1414,38,1376,118,0,3454400,197600,3256800,951822,2024.10.24
38,Just To Say We Did,Kenny Chesney,1508,156,1352,129,0,3409800,-50100,3459900,356305,2024.10.24
39,Wranglers,Miranda Lambert,1521,27,1494,134,0,3085100,-45500,3130600,341377,2024.10.24
40,Coming Home,Old Dominion,1094,-13,1107,120,0,2651600,139600,2512000,1508130,2024.10.24
41,Cowboys Cry Too,Kelsea Ballerini,1301,140,1161,132,0,2486400,222900,2263500,2873331,2024.10.24
42,Single Again,Josh Ross,1258,105,1153,104,0,2465500,250900,2214600,2305277,2024.10.24
43,I Tried A Ring On,Tigirlily Gold,1479,12,1467,142,0,2447900,47700,2400200,147791,2024.10.24
44,Fall Of Summer,Scotty McCreery,1115,40,1075,108,0,2225700,-119000,2344700,356281,2024.10.24
45,Truck On Fire,Carly Pearce,991,5,986,112,0,2131500,59200,2072300,845201,2024.10.24
46,Darkest Hour (Helene Edit),Eric Church,887,585,302,102,0,2003200,1359400,643800,490466,2024.10.24
47,Heavens To Betsy,Jackson Dean,805,105,700,92,0,1796400,337900,1458500,373985,2024.10.24
48,Friday Night Heartbreaker,Jon Pardi,579,-1,580,78,0,1576100,18200,1557900,440004,2024.10.24
49,Everything I Need,Chayce Beckham,773,29,744,72,0,1548500,66700,1481800,235472,2024.10.24
50,Country Back,Randy Houser,830,-18,848,86,0,1344400,-181100,1525500,12597,2024.10.24
51,Country House,Sam Hunt,635,35,600,81,0,1271800,16500,1255300,233378,2024.10.24
52,I Never Lie,Zach Top,236,15,221,18,0,1265700,-242400,1508100,6516382,2024.10.24
53,Love The Leavin',Drew Parker,496,29,467,25,0,1262300,38900,1223400,64527,2024.10.24
54,Park,Tyler Hubbard,637,73,564,80,0,1243800,81400,1162400,830870,2024.10.24
55,Over When We'Re Sober,Brantley Gilbert,656,24,632,83,0,1243400,72500,1170900,667542,2024.10.24
56,Devil You Know,Tyler Braden,442,-43,485,42,0,1190400,7000,1183400,3939855,2024.10.24
57,Truck Still Works,Brad Paisley,545,26,519,64,0,1143700,25700,1118000,306514,2024.10.24
58,Bones,Russell Dickerson,670,18,652,85,0,1139100,65800,1073300,1163629,2024.10.24
59,What Kinda Man,Parker Mccollum,517,36,481,64,0,1124500,4800,1119700,954380,2024.10.24
60,This Heart,Corey Kent,563,1,562,62,0,1075700,-187100,1262800,784298,2024.10.24
61,Would If I Could,Ernest Feat. Lainey Wilson,401,35,366,63,0,984300,123000,861300,815143,2024.10.24
62,Relapse,Warren Zeiders,416,30,386,38,0,840700,202400,638300,3658952,2024.10.24
63,Worst Way,Riley Green,85,18,67,20,0,790700,45600,745100,5669143,2024.10.24
64,I Could Be That Rain,Randall King,491,20,471,62,0,758500,-82400,840900,100387,2024.10.24
65,Better Than You,Joe Nichols & Annie Bosko,466,101,365,71,0,618200,175100,443100,108176,2024.10.24
66,Wine Into Whiskey,Tucker Wetmore,54,-12,66,6,0,460100,-104800,564900,4612281,2024.10.24
67,Golden Child,Meghan Patrick,421,60,361,58,0,425100,88800,336300,54984,2024.10.24
68,Highway,Shaboozey,182,162,20,30,0,349400,308200,41200,931315,2024.10.24
69,Darlin',Chase Matthew,238,121,117,38,0,312900,157800,155100,3250377,2024.10.24
70,Hung Up On You,Bryce Leatherwood,285,36,249,46,0,301800,64000,237800,23085,2024.10.24
71,Not Today,Mitchell Tenpenny,343,25,318,50,0,300900,5500,295400,405904,2024.10.24
72,If I Die Before You,Chris Lane,59,2,57,58,0,284800,33300,251500,214065,2024.10.24
73,Backseat Driver,Kane Brown,75,-54,129,11,0,265400,-286500,551900,1998425,2024.10.24
74,Liar,Jelly Roll,88,31,57,4,0,260400,92100,168300,5743935,2024.10.24
75,Wolves Cry,Bryan Martin,105,46,59,17,0,258800,64200,194600,891480,2024.10.24
76,I Got A Problem,Drake Milligan,62,-1,63,5,0,202800,-3600,206400,47321,2024.10.24
77,Just Like Johnny,Redferrin,181,18,163,22,0,194100,-4200,198300,3529158,2024.10.24
78,Pink Skies,Zach Bryan,85,-20,105,7,0,194000,-58600,252600,13940159,2024.10.24
79,Strangers,Kameron Marlowe & Ella Langley,145,-90,235,23,0,166300,-152000,318300,858991,2024.10.24
80,Can'T Help My Country,Tiera Kennedy,55,-51,106,40,0,166100,-193100,359200,7979,2024.10.24
81,Songs About Whiskey,Anne Wilson,105,-12,117,15,0,163900,-4800,168700,138876,2024.10.24
82,How Is She,Cole Swindell,21,5,16,1,0,156700,35800,120900,35768,2024.10.24
83,Wrong Ones,Post Malone,34,-5,39,6,0,146600,3800,142800,1712569,2024.10.24
84,The Devil I Know,Ashley McBryde,59,11,48,6,0,145800,-800,146600,127475,2024.10.24
85,Beatles And Eagles,Frontmen,200,0,200,29,0,133300,-14600,147900,899,2024.10.24
86,Losers,Post Malone,40,-21,61,4,0,119100,-50900,170000,4577552,2024.10.24
87,Now Or Never,Corey Kent,27,2,25,1,0,99100,8800,90300,1986738,2024.10.24
88,Wondering Why,Red Clay Strays,17,-7,24,4,0,98900,-16500,115400,4252550,2024.10.24
89,Things I Take For Granted,Larry Fleet,65,2,63,9,0,98800,-2800,101600,424387,2024.10.24
90,Break Mine,Brothers Osborne,33,-7,40,4,0,89900,-10200,100100,290667,2024.10.24
91,New Kind Of Emotion,Runaway June,49,49,0,49,0,88200,88200,0,34072,2024.10.24
92,Work Boots,Cody Johnson,7,4,3,1,0,88000,60700,27300,251559,2024.10.24
93,Cozy,Braxton Keith,20,2,18,4,0,87200,11800,75400,1379668,2024.10.24
94,Spin You Around (1/24),Morgan Wallen,25,-5,30,3,0,85800,-12700,98500,5190307,2024.10.24
95,Sunday In the South,Shenandoah,17,-14,31,2,0,83200,-92000,175200,239708,2024.10.24
96,Life Right Now,Caitlyn Smith,48,48,0,48,0,76700,76700,0,66973,2024.10.24
97,The Star-Spangled Banner,Chris Stapleton,14,3,11,13,0,71400,22000,49400,72407,2024.10.24
98,Hey Mercedes,Post Malone,6,6,0,1,0,70600,70600,0,417907,2024.10.24
99,A Lot More Free,Max Mcnown,21,12,9,2,0,61000,48800,12200,3153964,2024.10.24
100,Never Been Over,Darius Rucker,28,-12,40,4,0,58400,-13400,71800,138618,2024.10.24
101,Pray All The Way Home,Austin Snell,38,0,38,6,0,58100,-4800,62900,707205,2024.10.24
102,Let 'Em Talk,Ty Myers,17,1,16,2,0,57500,10400,47100,1257388,2024.10.24
103,Good On You,Priscilla Block,47,-8,55,8,0,55400,-29300,84700,244953,2024.10.24
104,Broadway Girls,Lil Durk Feat. Morgan Wallen,12,-4,16,2,0,51600,-14100,65700,4974371,2024.10.24
105,Don'T Mind If I Do,Riley Green,20,20,0,18,0,50400,50400,0,4756149,2024.10.24
106,That's Texas,Cody Johnson,5,4,1,1,0,49000,47200,1800,225012,2024.10.24
107,Change My Mind,Riley Green,17,16,1,17,0,46100,38800,7300,2553033,2024.10.24
108,American Nights,Zach Bryan,18,-1,19,1,0,43600,2800,40800,3171563,2024.10.24
109,Man Upstairs,Tim Dugger,10,2,8,1,0,43400,8400,35000,1524,2024.10.24
110,Maxed Out,Bayker Blankenship,7,-2,9,1,0,40500,-22300,62800,3211504,2024.10.24
111,Chip Off The Ol' Block,Riley Green,17,17,0,17,0,40300,40300,0,756345,2024.10.24
111,Looking Back On This,Riley Green,17,17,0,17,0,40300,40300,0,716960,2024.10.24
111,Too Early To Drink,Riley Green,17,17,0,17,0,40300,40300,0,820718,2024.10.24
111,Waitin' All Day,Riley Green,17,17,0,17,0,40300,40300,0,800441,2024.10.24
111,Jesus Saves,Riley Green,17,17,0,17,0,40300,40300,0,1402253,2024.10.24
111,Torn,Riley Green,17,17,0,17,0,40300,40300,0,793395,2024.10.24
111,Rather Be,Riley Green,17,17,0,17,0,40300,40300,0,1687402,2024.10.24
111,Reel Problems,Riley Green,17,17,0,17,0,40300,40300,0,1686199,2024.10.24
111,Turnin' Dirt,Riley Green,17,17,0,17,0,40300,40300,0,937238,2024.10.24
120,Way Out Here,Riley Green,16,16,0,16,0,38900,38900,0,734797,2024.10.24
121,That's A Mistake,Riley Green,14,14,0,14,0,38900,38900,0,1374879,2024.10.24
122,Go To Hell,Post Malone,2,0,2,1,0,37900,30500,7400,251144,2024.10.24
123,Me To Me,Morgan Wallen,14,12,2,14,0,36800,31200,5600,735735,2024.10.24
124,Goes Without Saying,Post Malone,4,3,1,2,0,36200,34400,1800,793469,2024.10.24
125,Mint Tea,Johnny Blue Skies,12,-3,15,1,0,36200,9900,26300,0,2024.10.24
126,Country Song Came On,Luke Bryan,7,7,0,3,0,33400,33400,0,247730,2024.10.24
127,You In A Honky Tonk,Randall King,3,0,3,1,0,33100,-6600,39700,351238,2024.10.24
128,Young Man,Greylan James,23,-5,28,3,0,33000,-27500,60500,33218,2024.10.24
129,Bury Me In This Bar,Dalton Dover,30,8,22,6,0,30900,18500,12400,9588,2024.10.24
130,Greener Pasture,Carter Faith,11,1,10,1,0,29800,5400,24400,93275,2024.10.24
131,Can I Get An Amen,The War And Treaty,13,13,0,13,0,29200,29200,0,14362,2024.10.24
132,Hey Driver,Zach Bryan Feat. The War and Treaty,11,4,7,2,0,28000,10400,17600,3767608,2024.10.24
133,You And The Whiskey,Ben Burgess & Brandon Jane,34,34,0,17,0,27600,27600,0,0,2024.10.24
134,Two Steppin' On The Moon,Josh Turner,4,4,0,4,0,22000,22000,0,119255,2024.10.24
135,Jesus Walked In,Joseph Habedank,3,2,1,3,0,21700,16100,5600,0,2024.10.24
136,Train Of Thought,Vincent Mason,7,0,7,1,0,21300,-24700,46000,0,2024.10.24
137,What Don't Belong To Me,Post Malone,2,2,0,1,0,21100,21100,0,2040334,2024.10.24
138,Can Down,Mike Ryan,2,2,0,2,0,19900,19900,0,25909,2024.10.24
139,Gettin' By,Flatland Cavalry,1,1,0,1,0,19900,19900,0,102077,2024.10.24
139,Follow,William Beckmann,1,1,0,1,0,19900,19900,0,7969,2024.10.24
139,Night Time Is My Time,Jake Worthington,1,1,0,1,0,19900,19900,0,1753,2024.10.24
142,When My Baby's In Boots,Randall King,1,0,1,1,0,19900,14300,5600,0,2024.10.24
143,Hide My Gun,Post Malone,2,2,0,1,0,19800,19800,0,1089153,2024.10.24
144,Sunrise Tells The Story,Midland,2,1,1,1,0,19800,18000,1800,110103,2024.10.24
145,I Left It In The Water,Southbound,3,2,1,3,0,19300,13700,5600,10751,2024.10.24
146,Dead At The Honky Tonk,Post Malone,2,2,0,1,0,19200,19200,0,380288,2024.10.24
147,Killed A Man,Post Malone,1,1,0,1,0,18000,18000,0,289562,2024.10.24
148,Star Spangled Banner,Mickey Guyton,2,1,1,2,0,17700,9800,7900,0,2024.10.24
149,Roulette On The Heart,Conner Smith,15,4,11,3,0,16400,2700,13700,311575,2024.10.24
150,Loud and Heavy,Cody Jinks,6,-1,7,1,0,16300,-1400,17700,1253410,2024.10.24
151,Beer Ain't One,Justin Moore,6,5,1,6,0,15700,12200,3500,210950,2024.10.24
152,Back To Texas,Post Malone,2,-1,3,1,0,15400,-11900,27300,246498,2024.10.24
153,Any Given Friday Night,Luke Combs,2,0,2,1,0,14600,0,14600,165516,2024.10.24
154,Hippies And Cowboys,Sarah Darling,17,-15,32,17,0,13800,-18500,32300,849,2024.10.24
155,Baby Daddy's Weekend,Elle King,11,-1,12,3,0,13400,-5700,19100,28752,2024.10.24
156,Heart Of A Small Town,Tim Dugger,3,0,3,1,0,13300,1800,11500,8738,2024.10.24
157,Revival Broke Out,Gaither Vocal Band,2,2,0,2,0,13100,13100,0,3237,2024.10.24
158,Hole In The Heart,Nelons,2,1,1,2,0,13100,7500,5600,0,2024.10.24
159,Forever Bound,12/Oc,6,0,6,1,0,12500,1400,11100,1877,2024.10.24
160,You Can'T Hurry God,Perrys,2,1,1,2,0,11800,6200,5600,16388,2024.10.24
161,Help Is On The Way,Gold City,2,1,1,2,0,11800,5600,6200,19652,2024.10.24
162,Mia Down In Mia,George Strait,1,-1,2,1,0,11400,-3400,14800,122301,2024.10.24
163,The Good I'Ll Do,Zach Bryan,3,0,3,1,0,11300,2400,8900,2142181,2024.10.24
164,What Are You Waiting For,Tim Menzies,2,1,1,1,0,11200,5600,5600,30,2024.10.24
165,Good Ol' Boys,Mae Estes,8,-1,9,1,0,11200,600,10600,73235,2024.10.24
166,"Salt, Lime & Tequila",Ryan Griffin,3,1,2,1,0,11000,3300,7700,48607,2024.10.24
167,Runnin' Through That T,Thomas Edwards (Country),1,1,0,1,0,10800,10800,0,3488,2024.10.24
168,Learning As I Go,Kip Moore,2,2,0,1,0,10000,10000,0,294584,2024.10.24
169,Here Comes Jesus,Jeff & Sheri Easter,1,1,0,1,0,9900,9900,0,20106,2024.10.24
169,M-E-X-I-C-O,Post Malone,1,1,0,1,0,9900,9900,0,621710,2024.10.24
169,Strong,Anne Wilson,1,1,0,1,0,9900,9900,0,956496,2024.10.24
169,Nosedive,Post Malone,1,1,0,1,0,9900,9900,0,1704530,2024.10.24
169,Storms I Never See,Peach Goldman,1,1,0,1,0,9900,9900,0,10707,2024.10.24
169,Red Words,Erwins,1,1,0,1,0,9900,9900,0,10715,2024.10.24
175,Oklahoma Smokeshow,Zach Bryan,2,-6,8,2,0,9600,-10200,19800,5877048,2024.10.24
176,Decoration,Jillian Riscoe,4,2,2,1,0,9500,9100,400,4,2024.10.24
177,Damn Good Time,Jordan Davis,1,1,0,1,0,9500,9500,0,170824,2024.10.24
178,Heartfirst,Kelsea Ballerini,2,2,0,1,0,8800,8800,0,218052,2024.10.24
179,Last Night Lonely,Dylan Marlowe,4,4,0,4,0,8700,8700,0,0,2024.10.24
180,Use Me,Zach Top,3,3,0,1,0,8600,8600,0,1251332,2024.10.24
181,Winning Streak,Jelly Roll,3,-11,14,2,0,8400,-47400,55800,4579362,2024.10.24
182,Time's Ticking,Justin Moore,2,-7,9,1,0,8300,-17400,25700,409202,2024.10.24
183,Oklahoma Sooner,Jake Banfield,4,1,3,1,0,8100,-500,8600,2030,2024.10.24
184,Scars In Heaven,Casting Crowns,1,1,0,1,0,7500,7500,0,378370,2024.10.24
184,Jeans & Jesus,Sound,1,1,0,1,0,7500,7500,0,0,2024.10.24
184,Been With Jesus,Craguns,1,1,0,1,0,7500,7500,0,57,2024.10.24
184,Until It Was Me,Doug Anderson,1,1,0,1,0,7500,7500,0,4438,2024.10.24
188,Bad Luck,Zach Top,1,0,1,1,0,7500,5100,2400,2022474,2024.10.24
189,Nine Ball,Zach Bryan,2,1,1,1,0,7400,5600,1800,3877611,2024.10.24
189,Dive,Luke Combs,2,1,1,1,0,7400,5600,1800,1001884,2024.10.24
191,Friday Night (Feat. Troy Aikman),Wade Bowen,2,2,0,2,0,7300,7300,0,2011,2024.10.24
192,Time On My Hands,Ringo Starr,1,1,0,1,0,7300,7300,0,122600,2024.10.24
193,Peaceful Place,Leon Bridges,1,1,0,1,0,7200,7200,0,271529,2024.10.24
193,Capricorn,Vampire Weekend,1,1,0,1,0,7200,7200,0,115408,2024.10.24
195,Yesterday's Burn,The War And Treaty,2,2,0,1,0,6800,6800,0,2208,2024.10.24
196,Lonely Road,Jelly Roll & Mgk,7,5,2,6,0,6600,3300,3300,7103987,2024.10.24
197,First Rodeo,Kelsea Ballerini,2,2,0,2,0,6600,6600,0,1275697,2024.10.24
198,Country Classic,Kane Brown,1,1,0,1,0,6300,6300,0,514475,2024.10.24
199,Old Blind Bartimaeus,Jonathan Wilburn,1,1,0,1,0,6200,6200,0,0,2024.10.24
199,He Sent Him For Me,Inspirations,1,1,0,1,0,6200,6200,0,0,2024.10.24
199,There Is A Name,LeFevre Quartet,1,1,0,1,0,6200,6200,0,9213,2024.10.24
199,There's A River,High Road,1,1,0,1,0,6200,6200,0,0,2024.10.24
203,Bigger On The Inside,Legacy Five,1,0,1,1,0,6200,600,5600,10339,2024.10.24
203,The Things We Cannot Change,LeFevre Quartet,1,0,1,1,0,6200,600,5600,5571,2024.10.24
205,Think About There,Greater Vision,1,0,1,1,0,6200,0,6200,13585,2024.10.24
205,He Bought Me,Old Paths,1,0,1,1,0,6200,0,6200,1302,2024.10.24
205,In God's Time,Jordan Family Band,1,0,1,1,0,6200,0,6200,2984,2024.10.24
205,Back To The Garden,Erwins,1,0,1,1,0,6200,0,6200,0,2024.10.24
205,Wings Of A Dove,Jonathan Wilburn,1,0,1,1,0,6200,0,6200,0,2024.10.24
205,Mansions,Sound Street,1,0,1,1,0,6200,0,6200,722,2024.10.24
205,Grateful For The Gospel,Brian Free & Assurance,1,0,1,1,0,6200,0,6200,13185,2024.10.24
205,All Things,Sound,1,0,1,1,0,6200,0,6200,1252,2024.10.24
205,Come To The Well,Inspirations,1,0,1,1,0,6200,0,6200,7380,2024.10.24
205,Be The Reason,Steeles,1,0,1,1,0,6200,0,6200,3910,2024.10.24
205,"I, John",Blackwood Brothers Quartet,1,0,1,1,0,6200,0,6200,58,2024.10.24
205,We Are The Church,Ernie Haase & Signature Sound,1,0,1,1,0,6200,0,6200,19514,2024.10.24
1,I Am Not Okay,Jelly Roll,8889,646,8243,145,0,33832200,3504800,30327400,10074402,2024.10.31
2,Miles On It,Marshmello & Kane Brown,7541,-1166,8707,144,0,30352600,-1157200,31509800,8687986,2024.10.31
3,Pour Me A Drink,Post Malone,6958,-174,7132,145,0,28706400,155500,28550900,4695559,2024.10.31
4,Lies Lies Lies,Morgan Wallen,7472,482,6990,145,0,28043800,4152700,23891100,12510143,2024.10.31
5,A Bar Song (Tipsy),Shaboozey,5405,-57,5462,141,0,22775900,545300,22230600,22389771,2024.10.31
6,Gonna Love You,Parmalee,5632,169,5463,145,0,19204800,1135100,18069700,399439,2024.10.31
7,You Look Like You Love Me,Ella Langley & Riley Green,5257,442,4815,145,0,19015100,1687800,17327300,8005756,2024.10.31
8,Austin,Dasha,5447,555,4892,143,0,18510800,2111500,16399300,7924346,2024.10.31
9,Beautiful As You,Thomas Rhett,5009,174,4835,145,0,17905400,1854700,16050700,3700514,2024.10.31
10,Cowboy Songs,George Birge,4710,167,4543,145,0,16380500,1528900,14851600,603776,2024.10.31
11,One Bad Habit,Tim McGraw,4585,41,4544,145,0,16088100,605900,15482200,412943,2024.10.31
12,High Road,Koe Wetzel,4320,381,3939,144,0,14912400,1951600,12960800,7315990,2024.10.31
13,Bigger Houses,Dan + Shay,3966,219,3747,145,0,13905900,1482000,12423900,732818,2024.10.31
14,Boys Back Home,Dylan Marlowe Feat. Dylan Scott,3883,383,3500,145,0,13545300,2191100,11354200,1332988,2024.10.31
15,Wind Up Missin' You,Tucker Wetmore,3588,128,3460,145,0,12443900,1325800,11118100,7700126,2024.10.31
16,Sounds Like The Radio,Zach Top,3621,105,3516,144,0,12066500,929800,11136700,1945589,2024.10.31
17,Messed Up As Me,Keith Urban,3605,24,3581,145,0,10953700,620400,10333300,1689243,2024.10.31
18,Damn Good Day To Leave,Riley Green,3173,149,3024,145,0,10071400,1047800,9023600,948187,2024.10.31
19,Think I’m In Love With You,Chris Stapleton,2900,-50,2950,144,0,9732600,-7000,9739600,4972557,2024.10.31
20,Love Somebody,Morgan Wallen,2169,-830,2999,138,0,9166000,-4174200,13340200,21804307,2024.10.31
21,Guy For That,Post Malone,2366,94,2272,143,0,8864600,901800,7962800,5269889,2024.10.31
22,American Girl,Dierks Bentley,2303,-138,2441,143,0,7742300,-155600,7897900,169010,2024.10.31
23,4x4xu,Lainey Wilson,2377,225,2152,145,0,7546600,852500,6694100,3179419,2024.10.31
24,This Town's Been Too Good To Us,Dylan Scott,2051,147,1904,139,0,6632700,1079000,5553700,2094265,2024.10.31
25,I Ain'T Sayin',Jordan Davis,2177,221,1956,142,0,6385300,725700,5659600,4058129,2024.10.31
26,Breakin' In Boots,Matt Stell,2418,215,2203,142,0,6327300,916900,5410400,200613,2024.10.31
27,Friends Like That,John Morgan Feat. Jason Aldean,2111,157,1954,136,0,5851400,881300,4970100,714202,2024.10.31
28,Forever To Me,Cole Swindell,1784,293,1491,120,0,5742900,1365000,4377900,752451,2024.10.31
29,Holy Smokes,Bailey Zimmerman,1375,127,1248,129,0,4600800,258200,4342600,3826431,2024.10.31
30,I'm Gonna Love You,Cody Johnson,1353,115,1238,111,0,4513400,399000,4114400,6510391,2024.10.31
31,Hometown Home,Locash,1522,166,1356,118,0,4454200,698700,3755500,89814,2024.10.31
32,Am I Okay?,Megan Moroney,1181,56,1125,100,0,4301200,511400,3789800,5225424,2024.10.31
33,Life With You,Kelsey Hart,1702,-7,1709,118,0,3988000,311700,3676300,1109050,2024.10.31
34,Whatcha See Is Whatcha Get,Chris Janson,1557,-7,1564,142,0,3905100,370600,3534500,106905,2024.10.31
35,Just To Say We Did,Kenny Chesney,1414,-94,1508,128,0,3735300,325500,3409800,335143,2024.10.31
36,Whiskey Drink,Jason Aldean,1389,-25,1414,119,0,3730100,275700,3454400,725185,2024.10.31
37,Darkest Hour (Helene Edit),Eric Church,1418,531,887,101,0,3456800,1453600,2003200,539454,2024.10.31
38,Wranglers,Miranda Lambert,1564,43,1521,139,0,3328900,243800,3085100,356435,2024.10.31
39,Coming Home,Old Dominion,1165,71,1094,125,0,3042500,390900,2651600,1374774,2024.10.31
40,Single Again,Josh Ross,1329,71,1258,106,0,2998200,532700,2465500,2423831,2024.10.31
41,Fall Of Summer,Scotty McCreery,1190,75,1115,120,0,2846300,620600,2225700,662271,2024.10.31
42,I Tried A Ring On,Tigirlily Gold,1473,-6,1479,140,0,2576200,128300,2447900,140414,2024.10.31
43,Cowboys Cry Too,Kelsea Ballerini,1251,-50,1301,132,0,2554800,68400,2486400,4868608,2024.10.31
44,Truck On Fire,Carly Pearce,1055,64,991,114,0,2545100,413600,2131500,818346,2024.10.31
45,Heavens To Betsy,Jackson Dean,801,-4,805,96,0,1883000,86600,1796400,536138,2024.10.31
46,Friday Night Heartbreaker,Jon Pardi,603,24,579,84,0,1637600,61500,1576100,409553,2024.10.31
47,Everything I Need,Chayce Beckham,799,26,773,74,0,1604300,55800,1548500,230699,2024.10.31
48,What Kinda Man,Parker Mccollum,590,73,517,64,0,1501900,377400,1124500,938901,2024.10.31
49,Park,Tyler Hubbard,648,11,637,85,0,1478800,235000,1243800,810138,2024.10.31
50,Country House,Sam Hunt,695,60,635,84,0,1440300,168500,1271800,224291,2024.10.31
51,Bones,Russell Dickerson,674,4,670,85,0,1382300,243200,1139100,1068966,2024.10.31
52,I Never Lie,Zach Top,282,46,236,20,0,1307200,41500,1265700,6409015,2024.10.31
53,Devil You Know,Tyler Braden,459,17,442,41,0,1307100,116700,1190400,3908175,2024.10.31
54,Love The Leavin',Drew Parker,518,22,496,26,0,1288500,26200,1262300,63789,2024.10.31
55,Over When We'Re Sober,Brantley Gilbert,653,-3,656,82,0,1269100,25700,1243400,603053,2024.10.31
56,Truck Still Works,Brad Paisley,526,-19,545,73,0,1204900,61200,1143700,227146,2024.10.31
57,This Heart,Corey Kent,543,-20,563,61,0,1030000,-45700,1075700,711700,2024.10.31
58,Better Than You,Joe Nichols & Annie Bosko,546,80,466,100,0,957600,339400,618200,113048,2024.10.31
59,Relapse,Warren Zeiders,458,42,416,38,0,954800,114100,840700,3406505,2024.10.31
60,Would If I Could,Ernest Feat. Lainey Wilson,368,-33,401,56,0,832900,-151400,984300,622351,2024.10.31
61,I Could Be That Rain,Randall King,449,-42,491,63,0,771100,12600,758500,97355,2024.10.31
62,Tough People,Drew Baldridge,275,168,107,49,0,707900,59400,648500,136806,2024.10.31
63,Worst Way,Riley Green,79,-6,85,9,0,690500,-100200,790700,4689913,2024.10.31
64,Highway,Shaboozey,329,147,182,32,0,652500,303100,349400,905855,2024.10.31
65,Backseat Driver,Kane Brown,184,109,75,49,0,617000,351600,265400,1765974,2024.10.31
66,Wine Into Whiskey,Tucker Wetmore,68,14,54,3,0,550600,90500,460100,4704080,2024.10.31
67,Golden Child,Meghan Patrick,430,9,421,71,0,459600,34500,425100,48365,2024.10.31
68,Darlin',Chase Matthew,277,39,238,36,0,357200,44300,312900,3072331,2024.10.31
69,Liar,Jelly Roll,98,10,88,7,0,355000,94600,260400,5264313,2024.10.31
70,Not Today,Mitchell Tenpenny,353,10,343,52,0,318800,17900,300900,373655,2024.10.31
71,Wolves Cry,Bryan Martin,159,54,105,26,0,311200,52400,258800,803697,2024.10.31
72,Hung Up On You,Bryce Leatherwood,299,14,285,46,0,302500,700,301800,18832,2024.10.31
73,Pretty Good Living,Sarahbeth Taite,58,58,0,57,0,274100,274100,0,5414,2024.10.31
74,Fix What You Didn't Break,Nate Smith,65,65,0,19,0,259600,259600,0,4646052,2024.10.31
75,I Got A Problem,Drake Milligan,64,2,62,5,0,219700,16900,202800,48345,2024.10.31
76,Just Like Johnny,Redferrin,182,1,181,21,0,195400,1300,194100,3530487,2024.10.31
77,Winning Streak,Jelly Roll,30,27,3,19,0,171400,163000,8400,4020003,2024.10.31
78,Heart Burn/California Cowgirl,Annie Bosko,55,55,0,40,0,163200,163200,0,0,2024.10.31
79,Wrong Ones,Post Malone,33,-1,34,4,0,145800,-800,146600,1445491,2024.10.31
80,The Devil I Know,Ashley McBryde,56,-3,59,6,0,137400,-8400,145800,119330,2024.10.31
81,Songs About Whiskey,Anne Wilson,105,0,105,14,0,136000,-27900,163900,135547,2024.10.31
82,Now Or Never,Corey Kent,25,-2,27,1,0,114800,15700,99100,1868253,2024.10.31
83,How Is She,Cole Swindell,17,-4,21,1,0,112700,-44000,156700,35881,2024.10.31
84,Losers,Post Malone,35,-5,40,3,0,112500,-6600,119100,4542529,2024.10.31
85,Beatles And Eagles,Frontmen,162,-38,200,27,0,98100,-35200,133300,849,2024.10.31
86,The Aftermath,Carter Faith,48,48,0,48,0,95200,95200,0,36895,2024.10.31
86,Stand,Anne Wilson,48,48,0,48,0,95200,95200,0,266279,2024.10.31
88,Train Of Thought,Vincent Mason,10,3,7,1,0,93900,72600,21300,0,2024.10.31
89,Pink Skies,Zach Bryan,36,-49,85,3,0,93700,-100300,194000,13097846,2024.10.31
90,Cozy,Braxton Keith,19,-1,20,2,0,91200,4000,87200,1306749,2024.10.31
91,A Lot More Free,Max Mcnown,24,3,21,4,0,91100,30100,61000,3096606,2024.10.31
92,Sunday In the South,Shenandoah,20,3,17,2,0,90400,7200,83200,232282,2024.10.31
93,Strangers,Kameron Marlowe & Ella Langley,67,-78,145,21,0,89700,-76600,166300,824873,2024.10.31
94,Spin You Around (1/24),Morgan Wallen,29,4,25,4,0,88300,2500,85800,4855025,2024.10.31
95,Picture,Eric Church,47,47,0,47,0,84900,84900,0,0,2024.10.31
96,Haw River,Chase Rice,46,46,0,46,0,84400,84400,0,287649,2024.10.31
97,Red Daisy,Billy Strings,46,46,0,46,0,80600,80600,0,42516,2024.10.31
98,Carolina To Me,Scotty McCreery,43,43,0,43,0,80200,80200,0,30299,2024.10.31
99,Hippies And Cowboys,Sarah Darling,102,85,17,17,0,69600,55800,13800,505,2024.10.31
100,Break Mine,Brothers Osborne,30,-3,33,2,0,69100,-20800,89900,289148,2024.10.31
101,That's Texas,Cody Johnson,7,2,5,2,0,63800,14800,49000,214901,2024.10.31
102,Things I Take For Granted,Larry Fleet,45,-20,65,7,0,62600,-36200,98800,374698,2024.10.31
103,Work Boots,Cody Johnson,5,-2,7,1,0,61100,-26900,88000,251785,2024.10.31
104,Let 'Em Talk,Ty Myers,17,0,17,2,0,60200,2700,57500,952303,2024.10.31
105,Wondering Why,Red Clay Strays,17,0,17,4,0,58700,-40200,98900,4622653,2024.10.31
106,Good On You,Priscilla Block,44,-3,47,8,0,57400,2000,55400,259960,2024.10.31
107,The Star-Spangled Banner,Chris Stapleton,17,3,14,16,0,56700,-14700,71400,66315,2024.10.31
108,Faith From A Farmer,Conner Smith,9,9,0,9,0,56400,56400,0,23800,2024.10.31
109,Finer Things,Post Malone,18,18,0,18,0,56300,56300,0,952699,2024.10.31
110,Three Drinks Behind,George Strait,14,14,0,14,0,53100,53100,0,342705,2024.10.31
111,A Little Bit Closer,Braxton Keith,4,3,1,1,0,49700,47900,1800,238037,2024.10.31
112,Never Been Over,Darius Rucker,22,-6,28,2,0,49600,-8800,58400,130151,2024.10.31
113,Man Upstairs,Tim Dugger,11,1,10,1,0,49400,6000,43400,1549,2024.10.31
114,Country Song Came On,Luke Bryan,12,5,7,3,0,48100,14700,33400,234139,2024.10.31
115,Better Man (Taylor's Version) (From The Vault),Taylor Swift,5,5,0,1,0,46600,46600,0,481575,2024.10.31
116,Pray All The Way Home,Austin Snell,32,-6,38,3,0,45200,-12900,58100,680986,2024.10.31
117,Broadway Girls,Lil Durk Feat. Morgan Wallen,10,-2,12,2,0,44800,-6800,51600,4821296,2024.10.31
118,Sunrise,Morgan Wallen,14,14,0,14,0,44700,44700,0,2419983,2024.10.31
119,Maxed Out,Bayker Blankenship,10,3,7,2,0,42900,2400,40500,3053679,2024.10.31
120,Mint Tea,Johnny Blue Skies,14,2,12,1,0,36300,100,36200,0,2024.10.31
121,American Nights,Zach Bryan,10,-8,18,1,0,31500,-12100,43600,2949507,2024.10.31
122,How Do You Sleep At Night?,Cody Johnson,2,2,0,1,0,31000,31000,0,938619,2024.10.31
123,Time's Ticking,Justin Moore,8,6,2,7,0,30600,22300,8300,657590,2024.10.31
124,Grandpa (Tell Me 'Bout The Good Old Days),Cody Johnson,3,1,2,1,0,30300,26700,3600,0,2024.10.31
125,Neon Baby,Annie Bosko,3,3,0,1,0,29800,29800,0,13143,2024.10.31
126,Turn The Lights Back On,Billy Joel,3,2,1,1,0,26200,20600,5600,296978,2024.10.31
127,When It's Gone For Good,Gold City,4,3,1,3,0,25400,19800,5600,6978,2024.10.31
128,Honky Tonks And Country Songs,Joe Nichols,4,4,0,4,0,24100,24100,0,35215,2024.10.31
129,Feelin' Country,Thomas Rhett,6,3,3,1,0,22400,18800,3600,267243,2024.10.31
130,Greener Pasture,Carter Faith,8,-3,11,1,0,21300,-8500,29800,95212,2024.10.31
131,Don'T Mind If I Do,Riley Green,6,-14,20,6,0,20900,-29500,50400,3173292,2024.10.31
132,Loud and Heavy,Cody Jinks,9,3,6,1,0,19100,2800,16300,1287627,2024.10.31
133,"Salt, Lime & Tequila",Ryan Griffin,4,1,3,1,0,17900,6900,11000,46859,2024.10.31
134,Jesus Walked In,Joseph Habedank,3,0,3,3,0,17900,-3800,21700,0,2024.10.31
135,Any Given Friday Night,Luke Combs,2,0,2,1,0,17400,2800,14600,162785,2024.10.31
136,Oklahoma Smokeshow,Zach Bryan,5,3,2,3,0,17300,7700,9600,5619610,2024.10.31
137,Grease,Lainey Wilson,3,3,0,1,0,16600,16600,0,95090,2024.10.31
138,Good Ol' Boys,Mae Estes,10,2,8,1,0,15800,4600,11200,83662,2024.10.31
139,"Checking Boxes, Crossing Lines",Trent Cowie,1,1,0,1,0,15500,15500,0,592,2024.10.31
139,What's Your Drinking Song?,Kyle Park,1,1,0,1,0,15500,15500,0,0,2024.10.31
139,Tequila Sundown,Jon Wolfe,1,1,0,1,0,15500,15500,0,3404,2024.10.31
139,Long Live Country Music,Cody Johnson,1,1,0,1,0,15500,15500,0,160046,2024.10.31
139,Over Drinkin' Under Thinkin',Drake Milligan,1,1,0,1,0,15500,15500,0,95357,2024.10.31
139,Single At The Same Time,Jake Worthington,1,1,0,1,0,15500,15500,0,4872,2024.10.31
145,People In The Back,Cody Johnson,1,0,1,1,0,15500,13700,1800,150032,2024.10.31
146,Lonely Road,Jelly Roll & Mgk,18,11,7,6,0,14300,7700,6600,5500628,2024.10.31
147,Hey Driver,Zach Bryan Feat. The War and Treaty,5,-6,11,1,0,14300,-13700,28000,3661715,2024.10.31
148,Learning As I Go,Kip Moore,3,1,2,3,0,13800,3800,10000,151814,2024.10.31
149,Bury Me In This Bar,Dalton Dover,22,-8,30,4,0,13300,-17600,30900,9386,2024.10.31
150,Heart Of A Small Town,Tim Dugger,2,-1,3,1,0,12300,-1000,13300,10129,2024.10.31
151,Wasted Words,Craguns,2,2,0,2,0,12100,12100,0,785,2024.10.31
152,Everything Good,Zane & Donna King,2,1,1,2,0,12100,6500,5600,0,2024.10.31
153,Hypothetically,Twinnie,17,17,0,17,0,11600,11600,0,2950,2024.10.31
154,If I Die Before You,Chris Lane,2,-57,59,2,0,11300,-273500,284800,174483,2024.10.31
155,Dance Like No One’s Watching,Gabby Barrett,13,1,12,1,0,11200,5200,6000,172737,2024.10.31
156,Heartfirst,Kelsea Ballerini,3,1,2,1,0,11000,2200,8800,247137,2024.10.31
157,Be Ready,Karen Peck & New River,2,2,0,2,0,10400,10400,0,18887,2024.10.31
158,Old Blind Bartimaeus,Jonathan Wilburn,2,1,1,2,0,10400,4200,6200,0,2024.10.31
158,The Things We Cannot Change,LeFevre Quartet,2,1,1,2,0,10400,4200,6200,5276,2024.10.31
160,You Can'T Hurry God,Perrys,2,0,2,2,0,10400,-1400,11800,11552,2024.10.31
161,I Left It In The Water,Southbound,2,-1,3,2,0,10400,-8900,19300,10681,2024.10.31
162,Braggin' On Jesus,Steeles,1,1,0,1,0,9900,9900,0,861,2024.10.31
162,Just As I Am,Carrie Underwood,1,1,0,1,0,9900,9900,0,34508,2024.10.31
164,Big Ole Stone (Victory),Triumphant Quartet,1,0,1,1,0,9900,4300,5600,6383,2024.10.31
165,Jeans & Jesus,Sound,1,0,1,1,0,9900,2400,7500,0,2024.10.31
166,Red Words,Erwins,1,0,1,1,0,9900,0,9900,11498,2024.10.31
167,Hole In The Heart,Nelons,1,-1,2,1,0,9900,-3200,13100,0,2024.10.31
168,Feel Like The Holidays,Scotty McCreery,1,1,0,1,0,9700,9700,0,12073,2024.10.31
169,Hell Is A Dance Floor,Vincent Mason,1,0,1,1,0,9700,7900,1800,1995803,2024.10.31
170,Forever Bound,12/Oc,4,-2,6,1,0,9600,-2900,12500,1368,2024.10.31
171,Longneck Way To Go,Midland Feat. Jon Pardi,1,1,0,1,0,9000,9000,0,114865,2024.10.31
172,Baby Daddy's Weekend,Elle King,9,-2,11,2,0,8900,-4500,13400,20161,2024.10.31
173,Oklahoma Sooner,Jake Banfield,3,-1,4,1,0,8700,600,8100,3426,2024.10.31
174,Heartbeat Of America,Billy Strings,4,4,0,4,0,8500,8500,0,17356,2024.10.31
175,The Good I'Ll Do,Zach Bryan,3,0,3,1,0,8400,-2900,11300,1954269,2024.10.31
176,Oklahoma Sun,Koe Wetzel,2,0,2,1,0,7900,1800,6100,110053,2024.10.31
177,House Again,Hudson Westbrook,1,1,0,1,0,7600,7600,0,2527045,2024.10.31
178,No One Greater,Browns,1,1,0,1,0,7500,7500,0,601,2024.10.31
178,One Name,Jeff & Sheri Easter,1,1,0,1,0,7500,7500,0,18323,2024.10.31
178,Until Prayer Changes Me,Kingdom Heirs,1,1,0,1,0,7500,7500,0,9332,2024.10.31
178,The Building,Emily Ann Roberts,1,1,0,1,0,7500,7500,0,28934,2024.10.31
178,Waiting For Me,Truesong,1,1,0,1,0,7500,7500,0,822,2024.10.31
178,By Grace,Lore Family,1,1,0,1,0,7500,7500,0,513,2024.10.31
184,Here Comes Jesus,Jeff & Sheri Easter,1,0,1,1,0,7500,-2400,9900,17814,2024.10.31
185,First Rodeo,Kelsea Ballerini,2,0,2,2,0,7400,800,6600,1759343,2024.10.31
186,Long Live Cowgirls,Ian Munsick & Cody Johnson,3,3,0,3,0,7300,7300,0,651415,2024.10.31
187,'98 Braves,Morgan Wallen,1,0,1,1,0,7200,4400,2800,1315587,2024.10.31
188,Victory In Jesus,Carrie Underwood,1,1,0,1,0,6900,6900,0,41675,2024.10.31
188,Way Home,Tyler Hubbard,1,1,0,1,0,6900,6900,0,65151,2024.10.31
190,Where That Came From,Randy Travis,2,0,2,1,0,6300,2700,3600,293734,2024.10.31
191,Hey Mercedes,Post Malone,2,-4,6,1,0,6300,-64300,70600,373087,2024.10.31
192,Growin To Do,Conor Clemmons,1,1,0,1,0,6000,6000,0,124,2024.10.31
192,Born With A Beer In My Hand,Morgan Wallen,1,1,0,1,0,6000,6000,0,542439,2024.10.31
194,Am I The Only One,Aaron Lewis,2,0,2,1,0,6000,1200,4800,486750,2024.10.31
195,Use Me,Zach Top,2,-1,3,2,0,5900,-2700,8600,1233055,2024.10.31
196,My God,Scotty Inman,1,1,0,1,0,5800,5800,0,38917,2024.10.31
196,He Pilots My Ship,Tribute Quartet,1,1,0,1,0,5800,5800,0,7986,2024.10.31
196,Nobody Knows Better Than Me,Tiffany Coburn,1,1,0,1,0,5800,5800,0,0,2024.10.31
196,Testify,Legacy Five,1,1,0,1,0,5800,5800,0,1030,2024.10.31
196,Tell The Grave,Perrys,1,1,0,1,0,5800,5800,0,2255,2024.10.31
201,Praying For The Prodigal,Kingsmen,1,0,1,1,0,5800,200,5600,1647,2024.10.31
202,Bigger On The Inside,Legacy Five,1,0,1,1,0,5800,-400,6200,12878,2024.10.31
202,Grateful For The Gospel,Brian Free & Assurance,1,0,1,1,0,5800,-400,6200,12469,2024.10.31
202,"I, John",Blackwood Brothers Quartet,1,0,1,1,0,5800,-400,6200,32,2024.10.31
202,All Things,Sound,1,0,1,1,0,5800,-400,6200,1345,2024.10.31
202,There's A River,High Road,1,0,1,1,0,5800,-400,6200,0,2024.10.31
202,He Bought Me,Old Paths,1,0,1,1,0,5800,-400,6200,1248,2024.10.31
202,Think About There,Greater Vision,1,0,1,1,0,5800,-400,6200,13001,2024.10.31
202,In God's Time,Jordan Family Band,1,0,1,1,0,5800,-400,6200,2224,2024.10.31
1,I Am Not Okay,Jelly Roll,8057,-915,8972,146,0,32262800,-1715600,33978400,9799186,2024.11.07
2,Lies Lies Lies,Morgan Wallen,8716,1165,7551,146,0,32074900,3896400,28178500,10162355,2024.11.07
3,Pour Me A Drink,Post Malone,6727,-314,7041,146,0,27802800,-1048700,28851500,4205795,2024.11.07
4,Miles On It,Marshmello & Kane Brown,6478,-1115,7593,143,0,26897300,-3548000,30445300,8304142,2024.11.07
5,A Bar Song (Tipsy),Shaboozey,5540,98,5442,142,0,22773000,-65400,22838400,21436576,2024.11.07
6,Gonna Love You,Parmalee,5853,166,5687,146,0,20266700,965000,19301700,402820,2024.11.07
7,You Look Like You Love Me,Ella Langley & Riley Green,5690,374,5316,146,0,19637700,526300,19111400,7699697,2024.11.07
8,Beautiful As You,Thomas Rhett,5574,509,5065,146,0,19001100,1001000,18000100,4690696,2024.11.07
9,Cowboy Songs,George Birge,5207,442,4765,146,0,18287100,1810500,16476600,606498,2024.11.07
10,High Road,Koe Wetzel,5112,789,4323,145,0,17471600,2555400,14916200,6932385,2024.11.07
11,One Bad Habit,Tim McGraw,5012,381,4631,146,0,17154700,982800,16171900,403198,2024.11.07
12,Boys Back Home,Dylan Marlowe Feat. Dylan Scott,4251,366,3885,146,0,15543600,1995400,13548200,1380925,2024.11.07
13,Bigger Houses,Dan + Shay,4321,309,4012,146,0,14896600,911600,13985000,706382,2024.11.07
14,Wind Up Missin' You,Tucker Wetmore,4017,427,3590,146,0,13859100,1412300,12446800,7075727,2024.11.07
15,Sounds Like The Radio,Zach Top,3637,14,3623,145,0,12006800,-62600,12069400,1904254,2024.11.07
16,Love Somebody,Morgan Wallen,2870,698,2172,145,0,11606800,2437000,9169800,19093109,2024.11.07
17,Messed Up As Me,Keith Urban,3645,37,3608,146,0,11070000,111200,10958800,1660803,2024.11.07
18,Damn Good Day To Leave,Riley Green,3276,101,3175,146,0,10503800,429500,10074300,773377,2024.11.07
19,Guy For That,Post Malone,2712,343,2369,145,0,9864500,996100,8868400,4652823,2024.11.07
20,Think I’m In Love With You,Chris Stapleton,2979,77,2902,145,0,9684200,-51300,9735500,4823766,2024.11.07
21,4x4xu,Lainey Wilson,2502,124,2378,145,0,8397500,848900,7548600,3155386,2024.11.07
22,American Girl,Dierks Bentley,2300,-4,2304,144,0,7653000,-91300,7744300,152885,2024.11.07
23,I Ain'T Sayin',Jordan Davis,2407,229,2178,145,0,7621600,1234300,6387300,3818497,2024.11.07
24,Breakin' In Boots,Matt Stell,2679,260,2419,143,0,7136900,807600,6329300,192590,2024.11.07
25,Forever To Me,Cole Swindell,2014,229,1785,122,0,6840500,1095600,5744900,745562,2024.11.07
26,This Town's Been Too Good To Us,Dylan Scott,2045,-7,2052,141,0,6667000,32300,6634700,2297014,2024.11.07
27,Friends Like That,John Morgan Feat. Jason Aldean,2231,119,2112,138,0,6395200,541800,5853400,586902,2024.11.07
28,I'm Gonna Love You,Cody Johnson,1458,103,1355,117,0,4840700,324400,4516300,6850618,2024.11.07
29,Holy Smokes,Bailey Zimmerman,1517,141,1376,127,0,4829900,227100,4602800,3673226,2024.11.07
30,Hometown Home,Locash,1690,167,1523,138,0,4730300,274100,4456200,89850,2024.11.07
31,Am I Okay?,Megan Moroney,1214,31,1183,102,0,4365300,61000,4304300,5245929,2024.11.07
32,Whiskey Drink,Jason Aldean,1538,148,1390,121,0,3988000,255900,3732100,737762,2024.11.07
33,Just To Say We Did,Kenny Chesney,1499,83,1416,129,0,3893700,155300,3738400,311897,2024.11.07
34,Whatcha See Is Whatcha Get,Chris Janson,1646,88,1558,143,0,3722800,-184300,3907100,104746,2024.11.07
35,Life With You,Kelsey Hart,1631,-73,1704,122,0,3717300,-273600,3990900,1076773,2024.11.07
36,Wranglers,Miranda Lambert,1644,78,1566,139,0,3471900,140100,3331800,260867,2024.11.07
37,Coming Home,Old Dominion,1260,95,1165,134,0,3331500,289000,3042500,1144921,2024.11.07
38,Darkest Hour (Helene Edit),Eric Church,1456,38,1418,100,0,3287400,-169400,3456800,384751,2024.11.07
39,Single Again,Josh Ross,1376,47,1329,110,0,3102000,103800,2998200,2305981,2024.11.07
40,I Tried A Ring On,Tigirlily Gold,1634,159,1475,141,0,2901300,322000,2579300,143610,2024.11.07
41,Fall Of Summer,Scotty McCreery,1169,-22,1191,122,0,2671700,-175500,2847200,456842,2024.11.07
42,Truck On Fire,Carly Pearce,1150,95,1055,132,0,2575100,30000,2545100,859588,2024.11.07
43,Cowboys Cry Too,Kelsea Ballerini,1282,30,1252,136,0,2502900,-53900,2556800,3650482,2024.11.07
44,Backseat Driver,Kane Brown,503,319,184,47,0,2281200,1664200,617000,1763666,2024.11.07
45,Heavens To Betsy,Jackson Dean,893,91,802,98,0,2059800,175700,1884100,415618,2024.11.07
46,Everything I Need,Chayce Beckham,848,49,799,76,0,1791500,187200,1604300,224337,2024.11.07
47,Park,Tyler Hubbard,760,112,648,86,0,1734800,256000,1478800,805422,2024.11.07
48,Friday Night Heartbreaker,Jon Pardi,639,35,604,77,0,1720800,82300,1638500,406734,2024.11.07
49,Country House,Sam Hunt,824,129,695,110,0,1713800,273500,1440300,204035,2024.11.07
50,I Never Lie,Zach Top,392,110,282,27,0,1664500,357300,1307200,6315963,2024.11.07
51,Over When We'Re Sober,Brantley Gilbert,667,13,654,84,0,1552900,281600,1271300,582420,2024.11.07
52,Bones,Russell Dickerson,695,21,674,86,0,1547100,164800,1382300,1117901,2024.11.07
53,Love The Leavin',Drew Parker,586,68,518,25,0,1486400,197900,1288500,64067,2024.11.07
54,What Kinda Man,Parker Mccollum,617,27,590,70,0,1392000,-109900,1501900,831224,2024.11.07
55,Truck Still Works,Brad Paisley,561,34,527,68,0,1359200,151100,1208100,168565,2024.11.07
56,Tough People,Drew Baldridge,589,313,276,86,0,1349100,640100,709000,84680,2024.11.07
57,Devil You Know,Tyler Braden,495,36,459,41,0,1336600,29500,1307100,3650721,2024.11.07
58,Relapse,Warren Zeiders,544,86,458,38,0,1247800,293000,954800,3372396,2024.11.07
59,This Heart,Corey Kent,609,66,543,60,0,1225200,195200,1030000,607626,2024.11.07
60,Would If I Could,Ernest Feat. Lainey Wilson,396,28,368,57,0,971200,138300,832900,598436,2024.11.07
61,I Could Be That Rain,Randall King,525,76,449,64,0,856300,85200,771100,97140,2024.11.07
62,Liar,Jelly Roll,206,108,98,26,0,807600,452600,355000,5521109,2024.11.07
63,Highway,Shaboozey,419,89,330,55,0,792200,138800,653400,879019,2024.11.07
64,Better Than You,Joe Nichols & Annie Bosko,584,38,546,71,0,771000,-186600,957600,120739,2024.11.07
65,Fix What You Didn't Break,Nate Smith,245,180,65,43,0,752500,492900,259600,4394207,2024.11.07
66,Worst Way,Riley Green,81,2,79,4,0,677900,-12600,690500,4388725,2024.11.07
67,Golden Child,Meghan Patrick,457,27,430,59,0,561500,101900,459600,43668,2024.11.07
68,Wine Into Whiskey,Tucker Wetmore,71,3,68,3,0,530100,-20500,550600,4380875,2024.11.07
69,Darlin',Chase Matthew,327,50,277,64,0,528500,171300,357200,3095734,2024.11.07
70,Not Today,Mitchell Tenpenny,391,38,353,51,0,407900,89100,318800,368160,2024.11.07
71,Hung Up On You,Bryce Leatherwood,342,43,299,50,0,404400,101900,302500,67238,2024.11.07
72,Wolves Cry,Bryan Martin,184,24,160,32,0,398800,86500,312300,743228,2024.11.07
73,Espresso,Sabrina Carpenter,79,79,0,40,0,328000,328000,0,15678850,2024.11.07
74,The Aftermath,Carter Faith,58,10,48,57,0,274700,179500,95200,36691,2024.11.07
75,Now Or Never,Corey Kent,83,58,25,6,0,259300,144500,114800,1899149,2024.11.07
76,Just Like Johnny,Redferrin,224,42,182,27,0,219800,24400,195400,4374283,2024.11.07
77,I Got A Problem,Drake Milligan,66,2,64,5,0,217500,-2200,219700,45837,2024.11.07
78,The Devil I Know,Ashley McBryde,58,2,56,6,0,139000,1600,137400,109447,2024.11.07
79,Losers,Post Malone,35,0,35,4,0,116400,3900,112500,4243012,2024.11.07
80,Pink Skies,Zach Bryan,48,12,36,5,0,104000,10300,93700,12435827,2024.11.07
81,Broadway Girls,Lil Durk Feat. Morgan Wallen,24,14,10,15,0,101900,57100,44800,4407925,2024.11.07
82,Son Of A Gun,Kassi Ashton,48,48,0,48,0,101100,101100,0,4388,2024.11.07
83,How Is She,Cole Swindell,14,-3,17,1,0,97600,-15100,112700,37310,2024.11.07
84,Bar Fight,Madeline Merlo,48,48,0,48,0,95200,95200,0,3723,2024.11.07
85,Time's Ticking,Justin Moore,20,12,8,7,0,93500,62900,30600,509534,2024.11.07
86,Cozy,Braxton Keith,20,1,19,2,0,92400,1200,91200,1288344,2024.11.07
87,Maxed Out,Bayker Blankenship,16,6,10,1,0,92100,49200,42900,3011166,2024.11.07
88,Songs About Whiskey,Anne Wilson,90,-15,105,14,0,89800,-46200,136000,124300,2024.11.07
89,A Lot More Free,Max Mcnown,22,-2,24,2,0,89600,-1500,91100,3001950,2024.11.07
90,Wrong Ones,Post Malone,16,-17,33,3,0,84800,-61000,145800,1246221,2024.11.07
91,Country Song Came On,Luke Bryan,20,8,12,9,0,82600,34500,48100,221909,2024.11.07
92,Spin You Around (1/24),Morgan Wallen,21,-8,29,3,0,77100,-11200,88300,4578969,2024.11.07
93,Break Mine,Brothers Osborne,28,-2,30,2,0,67900,-1200,69100,273185,2024.11.07
94,The Star-Spangled Banner,Chris Stapleton,15,-2,17,12,0,62600,5900,56700,97809,2024.11.07
95,Beatles And Eagles,Frontmen,129,-33,162,20,0,61900,-36200,98100,691,2024.11.07
96,Let 'Em Talk,Ty Myers,18,1,17,1,0,60000,-200,60200,823029,2024.11.07
97,Never Been Over,Darius Rucker,24,2,22,2,0,53500,3900,49600,121536,2024.11.07
98,Wondering Why,Red Clay Strays,14,-3,17,5,0,49600,-9100,58700,4723173,2024.11.07
99,Pray All The Way Home,Austin Snell,23,-9,32,3,0,47100,1900,45200,624869,2024.11.07
100,Neon Baby,Annie Bosko,5,2,3,1,0,46700,16900,29800,13307,2024.11.07
101,Train Of Thought,Vincent Mason,6,-4,10,1,0,43800,-50100,93900,0,2024.11.07
102,Man Upstairs,Tim Dugger,10,-1,11,1,0,40600,-8800,49400,1416,2024.11.07
103,Have The Heart,Post Malone,13,13,0,13,0,39000,39000,0,518327,2024.11.07
104,Things I Take For Granted,Larry Fleet,26,-19,45,4,0,38900,-23700,62600,353899,2024.11.07
105,American Nights,Zach Bryan,16,6,10,1,0,38300,6800,31500,2492797,2024.11.07
106,Winning Streak,Jelly Roll,19,-11,30,2,0,38000,-133400,171400,4010130,2024.11.07
107,You And The Whiskey,Ben Burgess & Brandon Jane,49,49,0,17,0,34900,34900,0,0,2024.11.07
108,Just A Bottle,Orlando Mendez,49,49,0,17,0,34400,34400,0,513,2024.11.07
109,Good On You,Priscilla Block,26,-18,44,4,0,33600,-23800,57400,229430,2024.11.07
110,You In A Honky Tonk,Randall King,4,2,2,2,0,31400,26800,4600,326782,2024.11.07
111,Strangers,Kameron Marlowe & Ella Langley,36,-31,67,4,0,29700,-60000,89700,761677,2024.11.07
112,"Tele-Man (Feat. Vince Gill, Jo)",Ira Dean & Ronnie Dunn,4,4,0,4,0,24900,24900,0,9517,2024.11.07
113,Feelin' Country,Thomas Rhett,6,0,6,1,0,23900,1500,22400,254889,2024.11.07
114,Hypothetically,Twinnie,34,17,17,17,0,23700,12100,11600,2273,2024.11.07
115,Lonely Road,Jelly Roll & Mgk,20,2,18,6,0,23700,9400,14300,5196940,2024.11.07
116,Hippies And Cowboys,Sarah Darling,34,-68,102,17,0,23200,-46400,69600,378,2024.11.07
117,The Good I'Ll Do,Zach Bryan,6,3,3,1,0,22700,14300,8400,1940827,2024.11.07
118,Taught Me The Rest,Landon Parker,31,31,0,16,0,20400,20400,0,21893,2024.11.07
119,Broken Heart Thing (Feat. Dust,Madeline Merlo,4,4,0,4,0,20300,20300,0,625475,2024.11.07
120,Heart Of A Small Town,Tim Dugger,2,0,2,1,0,19800,7500,12300,9906,2024.11.07
121,Am I The Only One,Aaron Lewis,4,2,2,2,0,18800,12800,6000,503838,2024.11.07
122,Heart Burn/California Cowgirl,Annie Bosko,9,-46,55,8,0,18000,-145200,163200,0,2024.11.07
123,Oklahoma Smokeshow,Zach Bryan,4,-1,5,2,0,17900,600,17300,5152958,2024.11.07
124,Liberty,Sam Hunt,2,2,0,2,0,17500,17500,0,978612,2024.11.07
125,Any Given Friday Night,Luke Combs,2,0,2,1,0,17400,0,17400,156110,2024.11.07
126,Loud and Heavy,Cody Jinks,7,-2,9,1,0,16800,-2300,19100,1201549,2024.11.07
127,Baby Daddy's Weekend,Elle King,11,2,9,2,0,16400,7500,8900,22134,2024.11.07
128,Me When I Drink,Kyle Park,1,1,0,1,0,15500,15500,0,896,2024.11.07
128,Dancin' With The Devil,Josh Ward,1,1,0,1,0,15500,15500,0,8267,2024.11.07
128,State You Left Me In,Jake Worthington,1,1,0,1,0,15500,15500,0,15133,2024.11.07
128,Built Different,Casey Donahew,1,1,0,1,0,15500,15500,0,28549,2024.11.07
128,Up In Texas,Midland,1,1,0,1,0,15500,15500,0,45458,2024.11.07
133,Hell Is A Dance Floor,Vincent Mason,1,0,1,1,0,15500,5800,9700,1899720,2024.11.07
134,Dance Like No One’s Watching,Gabby Barrett,15,2,13,1,0,14600,3400,11200,150193,2024.11.07
135,Greener Pasture,Carter Faith,7,-1,8,1,0,14500,-6800,21300,87296,2024.11.07
136,Damn Love,Kip Moore,2,2,0,1,0,13800,13800,0,21285,2024.11.07
137,Back To Texas,Post Malone,1,0,1,1,0,13600,12400,1200,181351,2024.11.07
138,Crazy One More Time (2022),Kip Moore,2,2,0,1,0,13500,13500,0,5732,2024.11.07
139,Forever Bound,12/Oc,5,1,4,1,0,13500,3900,9600,1450,2024.11.07
140,Mia Down In Mia,George Strait,1,1,0,1,0,12900,12900,0,104170,2024.11.07
141,Beer Drinkin' Crowd,Daniel Jeffers,18,18,0,17,0,12700,12700,0,332,2024.11.07
142,My Bar,Priscilla Block,2,1,1,2,0,12100,8400,3700,88702,2024.11.07
143,Hey Driver,Zach Bryan Feat. The War and Treaty,4,-1,5,1,0,11900,-2400,14300,3368924,2024.11.07
144,Grandpa (Tell Me 'Bout The Good Old Days),Cody Johnson,1,-2,3,1,0,11400,-18900,30300,0,2024.11.07
145,Johnny Moonshine,Maggie Antone,8,7,1,1,0,11200,9800,1400,163123,2024.11.07
146,Runnin' Through That T,Thomas Edwards (Country),1,1,0,1,0,10900,10900,0,2176,2024.11.07
147,Record High,Randall King,2,2,0,2,0,10600,10600,0,20107,2024.11.07
148,Grateful For The Gospel,Brian Free & Assurance,2,1,1,2,0,10400,4600,5800,13029,2024.11.07
149,Old Blind Bartimaeus,Jonathan Wilburn,2,0,2,2,0,10400,0,10400,0,2024.11.07
149,I Left It In The Water,Southbound,2,0,2,2,0,10400,0,10400,10923,2024.11.07
151,Jesus Walked In,Joseph Habedank,2,-1,3,2,0,10400,-7500,17900,0,2024.11.07
152,When It's Gone For Good,Gold City,2,-2,4,2,0,10400,-15000,25400,4695,2024.11.07
153,Because He Lives,Carrie Underwood,1,1,0,1,0,9900,9900,0,64803,2024.11.07
154,Damn Good Country Song,Corey Kent,3,2,1,2,0,9800,8500,1300,126886,2024.11.07
155,Star Spangled Banner,Mickey Guyton,1,0,1,1,0,9700,8300,1400,0,2024.11.07
156,Oklahoma Sooner,Jake Banfield,3,0,3,1,0,9700,1000,8700,1320,2024.11.07
157,M-E-X-I-C-O,Post Malone,1,1,0,1,0,9600,9600,0,450753,2024.11.07
157,Fox In The Henhouse,Luke Combs,1,1,0,1,0,9600,9600,0,68482,2024.11.07
157,Back 40 Back,Luke Combs,1,1,0,1,0,9600,9600,0,126032,2024.11.07
157,Yours,Post Malone,1,1,0,1,0,9600,9600,0,1086910,2024.11.07
157,Whiskey Friends,Morgan Wallen,1,1,0,1,0,9600,9600,0,972814,2024.11.07
162,Damn Good Time,Jordan Davis,1,1,0,1,0,9500,9500,0,138781,2024.11.07
163,Friday Night (Feat. Troy Aikman),Wade Bowen,2,2,0,2,0,8800,8800,0,1885,2024.11.07
164,Til The Last Shot's Fired,Scotty Hasting,1,1,0,1,0,8700,8700,0,0,2024.11.07
165,Good Ol' Boys,Mae Estes,7,-3,10,1,0,8600,-7200,15800,74620,2024.11.07
166,Ain't Missin' You,Dylan Schneider,9,8,1,1,0,8300,8000,300,413641,2024.11.07
167,Beer,Hardy,1,1,0,1,0,8300,8300,0,71485,2024.11.07
168,'98 Braves,Morgan Wallen,1,0,1,1,0,8300,1100,7200,1207715,2024.11.07
169,This Side Of The Dirt,Neon Union,5,2,3,1,0,8000,3200,4800,5296,2024.11.07
170,New Kind Of Emotion,Runaway June,1,1,0,1,0,7800,7800,0,30839,2024.11.07
171,Oklahoma Sun,Koe Wetzel,2,0,2,1,0,7800,-100,7900,101986,2024.11.07
172,Made In The Usa,Cody Johnson,1,1,0,1,0,7600,7600,0,592211,2024.11.07
172,Cheap,Chris Janson,1,1,0,1,0,7600,7600,0,516865,2024.11.07
174,Know You Like That,Jordan Davis,1,0,1,1,0,7600,3200,4400,1376469,2024.11.07
175,Scars In Heaven,Casting Crowns,1,1,0,1,0,7500,7500,0,348184,2024.11.07
176,Stretchy Pants,Carrie Underwood,2,2,0,2,0,7200,7200,0,33405,2024.11.07
177,Money On Me,Morgan Wallen,1,1,0,1,0,7200,7200,0,401928,2024.11.07
178,Mint Tea,Johnny Blue Skies,4,-10,14,1,0,7200,-29100,36300,0,2024.11.07
179,Baggage,Kelsea Ballerini,1,-1,2,1,0,7000,1800,5200,2158194,2024.11.07
180,Ain't That Some,Morgan Wallen,2,1,1,2,0,6900,3400,3500,3060538,2024.11.07
181,If I Die Before You,Chris Lane,9,7,2,1,0,6700,-4600,11300,171476,2024.11.07
182,Young Man,Greylan James,12,-1,13,1,0,6700,1000,5700,32195,2024.11.07
183,Finer Things,Post Malone,1,-17,18,1,0,6700,-49600,56300,819929,2024.11.07
184,Buckles And Broken Hearts,Joe Peters,1,1,0,1,0,6300,6300,0,746,2024.11.07
185,A Little Bit Closer,Braxton Keith,2,-2,4,1,0,6300,-43400,49700,237192,2024.11.07
186,Days That End In Why,Morgan Wallen,1,1,0,1,0,6000,6000,0,526594,2024.11.07
187,The End,Endless Highway,1,1,0,1,0,5800,5800,0,107,2024.11.07
187,Back To The Garden,Erwins,1,1,0,1,0,5800,5800,0,0,2024.11.07
187,Come On In,Kingdom Heirs,1,1,0,1,0,5800,5800,0,6973,2024.11.07
187,There's Always A Place At The Table,Sunday Drive,1,1,0,1,0,5800,5800,0,347,2024.11.07
187,He Sent Him For Me,Inspirations,1,1,0,1,0,5800,5800,0,0,2024.11.07
187,We Are The Church,Ernie Haase & Signature Sound,1,1,0,1,0,5800,5800,0,18677,2024.11.07
187,Like Jesus Can,Taranda Greene,1,1,0,1,0,5800,5800,0,576,2024.11.07
187,Wings Of A Dove,Jonathan Wilburn,1,1,0,1,0,5800,5800,0,0,2024.11.07
187,Ready To Leave,Down East Boys,1,1,0,1,0,5800,5800,0,654,2024.11.07
187,There Is,Hyssongs,1,1,0,1,0,5800,5800,0,83,2024.11.07
197,He Pilots My Ship,Tribute Quartet,1,0,1,1,0,5800,0,5800,8133,2024.11.07
197,Think About There,Greater Vision,1,0,1,1,0,5800,0,5800,11684,2024.11.07
197,There's A River,High Road,1,0,1,1,0,5800,0,5800,0,2024.11.07
197,My God,Scotty Inman,1,0,1,1,0,5800,0,5800,40337,2024.11.07
197,He Bought Me,Old Paths,1,0,1,1,0,5800,0,5800,972,2024.11.07
197,Bigger On The Inside,Legacy Five,1,0,1,1,0,5800,0,5800,10300,2024.11.07
197,"I, John",Blackwood Brothers Quartet,1,0,1,1,0,5800,0,5800,19,2024.11.07
197,In God's Time,Jordan Family Band,1,0,1,1,0,5800,0,5800,3076,2024.11.07
197,All Things,Sound,1,0,1,1,0,5800,0,5800,1286,2024.11.07
206,You Can'T Hurry God,Perrys,1,-1,2,1,0,5800,-4600,10400,8369,2024.11.07
1,Lies Lies Lies,Morgan Wallen,7735,-981,8716,146,0,30261100,-1813800,32074900,10380275,2024.11.14
2,I Am Not Okay,Jelly Roll,6813,-1244,8057,144,0,29106500,-3156300,32262800,8152014,2024.11.14
3,Pour Me A Drink,Post Malone,6409,-318,6727,146,0,26865900,-936900,27802800,4083771,2024.11.14
4,Miles On It,Marshmello & Kane Brown,5902,-576,6478,143,0,24376200,-2521100,26897300,8053188,2024.11.14
5,One Bad Habit,Tim McGraw,7188,2176,5012,146,0,23971500,6816800,17154700,396310,2024.11.14
6,A Bar Song (Tipsy),Shaboozey,5445,-95,5540,142,0,22877500,104500,22773000,20105795,2024.11.14
7,Gonna Love You,Parmalee,6082,229,5853,146,0,20903400,636700,20266700,418436,2024.11.14
8,You Look Like You Love Me,Ella Langley & Riley Green,5727,37,5690,146,0,20246300,608600,19637700,7473515,2024.11.14
9,Cowboy Songs,George Birge,5743,536,5207,146,0,19880900,1593800,18287100,618851,2024.11.14
10,Beautiful As You,Thomas Rhett,5894,320,5574,146,0,19832600,831500,19001100,5362083,2024.11.14
11,High Road,Koe Wetzel,5295,183,5112,146,0,18629800,1158200,17471600,7941917,2024.11.14
12,Boys Back Home,Dylan Marlowe Feat. Dylan Scott,4695,444,4251,146,0,16762200,1218600,15543600,1191461,2024.11.14
13,Wind Up Missin' You,Tucker Wetmore,4331,314,4017,146,0,15272200,1413100,13859100,7870084,2024.11.14
14,Bigger Houses,Dan + Shay,4317,-4,4321,146,0,14790500,-106100,14896600,760703,2024.11.14
15,Love Somebody,Morgan Wallen,3242,372,2870,144,0,13169000,1562200,11606800,18380266,2024.11.14
16,Messed Up As Me,Keith Urban,3693,48,3645,146,0,11259400,189400,11070000,1627136,2024.11.14
17,Sounds Like The Radio,Zach Top,3520,-117,3637,145,0,11151300,-855500,12006800,1969996,2024.11.14
18,Damn Good Day To Leave,Riley Green,3337,61,3276,146,0,10940700,436900,10503800,785381,2024.11.14
19,Guy For That,Post Malone,2803,91,2712,145,0,10294700,430200,9864500,4461706,2024.11.14
20,Think I’m In Love With You,Chris Stapleton,2878,-101,2979,145,0,9731400,47200,9684200,5135261,2024.11.14
21,4x4xu,Lainey Wilson,2846,344,2502,145,0,9346700,949200,8397500,3236052,2024.11.14
22,I Ain'T Sayin',Jordan Davis,2706,299,2407,145,0,8685600,1064000,7621600,3522425,2024.11.14
23,American Girl,Dierks Bentley,2427,127,2300,144,0,7839300,186300,7653000,146122,2024.11.14
24,Forever To Me,Cole Swindell,2261,247,2014,129,0,7724800,884300,6840500,707483,2024.11.14
25,Breakin' In Boots,Matt Stell,2633,-46,2679,143,0,7318400,181500,7136900,195297,2024.11.14
26,This Town's Been Too Good To Us,Dylan Scott,2248,203,2045,145,0,7048500,381500,6667000,2006677,2024.11.14
27,Friends Like That,John Morgan Feat. Jason Aldean,2388,157,2231,138,0,6907500,512300,6395200,548166,2024.11.14
28,I'm Gonna Love You,Cody Johnson,1731,273,1458,124,0,5586500,745800,4840700,6585436,2024.11.14
29,Holy Smokes,Bailey Zimmerman,1675,158,1517,131,0,5156800,326900,4829900,3628841,2024.11.14
30,Hometown Home,Locash,1713,23,1690,140,0,4706800,-23500,4730300,88196,2024.11.14
31,Am I Okay?,Megan Moroney,1257,43,1214,96,0,4500500,135200,4365300,4895933,2024.11.14
32,Just To Say We Did,Kenny Chesney,1576,77,1499,129,0,4075800,182100,3893700,309290,2024.11.14
33,Whiskey Drink,Jason Aldean,1504,-34,1538,120,0,4034900,46900,3988000,822684,2024.11.14
34,Life With You,Kelsey Hart,1728,97,1631,122,0,3966900,249600,3717300,1128465,2024.11.14
35,Whatcha See Is Whatcha Get,Chris Janson,1649,3,1646,143,0,3904900,182100,3722800,106104,2024.11.14
36,Darkest Hour (Helene Edit),Eric Church,1467,11,1456,115,0,3541200,253800,3287400,343654,2024.11.14
37,Wranglers,Miranda Lambert,1575,-69,1644,142,0,3446700,-25200,3471900,209104,2024.11.14
38,Coming Home,Old Dominion,1179,-81,1260,133,0,3262400,-69100,3331500,1107112,2024.11.14
39,Backseat Driver,Kane Brown,700,197,503,66,0,3224300,943100,2281200,2714483,2024.11.14
40,Single Again,Josh Ross,1358,-18,1376,110,0,3038800,-63200,3102000,2207856,2024.11.14
41,Fall Of Summer,Scotty McCreery,1250,81,1169,126,0,2799700,128000,2671700,471891,2024.11.14
42,Truck On Fire,Carly Pearce,1187,37,1150,135,0,2622000,46900,2575100,836065,2024.11.14
43,Cowboys Cry Too,Kelsea Ballerini,1326,44,1282,135,0,2604400,101500,2502900,2523949,2024.11.14
44,Liar,Jelly Roll,598,392,206,71,0,2313700,1506100,807600,5526173,2024.11.14
45,I Never Lie,Zach Top,509,117,392,41,0,2168700,504200,1664500,7588381,2024.11.14
46,Heavens To Betsy,Jackson Dean,850,-43,893,98,0,2098600,38800,2059800,429788,2024.11.14
47,Tough People,Drew Baldridge,846,257,589,106,0,2070900,721800,1349100,105253,2024.11.14
48,Friday Night Heartbreaker,Jon Pardi,747,108,639,94,0,1916800,196000,1720800,435521,2024.11.14
49,Everything I Need,Chayce Beckham,857,9,848,76,0,1863100,71600,1791500,218459,2024.11.14
50,Country House,Sam Hunt,844,20,824,109,0,1750300,36500,1713800,204665,2024.11.14
51,Love The Leavin',Drew Parker,639,53,586,24,0,1687600,201200,1486400,68182,2024.11.14
52,Park,Tyler Hubbard,706,-54,760,86,0,1615200,-119600,1734800,728686,2024.11.14
53,Bones,Russell Dickerson,708,13,695,92,0,1593500,46400,1547100,868599,2024.11.14
54,Over When We'Re Sober,Brantley Gilbert,673,6,667,84,0,1503400,-49500,1552900,582026,2024.11.14
55,Truck Still Works,Brad Paisley,592,31,561,87,0,1456200,97000,1359200,157168,2024.11.14
56,Relapse,Warren Zeiders,565,21,544,39,0,1455300,207500,1247800,3431848,2024.11.14
57,Devil You Know,Tyler Braden,498,3,495,39,0,1409500,72900,1336600,3880943,2024.11.14
58,What Kinda Man,Parker Mccollum,612,-5,617,72,0,1332700,-59300,1392000,843089,2024.11.14
59,This Heart,Corey Kent,621,12,609,61,0,1294700,69500,1225200,592507,2024.11.14
60,Fix What You Didn't Break,Nate Smith,332,87,245,39,0,936500,184000,752500,4272475,2024.11.14
61,Would If I Could,Ernest Feat. Lainey Wilson,392,-4,396,58,0,814200,-157000,971200,569660,2024.11.14
62,Better Than You,Joe Nichols & Annie Bosko,539,-45,584,69,0,784900,13900,771000,106655,2024.11.14
63,I Could Be That Rain,Randall King,496,-29,525,65,0,724500,-131800,856300,94892,2024.11.14
64,Worst Way,Riley Green,84,3,81,4,0,720600,42700,677900,4910441,2024.11.14
65,Darlin',Chase Matthew,350,23,327,43,0,678500,150000,528500,2980916,2024.11.14
66,Highway,Shaboozey,413,-6,419,55,0,589200,-203000,792200,965502,2024.11.14
67,Golden Child,Meghan Patrick,474,17,457,61,0,578300,16800,561500,42389,2024.11.14
68,Country Song Came On,Luke Bryan,177,157,20,36,0,556500,473900,82600,205435,2024.11.14
69,Now Or Never,Corey Kent,166,83,83,7,0,500800,241500,259300,1877501,2024.11.14
70,Not Today,Mitchell Tenpenny,374,-17,391,54,0,489400,81500,407900,394880,2024.11.14
71,Wine Into Whiskey,Tucker Wetmore,66,-5,71,4,0,474500,-55600,530100,4306372,2024.11.14
72,Wolves Cry,Bryan Martin,266,82,184,43,0,462800,64000,398800,737990,2024.11.14
73,Hung Up On You,Bryce Leatherwood,348,6,342,49,0,390400,-14000,404400,72487,2024.11.14
74,Time's Ticking,Justin Moore,105,85,20,27,0,287700,194200,93500,458732,2024.11.14
75,This Party Sucks,Ryan Hurd,57,57,0,56,0,270300,270300,0,97049,2024.11.14
76,Just Like Johnny,Redferrin,235,11,224,27,0,219000,-800,219800,4124906,2024.11.14
77,Maxed Out,Bayker Blankenship,25,9,16,1,0,173600,81500,92100,3154131,2024.11.14
78,Military Band Medley,Wild Blue Country,40,40,0,40,0,166000,166000,0,0,2024.11.14
79,The Devil I Know,Ashley McBryde,53,-5,58,5,0,134800,-4200,139000,114969,2024.11.14
80,How Is She,Cole Swindell,16,2,14,1,0,116100,18500,97600,34287,2024.11.14
81,Pink Skies,Zach Bryan,57,9,48,4,0,110000,6000,104000,12598359,2024.11.14
82,I Got A Problem,Drake Milligan,52,-14,66,4,0,105500,-112000,217500,49691,2024.11.14
83,American Dreamer,Tiffany Woys,18,18,0,15,0,100300,100300,0,451,2024.11.14
83,All American Guy,Chris Janson,18,18,0,15,0,100300,100300,0,59892,2024.11.14
83,Almost Home,Craig Morgan And Jelly Roll,18,18,0,15,0,100300,100300,0,313039,2024.11.14
83,Those Boots (Deddy's Song),Lainey Wilson,18,18,0,15,0,100300,100300,0,99098,2024.11.14
83,American Spirit,Brian Kelley,18,18,0,15,0,100300,100300,0,20847,2024.11.14
88,Three Favorite Colors,Locash,17,17,0,14,0,97100,97100,0,10230,2024.11.14
89,Losers,Post Malone,15,-20,35,4,0,95400,-21000,116400,4256494,2024.11.14
90,One House Down (From The Girl Next Door),Madeline Merlo,48,48,0,48,0,95200,95200,0,1,2024.11.14
90,See You Like That,Abby Anderson,48,48,0,48,0,95200,95200,0,10086,2024.11.14
92,Settling Things,Lauren Watkins,47,47,0,47,0,92000,92000,0,12669,2024.11.14
93,Wrong Ones,Post Malone,13,-3,16,3,0,86900,2100,84800,1237502,2024.11.14
94,A Lot More Free,Max Mcnown,30,8,22,3,0,83100,-6500,89600,2869559,2024.11.14
95,Sunday In the South,Shenandoah,17,-6,23,2,0,78300,-15400,93700,218131,2024.11.14
96,Spin You Around (1/24),Morgan Wallen,23,2,21,3,0,76300,-800,77100,4646315,2024.11.14
97,If I Die Before You,Chris Lane,20,11,9,2,0,71700,65000,6700,174293,2024.11.14
98,Wondering Why,Red Clay Strays,16,2,14,4,0,70800,21200,49600,5044442,2024.11.14
99,Ain't Missin' You,Dylan Schneider,15,6,9,1,0,66500,58200,8300,393315,2024.11.14
100,Cozy,Braxton Keith,17,-3,20,4,0,63700,-28700,92400,1487422,2024.11.14
101,Break Mine,Brothers Osborne,29,1,28,2,0,63400,-4500,67900,267915,2024.11.14
102,Train Of Thought,Vincent Mason,9,3,6,1,0,62200,18400,43800,0,2024.11.14
103,The Star-Spangled Banner,Chris Stapleton,18,3,15,17,0,61700,-900,62600,92845,2024.11.14
104,Things I Take For Granted,Larry Fleet,29,3,26,4,0,60500,21600,38900,354687,2024.11.14
105,Beatles And Eagles,Frontmen,111,-18,129,16,0,57000,-4900,61900,834,2024.11.14
106,Til The Last Shot's Fired,Scotty Hasting,9,8,1,9,0,56500,47800,8700,0,2024.11.14
107,Let 'Em Talk,Ty Myers,15,-3,18,1,0,55200,-4800,60000,792613,2024.11.14
108,Weren't For The Wind,Ella Langley,8,8,0,1,0,54500,54500,0,2900362,2024.11.14
109,Broadway Girls,Lil Durk Feat. Morgan Wallen,10,-14,24,2,0,53600,-48300,101900,4380372,2024.11.14
110,Pray All The Way Home,Austin Snell,23,0,23,2,0,52400,5300,47100,646324,2024.11.14
111,Songs About Whiskey,Anne Wilson,78,-12,90,12,0,48600,-41200,89800,115210,2024.11.14
112,Man Upstairs,Tim Dugger,10,0,10,1,0,38400,-2200,40600,1286,2024.11.14
113,Winning Streak,Jelly Roll,21,2,19,2,0,37900,-100,38000,3516426,2024.11.14
114,Lonely Road,Jelly Roll & Mgk,25,5,20,5,0,37100,13400,23700,5266693,2024.11.14
115,Small Town Wreck,Shawna Thompson,53,53,0,17,0,37000,37000,0,0,2024.11.14
116,Good On You,Priscilla Block,18,-8,26,2,0,32400,-1200,33600,222604,2024.11.14
117,American Nights,Zach Bryan,14,-2,16,1,0,32000,-6300,38300,2358951,2024.11.14
118,Texas,Blake Shelton,7,7,0,5,0,28800,28800,0,7913,2024.11.14
119,Never Been Over,Darius Rucker,15,-9,24,2,0,28500,-25000,53500,117850,2024.11.14
120,Loud and Heavy,Cody Jinks,9,2,7,2,0,23200,6400,16800,1291707,2024.11.14
121,Baggage,Kelsea Ballerini,7,6,1,7,0,21400,14400,7000,1924208,2024.11.14
122,Ends Of The Earth,Ty Myers,4,4,0,3,0,21400,21400,0,4537029,2024.11.14
123,I Left It In The Water,Southbound,3,1,2,3,0,20300,9900,10400,10338,2024.11.14
124,Johnny Moonshine,Maggie Antone,7,-1,8,1,0,19600,8400,11200,163133,2024.11.14
125,Two Things,Kelsea Ballerini,6,6,0,6,0,19400,19400,0,566508,2024.11.14
125,Sorry Mom,Kelsea Ballerini,6,6,0,6,0,19400,19400,0,547711,2024.11.14
127,M-E-X-I-C-O,Post Malone,2,1,1,1,0,19000,9400,9600,421643,2024.11.14
128,When It's Gone For Good,Gold City,3,1,2,3,0,17900,7500,10400,5260,2024.11.14
129,Any Given Friday Night,Luke Combs,2,0,2,1,0,17400,0,17400,155302,2024.11.14
130,Baby Daddy's Weekend,Elle King,11,0,11,3,0,16300,-100,16400,28926,2024.11.14
131,Neon Baby,Annie Bosko,3,-2,5,1,0,15500,-31200,46700,14482,2024.11.14
132,I Wrote The Book,Morgan Wallen,3,3,0,3,0,15200,15200,0,2228236,2024.11.14
133,28,Zach Bryan,11,11,0,1,0,14600,14600,0,6551528,2024.11.14
134,Jesus Walked In,Joseph Habedank,2,0,2,2,0,14500,4100,10400,0,2024.11.14
135,He Sent Him For Me,Inspirations,2,1,1,2,0,13300,7500,5800,0,2024.11.14
135,We Are The Church,Ernie Haase & Signature Sound,2,1,1,2,0,13300,7500,5800,18844,2024.11.14
137,Oklahoma Sooner,Jake Banfield,3,0,3,1,0,13300,3600,9700,1850,2024.11.14
138,Forever Bound,12/Oc,6,1,5,1,0,12900,-600,13500,1468,2024.11.14
139,Three Drinks Behind,George Strait,1,0,1,1,0,12900,8800,4100,263781,2024.11.14
140,Breaking In This Broken Heart,Tyler Kinch,18,18,0,17,0,12700,12700,0,668,2024.11.14
141,Revival Broke Out,Gaither Vocal Band,2,2,0,2,0,12100,12100,0,2950,2024.11.14
142,Moment Of Hope,Buddy Mullins,2,1,1,2,0,12100,7500,4600,5238,2024.11.14
143,This World's A Giant,Zach Bryan,4,4,0,1,0,12000,12000,0,8221952,2024.11.14
144,Praying For The Prodigal,Kingsmen,2,2,0,1,0,11600,11600,0,1843,2024.11.14
145,Bigger On The Inside,Legacy Five,2,1,1,1,0,11600,5800,5800,8479,2024.11.14
146,Taught Me The Rest,Landon Parker,17,-14,31,17,0,11600,-8800,20400,22394,2024.11.14
147,Hippies And Cowboys,Sarah Darling,17,-17,34,17,0,11600,-11600,23200,274,2024.11.14
148,Hypothetically,Twinnie,17,-17,34,17,0,11600,-12100,23700,3462,2024.11.14
149,Just A Bottle,Orlando Mendez,17,-32,49,17,0,11600,-22800,34400,2328,2024.11.14
150,You And The Whiskey,Ben Burgess & Brandon Jane,17,-32,49,17,0,11600,-23300,34900,0,2024.11.14
151,Can Down,Mike Ryan,2,2,0,1,0,11000,11000,0,22568,2024.11.14
152,From Austin,Zach Bryan,2,1,1,1,0,11000,5500,5500,1950662,2024.11.14
153,Heart Of A Small Town,Tim Dugger,3,1,2,1,0,10900,-8900,19800,9245,2024.11.14
154,You Can'T Hurry God,Perrys,2,1,1,2,0,10400,4600,5800,6388,2024.11.14
155,Long Live Cowgirls,Ian Munsick & Cody Johnson,2,0,2,2,0,10300,7100,3200,607398,2024.11.14
156,Strong,Anne Wilson,1,1,0,1,0,9900,9900,0,334,2024.11.14
156,Red Words,Erwins,1,1,0,1,0,9900,9900,0,16761,2024.11.14
156,By Grace,Lore Family,1,1,0,1,0,9900,9900,0,652,2024.11.14
159,Big Ole Stone (Victory),Triumphant Quartet,1,0,1,1,0,9900,5300,4600,4911,2024.11.14
160,Right About You,Post Malone,1,1,0,1,0,9600,9600,0,377605,2024.11.14
160,Nosedive,Post Malone,1,1,0,1,0,9600,9600,0,1233472,2024.11.14
162,Star Spangled Banner,Mickey Guyton,1,0,1,1,0,9600,-100,9700,0,2024.11.14
163,Mia Down In Mia,George Strait,1,0,1,1,0,9600,-3300,12900,100796,2024.11.14
164,Heartfirst,Kelsea Ballerini,2,1,1,1,0,9300,4900,4400,214608,2024.11.14
165,Oklahoma Smokeshow,Zach Bryan,4,0,4,3,0,9000,-8900,17900,5379939,2024.11.14
166,Forward,Niia,1,1,0,1,0,8900,8900,0,189,2024.11.14
167,Drunk Since Dallas,Grant Gilbert,2,2,0,2,0,8800,8800,0,4869,2024.11.14
168,Hell Of A Show,Megan Moroney,2,2,0,2,0,8600,8600,0,188191,2024.11.14
169,Trouble,Josh Ross,1,1,0,1,0,8600,8600,0,645236,2024.11.14
170,Single Bells,Lee Brice,1,1,0,1,0,7600,7600,0,53371,2024.11.14
170,Last Rodeo,Restless Road,1,1,0,1,0,7600,7600,0,191992,2024.11.14
170,10-90,Muscadine Bloodline,1,1,0,1,0,7600,7600,0,780780,2024.11.14
173,Oklahoma Sun,Koe Wetzel,3,1,2,1,0,7600,-200,7800,104195,2024.11.14
174,'98 Braves,Morgan Wallen,2,1,1,2,0,7600,-700,8300,1209248,2024.11.14
175,Anywhere Jesus Is,Scotty Inman,1,1,0,1,0,7500,7500,0,1339,2024.11.14
175,Do It For You,Jason Crabb,1,1,0,1,0,7500,7500,0,2667,2024.11.14
175,Sunday Sermons,Anne Wilson,1,1,0,1,0,7500,7500,0,444060,2024.11.14
175,New Name Written Down In Glory,Chitans,1,1,0,1,0,7500,7500,0,113,2024.11.14
175,Middle Of Nowhere,Southbound,1,1,0,1,0,7500,7500,0,7533,2024.11.14
175,One Name,Jeff & Sheri Easter,1,1,0,1,0,7500,7500,0,11826,2024.11.14
175,Here Comes Jesus,Jeff & Sheri Easter,1,1,0,1,0,7500,7500,0,17964,2024.11.14
182,Keep Up With A Cowgirl,David Adam Byrnes,2,2,0,2,0,7000,7000,0,52621,2024.11.14
183,Am I The Only One,Aaron Lewis,4,0,4,2,0,7000,-11800,18800,518300,2024.11.14
184,Rainy Days,Chase Matthew,1,1,0,1,0,6900,6900,0,10819,2024.11.14
185,Dance Like No One’s Watching,Gabby Barrett,13,-2,15,1,0,6900,-7700,14600,139733,2024.11.14
186,Strangers,Kameron Marlowe & Ella Langley,24,-12,36,3,0,6700,-23000,29700,786364,2024.11.14
187,Don'T Mind If I Do,Riley Green,10,4,6,1,0,6500,1900,4600,3161121,2024.11.14
188,This Side Of The Dirt,Neon Union,4,-1,5,1,0,6400,-1600,8000,5804,2024.11.14
189,A Little Bit Closer,Braxton Keith,2,0,2,1,0,6300,0,6300,263942,2024.11.14
190,You In A Honky Tonk,Randall King,2,-2,4,2,0,6200,-25200,31400,338114,2024.11.14
191,Devil Don't Know,Morgan Wallen,1,1,0,1,0,6000,6000,0,535537,2024.11.14
191,Saltwater Cinderella,Chase Matthew,1,1,0,1,0,6000,6000,0,50920,2024.11.14
193,Jesus Does,Lore Family,1,1,0,1,0,5800,5800,0,1187,2024.11.14
193,"Liar, Liar",Brian Free & Assurance,1,1,0,1,0,5800,5800,0,2183,2024.11.14
193,Waiting For Me,Truesong,1,1,0,1,0,5800,5800,0,650,2024.11.14
193,Answer Is Jesus,Karen Peck & New River,1,1,0,1,0,5800,5800,0,1164,2024.11.14
193,There Is A Name,LeFevre Quartet,1,1,0,1,0,5800,5800,0,7563,2024.11.14
193,Come To The Well,Inspirations,1,1,0,1,0,5800,5800,0,6158,2024.11.14
199,Back To The Garden,Erwins,1,0,1,1,0,5800,0,5800,0,2024.11.14
199,Ready To Leave,Down East Boys,1,0,1,1,0,5800,0,5800,638,2024.11.14
199,Think About There,Greater Vision,1,0,1,1,0,5800,0,5800,10123,2024.11.14
199,All Things,Sound,1,0,1,1,0,5800,0,5800,1760,2024.11.14
199,He Bought Me,Old Paths,1,0,1,1,0,5800,0,5800,948,2024.11.14
199,He Pilots My Ship,Tribute Quartet,1,0,1,1,0,5800,0,5800,6894,2024.11.14
199,Like Jesus Can,Taranda Greene,1,0,1,1,0,5800,0,5800,1068,2024.11.14
199,The End,Endless Highway,1,0,1,1,0,5800,0,5800,97,2024.11.14
199,In God's Time,Jordan Family Band,1,0,1,1,0,5800,0,5800,3569,2024.11.14
199,Come On In,Kingdom Heirs,1,0,1,1,0,5800,0,5800,6416,2024.11.14
209,Old Blind Bartimaeus,Jonathan Wilburn,1,-1,2,1,0,5800,-4600,10400,0,2024.11.14
1,Gonna Love You,Parmalee,8008,1652,6356,146,0,28807800,6374100,22433700,423901,2024.11.28
2,I Am Not Okay,Jelly Roll,6388,46,6342,145,0,27864100,493900,27370200,7839048,2024.11.28
3,Pour Me A Drink,Post Malone,6291,-2,6293,146,0,25908700,250500,25658200,4136306,2024.11.28
4,Cowboy Songs,George Birge,6882,520,6362,146,0,24683100,2551600,22131500,742070,2024.11.28
5,A Bar Song (Tipsy),Shaboozey,5580,60,5520,140,0,22977100,65000,22912100,20879494,2024.11.28
6,High Road,Koe Wetzel,6447,660,5787,145,0,22937200,2652500,20284700,7964545,2024.11.28
7,You Look Like You Love Me,Ella Langley & Riley Green,6441,515,5926,146,0,22408800,1809900,20598900,7717736,2024.11.28
8,Lies Lies Lies,Morgan Wallen,5660,-387,6047,146,0,22102100,-1864100,23966200,10034774,2024.11.28
9,Miles On It,Marshmello & Kane Brown,4962,-311,5273,140,0,20595300,-1038600,21633900,7657608,2024.11.28
10,Boys Back Home,Dylan Marlowe Feat. Dylan Scott,5472,524,4948,146,0,19920300,1824300,18096000,1078080,2024.11.28
11,Love Somebody,Morgan Wallen,4849,780,4069,146,0,18296900,2116500,16180400,15763389,2024.11.28
12,Wind Up Missin' You,Tucker Wetmore,4842,311,4531,146,0,17463400,1597900,15865500,8165398,2024.11.28
13,Beautiful As You,Thomas Rhett,4565,-2961,7526,146,0,17018400,-8863300,25881700,5125995,2024.11.28
14,Bigger Houses,Dan + Shay,4797,320,4477,146,0,16418200,1376000,15042200,771476,2024.11.28
15,Messed Up As Me,Keith Urban,4012,200,3812,143,0,13221300,1586000,11635300,1343813,2024.11.28
16,Guy For That,Post Malone,3412,432,2980,146,0,12987600,1675800,11311800,4564276,2024.11.28
17,Damn Good Day To Leave,Riley Green,3966,388,3578,146,0,12740200,1249300,11490900,718209,2024.11.28
18,4x4xu,Lainey Wilson,3401,309,3092,146,0,11513900,1537900,9976000,5193713,2024.11.28
19,Think I’m In Love With You,Chris Stapleton,3298,258,3040,145,0,10819000,864300,9954700,5952898,2024.11.28
20,I Ain'T Sayin',Jordan Davis,3298,333,2965,146,0,10575100,1288500,9286600,3237131,2024.11.28
21,This Town's Been Too Good To Us,Dylan Scott,2641,270,2371,145,0,8803000,1365400,7437600,1753225,2024.11.28
22,Forever To Me,Cole Swindell,2495,316,2179,134,0,8411800,785700,7626100,850760,2024.11.28
23,Friends Like That,John Morgan Feat. Jason Aldean,2806,235,2571,142,0,8308100,821600,7486500,575023,2024.11.28
24,Breakin' In Boots,Matt Stell,2829,251,2578,143,0,8167100,916200,7250900,289203,2024.11.28
25,I'm Gonna Love You,Cody Johnson,2237,232,2005,143,0,7022600,609900,6412700,8064069,2024.11.28
26,Liar,Jelly Roll,1885,491,1394,132,0,6680300,1974100,4706200,6746610,2024.11.28
27,Texas,Blake Shelton,1811,-866,2677,145,0,6676700,-5607400,12284100,1285986,2024.11.28
28,Hometown Home,Locash,2281,320,1961,143,0,6644900,872500,5772400,157919,2024.11.28
29,Holy Smokes,Bailey Zimmerman,1997,-5,2002,133,0,6224900,226200,5998700,3570970,2024.11.28
30,Just To Say We Did,Kenny Chesney,1804,150,1654,132,0,5137600,591100,4546500,288827,2024.11.28
31,Am I Okay?,Megan Moroney,1396,76,1320,106,0,4762200,100700,4661500,5474205,2024.11.28
32,Whiskey Drink,Jason Aldean,1733,159,1574,125,0,4605700,447600,4158100,826930,2024.11.28
33,I Never Lie,Zach Top,1084,292,792,74,0,4468100,1096000,3372100,8749448,2024.11.28
34,Life With You,Kelsey Hart,1853,21,1832,123,0,4404900,16500,4388400,849837,2024.11.28
35,Whatcha See Is Whatcha Get,Chris Janson,1718,43,1675,143,0,4067400,120300,3947100,102468,2024.11.28
36,Backseat Driver,Kane Brown,1018,164,854,92,0,3964300,235700,3728600,2171037,2024.11.28
37,Coming Home,Old Dominion,1309,-15,1324,138,0,3519900,33500,3486400,1036856,2024.11.28
38,Wranglers,Miranda Lambert,1597,-45,1642,141,0,3325500,-129900,3455400,249070,2024.11.28
39,Cowboys Cry Too,Kelsea Ballerini,1470,10,1460,141,0,3199400,243900,2955500,2501325,2024.11.28
40,Truck On Fire,Carly Pearce,1256,125,1131,139,0,3067800,416400,2651400,738990,2024.11.28
41,Fall Of Summer,Scotty McCreery,1333,106,1227,124,0,2981800,209200,2772600,359949,2024.11.28
42,Single Again,Josh Ross,1393,115,1278,111,0,2920600,-22800,2943400,2143234,2024.11.28
43,Heavens To Betsy,Jackson Dean,947,58,889,105,0,2277000,147700,2129300,356780,2024.11.28
44,Friday Night Heartbreaker,Jon Pardi,895,124,771,94,0,2264900,441300,1823600,460466,2024.11.28
45,Tough People,Drew Baldridge,920,55,865,97,0,2152200,45400,2106800,97682,2024.11.28
46,Everything I Need,Chayce Beckham,912,63,849,79,0,2072200,248400,1823800,196705,2024.11.28
47,Park,Tyler Hubbard,784,10,774,90,0,1988500,137900,1850600,712679,2024.11.28
48,Country House,Sam Hunt,927,82,845,110,0,1911600,230000,1681600,186697,2024.11.28
49,Relapse,Warren Zeiders,600,24,576,41,0,1617400,67500,1549900,3284317,2024.11.28
50,Bones,Russell Dickerson,741,48,693,87,0,1553500,15900,1537600,644629,2024.11.28
51,This Heart,Corey Kent,599,-9,608,59,0,1460700,164000,1296700,576763,2024.11.28
52,Truck Still Works,Brad Paisley,595,34,561,74,0,1449200,49900,1399300,139993,2024.11.28
53,Devil You Know,Tyler Braden,467,-13,480,38,0,1427500,34200,1393300,3723125,2024.11.28
54,Country Song Came On,Luke Bryan,490,66,424,61,0,1393300,212300,1181000,197789,2024.11.28
55,What Kinda Man,Parker Mccollum,692,44,648,78,0,1358400,87400,1271000,873914,2024.11.28
56,Fix What You Didn't Break,Nate Smith,508,65,443,63,0,1326400,221400,1105000,4356253,2024.11.28
57,Love The Leavin',Drew Parker,501,1,500,24,0,1273200,47500,1225700,69636,2024.11.28
58,Over When We'Re Sober,Brantley Gilbert,679,17,662,90,0,1261900,-135000,1396900,559639,2024.11.28
59,I Could Be That Rain,Randall King,555,45,510,65,0,958800,230400,728400,90553,2024.11.28
60,Better Than You,Joe Nichols & Annie Bosko,580,13,567,76,0,843500,46000,797500,93170,2024.11.28
61,Darlin',Chase Matthew,385,15,370,47,0,834000,70400,763600,2500616,2024.11.28
62,Would If I Could,Ernest Feat. Lainey Wilson,402,38,364,58,0,767100,4900,762200,636407,2024.11.28
63,Worst Way,Riley Green,91,-1,92,4,0,766400,31700,734700,4850177,2024.11.28
64,Golden Child,Meghan Patrick,491,24,467,63,0,570100,25800,544300,29243,2024.11.28
65,Highway,Shaboozey,422,-24,446,64,0,521100,13100,508000,1550544,2024.11.28
66,Wine Into Whiskey,Tucker Wetmore,66,1,65,3,0,507700,10500,497200,3078490,2024.11.28
67,Wolves Cry,Bryan Martin,366,48,318,55,0,501600,84200,417400,711439,2024.11.28
68,Not Today,Mitchell Tenpenny,421,30,391,56,0,476400,40500,435900,137592,2024.11.28
69,Hung Up On You,Bryce Leatherwood,347,5,342,46,0,450900,34500,416400,68829,2024.11.28
70,Time's Ticking,Justin Moore,204,33,171,36,0,356100,40900,315200,377774,2024.11.28
71,Espresso,Sabrina Carpenter,80,80,0,40,0,332000,332000,0,14324494,2024.11.28
72,Now Or Never,Corey Kent,120,-34,154,7,0,301800,-162600,464400,1687911,2024.11.28
73,One House Down (From The Girl Next Door),Madeline Merlo,58,58,0,57,0,276700,276700,0,2,2024.11.28
74,Just Like Johnny,Redferrin,249,5,244,29,0,238300,13700,224600,3778253,2024.11.28
75,Pink Skies,Zach Bryan,79,15,64,5,0,196500,54000,142500,10009834,2024.11.28
76,Maxed Out,Bayker Blankenship,26,-2,28,1,0,178500,-4700,183200,2918129,2024.11.28
77,If I Die Before You,Chris Lane,126,73,53,31,0,175200,79800,95400,203222,2024.11.28
78,A Lot More Free,Max Mcnown,60,16,44,4,0,160500,49900,110600,3024737,2024.11.28
79,Hillbilly Deluxe,Brooks & Dunn,16,14,2,16,0,136900,117900,19000,244351,2024.11.28
80,The Devil I Know,Ashley McBryde,54,0,54,5,0,128700,-3200,131900,126685,2024.11.28
81,How Is She,Cole Swindell,18,2,16,1,0,119200,18100,101100,32950,2024.11.28
82,90's Country,Hannah Ellis,48,47,1,48,0,104200,97200,7000,0,2024.11.28
83,I Got A Problem,Drake Milligan,32,-27,59,2,0,102500,-129400,231900,45723,2024.11.28
84,Spin You Around (1/24),Morgan Wallen,28,2,26,3,0,98600,16400,82200,4585887,2024.11.28
85,New Kind Of Emotion,Runaway June,48,48,0,48,0,95200,95200,0,27013,2024.11.28
86,Wrong Ones,Post Malone,15,3,12,2,0,90700,21700,69000,1120521,2024.11.28
87,Hippies And Cowboys,Sarah Darling,133,32,101,17,0,89900,21400,68500,234,2024.11.28
88,Losers,Post Malone,14,-2,16,2,0,83000,-23400,106400,3663759,2024.11.28
89,Ends Of The Earth,Ty Myers,20,6,14,2,0,80900,37700,43200,4934837,2024.11.28
90,Stretchy Pants,Carrie Underwood,14,14,0,8,0,70200,70200,0,249030,2024.11.28
91,Weren't For The Wind,Ella Langley,15,-7,22,2,0,63100,-55500,118600,3279732,2024.11.28
92,Almost Gone,Gavin Adcock,25,25,0,2,0,61200,61200,0,1902290,2024.11.28
93,28,Zach Bryan,32,3,29,1,0,60200,7900,52300,5251749,2024.11.28
94,Break Mine,Brothers Osborne,29,-1,30,2,0,60200,-4200,64400,259662,2024.11.28
95,I Went To College/I Went To Jail,Ernest,11,9,2,1,0,59300,50900,8400,76021,2024.11.28
96,Somethin' 'Bout A Woman,Thomas Rhett,13,-48,61,7,0,56800,-72300,129100,4375179,2024.11.28
97,Til The Last Shot's Fired,Scotty Hasting,9,9,0,9,0,56500,56500,0,0,2024.11.28
97,Jesus 'Bout My Kids,Luke Bryan,9,9,0,9,0,56500,56500,0,68885,2024.11.28
99,The Star-Spangled Banner,Chris Stapleton,12,-1,13,12,0,51000,-7800,58800,75967,2024.11.28
100,Pray All The Way Home,Austin Snell,23,1,22,2,0,46200,-15800,62000,633854,2024.11.28
101,Train Of Thought,Vincent Mason,8,1,7,1,0,44000,-6400,50400,0,2024.11.28
102,Man Upstairs,Tim Dugger,9,-2,11,1,0,42400,-10900,53300,1149,2024.11.28
103,What Christmas Means To Me,Old Dominion,5,5,0,1,0,39600,39600,0,0,2024.11.28
104,Cozy,Braxton Keith,14,-2,16,1,0,38000,-13200,51200,1508715,2024.11.28
105,Songs About Whiskey,Anne Wilson,60,-5,65,8,0,37200,1200,36000,92073,2024.11.28
106,Wondering Why,Red Clay Strays,14,-2,16,5,0,37100,-15900,53000,5680387,2024.11.28
107,Lonely Road,Jelly Roll & Mgk,21,4,17,2,0,33700,9800,23900,4999427,2024.11.28
108,Things I Take For Granted,Larry Fleet,15,-16,31,3,0,33600,-76500,110100,474366,2024.11.28
109,Good On You,Priscilla Block,18,-1,19,3,0,33500,-1000,34500,208872,2024.11.28
110,"Santa, Send Your Reindeer",Runaway June,5,5,0,3,0,33300,33300,0,61353,2024.11.28
110,Mr And Mrs Santa Claus,Spencer Hatcher And Aubrie Sellers,5,5,0,3,0,33300,33300,0,0,2024.11.28
110,Jingle Bells On The Rocks,Dusty Black,5,5,0,3,0,33300,33300,0,0,2024.11.28
110,Jingle Bell Rock,Nate Barnes,5,5,0,3,0,33300,33300,0,935,2024.11.28
110,SILENT NIGHT,Annie Bosko,5,5,0,3,0,33300,33300,0,93763,2024.11.28
115,Hypothetically,Twinnie,48,31,17,17,0,33100,21500,11600,1647,2024.11.28
116,Broadway Girls,Lil Durk Feat. Morgan Wallen,10,0,10,2,0,32200,-21000,53200,4135164,2024.11.28
117,Beatles And Eagles,Frontmen,73,-2,75,10,0,32100,-400,32500,591,2024.11.28
118,Body Talk,Kane Brown w/ Katelyn Brown,4,4,0,3,0,31500,31500,0,2901695,2024.11.28
119,Oklahoma Smokeshow,Zach Bryan,8,3,5,2,0,27600,10400,17200,4888443,2024.11.28
120,Hey Driver,Zach Bryan Feat. The War and Treaty,9,3,6,1,0,27200,9900,17300,3010373,2024.11.28
121,"Mary, Did You Know",Runaway June,3,3,0,2,0,23200,23200,0,0,2024.11.28
122,You And The Whiskey,Ben Burgess & Brandon Jane,34,-2,36,17,0,23200,-2200,25400,0,2024.11.28
123,This World's A Giant,Zach Bryan,17,10,7,1,0,22700,17800,4900,3250630,2024.11.28
124,Forever Bound,12/Oc,6,0,6,1,0,21900,3200,18700,1907,2024.11.28
125,Loud and Heavy,Cody Jinks,8,-1,9,2,0,18600,-200,18800,1233353,2024.11.28
126,Can'T Help My Country,Tiera Kennedy,9,9,0,8,0,18000,18000,0,5009,2024.11.28
127,Hide My Gun,Post Malone,2,1,1,2,0,17300,12200,5100,750661,2024.11.28
128,Carol Of The Strings,Ben Gallaher,3,3,0,2,0,17000,17000,0,2885,2024.11.28
129,Neon Baby,Annie Bosko,2,-3,5,1,0,16900,-38700,55600,12721,2024.11.28
130,My Bar,Priscilla Block,2,2,0,2,0,14500,14500,0,84158,2024.11.28
131,Wings Of A Dove,Jonathan Wilburn,2,2,0,2,0,13300,13300,0,0,2024.11.28
132,The Good I'Ll Do,Zach Bryan,4,-4,8,2,0,13300,-8800,22100,1731514,2024.11.28
133,Taught Me The Rest,Landon Parker,18,18,0,17,0,12700,12700,0,3815,2024.11.28
133,Just A Bottle,Orlando Mendez,18,18,0,17,0,12700,12700,0,4807,2024.11.28
135,Ain't Missin' You,Dylan Schneider,12,2,10,1,0,12000,-10000,22000,380049,2024.11.28
136,Finer Things,Post Malone,2,2,0,1,0,11000,11000,0,750005,2024.11.28
137,Runnin' Through That T,Thomas Edwards (Country),1,-2,3,1,0,10900,-23200,34100,1578,2024.11.28
138,Heartfirst,Kelsea Ballerini,4,3,1,2,0,10800,6600,4200,193328,2024.11.28
139,Heart Of A Small Town,Tim Dugger,3,2,1,1,0,10800,3400,7400,7830,2024.11.28
140,Never Been Over,Darius Rucker,6,0,6,1,0,10700,0,10700,107002,2024.11.28
141,California Sober,Post Malone,4,-49,53,2,0,10600,-94200,104800,1194134,2024.11.28
142,Whose Tequila Are You Drinkin',Billie Jo Jones,16,16,0,16,0,10500,10500,0,14010,2024.11.28
143,There's A River,High Road,2,0,2,2,0,10400,0,10400,0,2024.11.28
144,Old Blind Bartimaeus,Jonathan Wilburn,2,0,2,2,0,10400,-5300,15700,0,2024.11.28
145,"Salt, Lime & Tequila",Ryan Griffin,2,2,0,1,0,10000,10000,0,42066,2024.11.28
146,Even After Everything,Lily Rose,1,1,0,1,0,9900,9900,0,152383,2024.11.28
147,American Nights,Zach Bryan,5,-1,6,1,0,9800,-200,10000,2017200,2024.11.28
148,Bury Me In This Bar,Dalton Dover,13,-5,18,3,0,9700,1800,7900,8111,2024.11.28
149,5 Leaf Clover,Luke Combs,1,1,0,1,0,9600,9600,0,739139,2024.11.28
150,A Lovely Tapestry,Mark Bishop,2,1,1,1,0,9200,4600,4600,379,2024.11.28
151,Any Given Friday Night,Luke Combs,1,-1,2,1,0,8700,-8700,17400,144930,2024.11.28
152,Star Spangled Banner,Mickey Guyton,1,1,0,1,0,8200,8200,0,0,2024.11.28
153,Oklahoma Sun,Koe Wetzel,3,1,2,1,0,8000,-4500,12500,112261,2024.11.28
154,Strangers,Kameron Marlowe & Ella Langley,15,-5,20,3,0,7700,1500,6200,866871,2024.11.28
155,Christmas Morning,Megan Moroney,1,1,0,1,0,7600,7600,0,248216,2024.11.28
155,Glow,Little Big Town,1,1,0,1,0,7600,7600,0,96180,2024.11.28
157,Because He Lives,Carrie Underwood,1,1,0,1,0,7500,7500,0,54146,2024.11.28
157,Say Yes I Am,Lauren Talley,1,1,0,1,0,7500,7500,0,221,2024.11.28
159,Old School,Toby Keith,1,1,0,1,0,7200,7200,0,18287,2024.11.28
160,Ain't In Kansas Anymore,Miranda Lambert,2,2,0,2,0,6900,6900,0,792376,2024.11.28
161,God's Gonna Cut You Down,Bailey Zimmerman,1,1,0,1,0,6900,6900,0,222765,2024.11.28
162,Ain't That Some,Morgan Wallen,1,-1,2,1,0,6900,900,6000,3001615,2024.11.28
163,Dance Like No One’s Watching,Gabby Barrett,15,1,14,1,0,6600,-6300,12900,135715,2024.11.28
164,Roulette On The Heart,Conner Smith,6,-1,7,1,0,6100,5400,700,247634,2024.11.28
165,Sunrise,Morgan Wallen,1,1,0,1,0,6000,6000,0,2238348,2024.11.28
166,Don'T Mind If I Do,Riley Green,8,-3,11,1,0,5900,-2300,8200,3492299,2024.11.28
167,Still Telling My Story,Erwins,1,1,0,1,0,5800,5800,0,0,2024.11.28
167,Jesus Does,Lore Family,1,1,0,1,0,5800,5800,0,805,2024.11.28
167,God's Been Good,LeFevre Quartet,1,1,0,1,0,5800,5800,0,585,2024.11.28
167,There's Always A Place At The Table,Sunday Drive,1,1,0,1,0,5800,5800,0,358,2024.11.28
167,Come On In,Kingdom Heirs,1,1,0,1,0,5800,5800,0,6716,2024.11.28
167,There Is,Hyssongs,1,1,0,1,0,5800,5800,0,46,2024.11.28
167,"Liar, Liar",Brian Free & Assurance,1,1,0,1,0,5800,5800,0,1087,2024.11.28
167,A Good Day Coming On,Kingdom Heirs,1,1,0,1,0,5800,5800,0,0,2024.11.28
167,We Are The Church,Ernie Haase & Signature Sound,1,1,0,1,0,5800,5800,0,17563,2024.11.28
167,The End,Endless Highway,1,1,0,1,0,5800,5800,0,66,2024.11.28
167,He Pilots My Ship,Tribute Quartet,1,1,0,1,0,5800,5800,0,8449,2024.11.28
167,I Think I'Ll Just Go On,Perrys,1,1,0,1,0,5800,5800,0,4234,2024.11.28
179,When It's Gone For Good,Gold City,1,0,1,1,0,5800,1200,4600,3557,2024.11.28
180,It Won't Be Long,Poet Voices,1,0,1,1,0,5800,0,5800,13383,2024.11.28
180,In God's Time,Jordan Family Band,1,0,1,1,0,5800,0,5800,2850,2024.11.28
180,Like Jesus Can,Taranda Greene,1,0,1,1,0,5800,0,5800,670,2024.11.28
180,Be The Reason,Steeles,1,0,1,1,0,5800,0,5800,4610,2024.11.28
180,He Sent Him For Me,Inspirations,1,0,1,1,0,5800,0,5800,0,2024.11.28
180,Praying For The Prodigal,Kingsmen,1,0,1,1,0,5800,0,5800,1575,2024.11.28
180,Come To The Well,Inspirations,1,0,1,1,0,5800,0,5800,4927,2024.11.28
180,Bigger On The Inside,Legacy Five,1,0,1,1,0,5800,0,5800,8878,2024.11.28
180,He Bought Me,Old Paths,1,0,1,1,0,5800,0,5800,1150,2024.11.28
189,I Left It In The Water,Southbound,1,-1,2,1,0,5800,-4600,10400,10591,2024.11.28
190,I Need You,Frontmen,2,2,0,2,0,5700,5700,0,407,2024.11.28
191,Harder Stuff,Adam Hood Feat. Miranda Lambert,1,1,0,1,0,5500,5500,0,2852,2024.11.28
192,Nothing But Love Songs,Randy Rogers Band,1,0,1,1,0,5500,0,5500,7252,2024.11.28
192,From Austin,Zach Bryan,1,0,1,1,0,5500,0,5500,1750467,2024.11.28
194,One Too Many,Maggie Antone,1,1,0,1,0,5400,5400,0,78724,2024.11.28
194,Coulda Been Love,Randall King,1,1,0,1,0,5400,5400,0,41733,2024.11.28
194,Running Out Of Time,Wyatt Flores,1,1,0,1,0,5400,5400,0,266509,2024.11.28
194,Get Away With Anything,Mike Ryan,1,1,0,1,0,5400,5400,0,2291,2024.11.28
194,Worry Is A Sickness,Ty Myers,1,1,0,1,0,5400,5400,0,272631,2024.11.28
194,Her Way Ain't The Highway,Jake Bush,1,1,0,1,0,5400,5400,0,0,2024.11.28
194,All Night Longer,Matt Lang,1,1,0,1,0,5400,5400,0,1865,2024.11.28
194,Money To Drank,Colby Lee Swift,1,1,0,1,0,5400,5400,0,3299,2024.11.28
194,Good Guy,Cole Phillips,1,1,0,1,0,5400,5400,0,43030,2024.11.28
